page	access#	AVF	wr_ratio	wr#	rd#	mean_AVF	page_wr_ratio
1518296734	27	0.0	27.0	27	0	0.0	inf
1518296735	98	13.99834260528554	35.0	35	63	0.21872410320758656	0.5555555555555556
1518296739	27	0.0	27.0	27	0	0.0	inf
1518296740	97	14.03238996475212	34.0	34	63	0.21925609319925188	0.5396825396825397
16355949808	7	6.4583043198386205	0.0	0	7	0.9226149028340886	0.0
20748601587	6	3.9028313423536916	0.0	0	6	0.6504718903922819	0.0
20748601588	8	4.407843322856623	0.0	0	8	0.5509804153570779	0.0
20748601589	6	3.4221357244724904	0.0	0	6	0.5703559540787484	0.0
20748601590	9	4.77466019642314	0.0	0	9	0.5305177996025711	0.0
20748601591	8	3.4466148699434735	0.0	0	8	0.4308268587429342	0.0
22641002229	4	0.0	4.0	4	0	0.0	inf
22641002231	3	0.46860235859757626	0.0	0	3	0.1562007861991921	0.0
22641002232	36	2.7066028006294576	0.0	0	36	0.07518341112859604	0.0
22641002238	39	0.0	39.0	39	0	0.0	inf
22641002243	6	0.0	6.0	6	0	0.0	inf
22641002244	23	1.8246250879398367	0.0	0	23	0.07933152556260159	0.0
26144142100	6	2.265925570015399	0.0	0	6	0.37765426166923316	0.0
26144142106	34	3.4069432955837504	0.0	0	34	0.10020421457599266	0.0
26144142114	58	6.39528892044618	0.0	0	58	0.11026360207665827	0.0
26144142117	18	1.8628733241404491	0.0	0	18	0.10349296245224718	0.0
29305824313	11	0.0	11.0	11	0	0.0	inf
29305824314	95	7.34364100266141	48.0	48	47	0.11474439066658453	1.0212765957446808
29305824319	10	0.0	10.0	10	0	0.0	inf
29305824320	89	7.36928447269711	42.0	42	47	0.11514506988589235	0.8936170212765957
29305824322	27	0.0	27.0	27	0	0.0	inf
29305824323	127	12.074054954500621	64.0	64	63	0.1886571086640722	1.0158730158730158
29305824326	11	0.0	11.0	11	0	0.0	inf
29305824327	90	7.411622740404302	43.0	43	47	0.11580660531881722	0.9148936170212766
29305824328	55	3.802934722953258	24.0	24	31	0.07605869445906516	0.7741935483870968
29305824332	19	0.0	19.0	19	0	0.0	inf
29305824333	105	9.408416885078232	50.0	50	55	0.14700651382934737	0.9090909090909091
29305824336	86	5.666991145647257	47.0	47	39	0.0885467366507384	1.205128205128205
29305824337	74	2.5045861369718745	51.0	51	23	0.04910953209748774	2.217391304347826
29305824345	5	2.0051799346305446	0.0	0	5	0.4010359869261089	0.0
29305824353	1	0.9492718952487869	0.0	0	1	0.9492718952487869	0.0
29305824355	74	2.6344952821078493	51.0	51	23	0.05165677023740881	2.217391304347826
29305824365	57	1.8573009344499998	42.0	42	15	0.04422145082023809	2.8
29305824366	17	0.0	17.0	17	0	0.0	inf
29305824367	75	10.288348008147237	20.0	20	55	0.16075543762730057	0.36363636363636365
29305824377	6	0.8370985486020348	0.0	0	6	0.1395164247670058	0.0
29305824378	39	7.34152482562112	0.0	0	39	0.18824422629797744	0.0
29305824379	2	0.0	2.0	2	0	0.0	inf
29305824384	13	1.655990037869496	0.0	0	13	0.12738384906688432	0.0
29305824385	51	0.0	51.0	51	0	0.0	inf
29305824406	1	0.7266817503113446	0.0	0	1	0.7266817503113446	0.0
29305824408	1	0.054436698269173134	0.0	0	1	0.054436698269173134	0.0
29305824410	47	6.171054421409274	0.0	0	47	0.13129903024275053	0.0
29305824411	7	0.9205101443618564	0.0	0	7	0.13150144919455092	0.0
29305824413	31	4.087949504940032	0.0	0	31	0.1318693388690333	0.0
29305824422	2	1.4615047790481386	0.0	0	2	0.7307523895240693	0.0
29305824424	2	1.4605241472843031	0.0	0	2	0.7302620736421516	0.0
29305824426	8	4.40688528733084	0.0	0	8	0.550860660916355	0.0
29305824427	10	5.387904559785936	0.0	0	10	0.5387904559785935	0.0
29305824428	10	4.9071758906908665	0.0	0	10	0.49071758906908663	0.0
29305824429	6	3.6627847603775754	0.0	0	6	0.6104641267295959	0.0
29305824430	4	2.6810997420431453	0.0	0	4	0.6702749355107863	0.0
29305824431	6	3.1824937388185157	0.0	0	6	0.5304156231364193	0.0
29305824432	8	4.884529064045833	0.0	0	8	0.6105661330057292	0.0
29305824433	8	5.363392700358369	0.0	0	8	0.6704240875447961	0.0
29305824434	8	4.403014023382722	0.0	0	8	0.5503767529228403	0.0
29305824435	6	2.944376043670771	0.0	0	6	0.4907293406117952	0.0
29305824436	8	4.165494622657439	0.0	0	8	0.5206868278321799	0.0
29305824437	2	1.2203771750565413	0.0	0	2	0.6101885875282707	0.0
29305824438	6	3.42187603636353	0.0	0	6	0.570312672727255	0.0
29305824439	4	2.2010389547902114	0.0	0	4	0.5502597386975528	0.0
29305824440	2	1.2204345087948831	0.0	0	2	0.6102172543974416	0.0
31933350762	37	2.7848297401567526	0.0	0	37	0.0752656686528852	0.0
31933350763	37	2.93929503784364	0.0	0	37	0.07944040642820649	0.0
31933350766	4	1.4902204381062059	0.0	0	4	0.37255510952655146	0.0
31933350769	2	0.0	2.0	2	0	0.0	inf
31933350772	17	2.058059178760525	0.0	0	17	0.12106230463297207	0.0
31933350773	17	1.41575515390961	0.0	0	17	0.08327971493585941	0.0
31933350779	41	2.713753779248919	0.0	0	41	0.0661891165670468	0.0
31933350780	41	3.3438420080028903	0.0	0	41	0.08155712214641196	0.0
34094639290	11	0.6251476343762302	0.0	0	11	0.05683160312511184	0.0
34094639292	1	0.8592234133899685	0.0	0	1	0.8592234133899685	0.0
34094639293	1	0.05540305280797042	0.0	0	1	0.05540305280797042	0.0
34094639295	2	0.23262411124274138	0.0	0	2	0.11631205562137069	0.0
34094639299	2	0.11128298741603136	0.0	0	2	0.05564149370801568	0.0
34094639304	2	1.7211209397876583	0.0	0	2	0.8605604698938292	0.0
37961544257	8	4.88484597347404	0.0	0	8	0.610605746684255	0.0
37961544258	7	4.036036952606133	0.0	0	7	0.5765767075151619	0.0
40979728428	64	25.166268178448675	0.0	0	64	0.39322294028826055	0.0
40979728429	64	28.036399054510454	0.0	0	64	0.43806873522672585	0.0
40979728430	64	31.73871351635012	0.0	0	64	0.49591739869297063	0.0
40979728431	64	30.108878005721223	0.0	0	64	0.4704512188393941	0.0
40979728432	64	25.382080576161346	0.0	0	64	0.39659500900252104	0.0
40979728433	64	28.25312530704465	0.0	0	64	0.4414550829225727	0.0
40979728434	64	31.734867546698325	0.0	0	64	0.49585730541716133	0.0
40979728435	72	31.76972016414088	8.0	8	64	0.4964018775647013	0.125
40979728436	65	29.885977471663082	1.0	1	64	0.46696839799473566	0.015625
40979728437	64	29.918479855509975	0.0	0	64	0.46747624774234336	0.0
40979728438	64	27.601124685591902	0.0	0	64	0.43126757321237347	0.0
40979728439	64	33.91981820483343	0.0	0	64	0.5299971594505224	0.0
40979728440	64	33.96940143352332	0.0	0	64	0.5307718973988019	0.0
40979728441	3	1.14129686218071	0.0	0	3	0.38043228739357	0.0
40979728442	2	0.7609369726841835	0.0	0	2	0.38046848634209174	0.0
40979728443	64	24.606509897489527	0.0	0	64	0.38447671714827386	0.0
40979728444	64	24.606874135356644	0.0	0	64	0.38448240836494757	0.0
40979728445	64	24.612788054257052	0.0	0	64	0.38457481334776644	0.0
40979728446	64	24.62013711532153	0.0	0	64	0.3846896424268989	0.0
40979728447	64	24.61316791837834	0.0	0	64	0.3845807487246616	0.0
40979728448	64	24.62076778644328	0.0	0	64	0.38469949666317627	0.0
40979728449	64	24.603861191197222	0.0	0	64	0.3844353311124566	0.0
40979728450	64	27.57359167541099	0.0	0	64	0.43083736992829674	0.0
40979728451	64	30.664744337618828	0.0	0	64	0.4791366302752942	0.0
40979728452	64	30.665065406553534	0.0	0	64	0.47914164697739897	0.0
40979728453	67	26.154072280531516	3.0	3	64	0.40865737938330493	0.046875
40979728454	64	30.547017262851355	0.0	0	64	0.4772971447320524	0.0
40979728455	64	28.211563068348784	0.0	0	64	0.44080567294294976	0.0
40979728456	64	26.621433195065336	0.0	0	64	0.4159598936728959	0.0
40979728457	64	25.15399954537718	0.0	0	64	0.3930312428965184	0.0
40979728458	64	25.59472466652561	0.0	0	64	0.39991757291446267	0.0
40979728459	64	29.17641265272415	0.0	0	64	0.45588144769881483	0.0
40979728460	64	32.456272794376716	0.0	0	64	0.5071292624121362	0.0
40979728461	64	27.398111876335395	0.0	0	64	0.42809549806774055	0.0
40979728462	51	20.330411186329474	0.0	0	51	0.3986355134574407	0.0
40979728463	64	25.777926870479483	0.0	0	64	0.4027801073512419	0.0
40979728464	64	32.47463105739377	0.0	0	64	0.5074161102717777	0.0
40979728465	64	31.84473225481452	0.0	0	64	0.4975739414814769	0.0
40979728466	64	26.66796132243528	0.0	0	64	0.4166868956630512	0.0
40979728467	51	20.71905917358924	0.0	0	51	0.40625606222724003	0.0
40979728468	64	30.210747018139728	0.0	0	64	0.47204292215843324	0.0
40979728469	64	31.317883427244503	0.0	0	64	0.48934192855069536	0.0
40979728470	60	29.66639892185592	0.0	0	60	0.494439982030932	0.0
40979728471	64	32.130792646801915	0.0	0	64	0.5020436351062799	0.0
40979728472	64	28.413626948026177	0.0	0	64	0.443962921062909	0.0
40979728473	64	38.20843894170463	0.0	0	64	0.5970068584641348	0.0
40979728474	64	35.721599170616884	0.0	0	64	0.5581499870408888	0.0
40979728475	64	34.449185220126694	0.0	0	64	0.5382685190644796	0.0
40979728476	64	27.699477003887228	0.0	0	64	0.43280432818573794	0.0
40979728477	64	29.390230398438	0.0	0	64	0.45922234997559375	0.0
40979728478	51	22.286965927795908	0.0	0	51	0.43699933191756685	0.0
40979728479	64	29.58048735026619	0.0	0	64	0.4621951148479092	0.0
40979728480	64	31.319615130980623	0.0	0	64	0.4893689864215722	0.0
40979728481	51	24.20271073914881	0.0	0	51	0.4745629556695845	0.0
40979728482	64	31.10905900046384	0.0	0	64	0.4860790468822475	0.0
40979728483	64	35.748833932939334	0.0	0	64	0.5585755302021771	0.0
40979728484	64	30.449601283196515	0.0	0	64	0.47577502004994554	0.0
40979728485	64	33.41958549730724	0.0	0	64	0.5221810233954256	0.0
40979728486	64	36.863323562615065	0.0	0	64	0.5759894306658604	0.0
40979728487	64	38.664324002623395	0.0	0	64	0.6041300625409906	0.0
40979728488	64	41.26955445839514	0.0	0	64	0.6448367884124241	0.0
40979728489	64	36.86594483864825	0.0	0	64	0.5760303881038789	0.0
40979728490	64	37.224720037107296	0.0	0	64	0.5816362505798015	0.0
40979728491	64	42.087837985198	0.0	0	64	0.6576224685187188	0.0
40979728492	25	12.104429806978663	0.0	0	25	0.4841771922791465	0.0
40979728493	32	17.08432421397131	0.0	0	32	0.5338851316866035	0.0
40979728494	64	33.96437562547175	0.0	0	64	0.5306933691479961	0.0
40979728495	64	36.85005316298992	0.0	0	64	0.5757820806717175	0.0
40979728496	64	39.892169178146716	0.0	0	64	0.6233151434085424	0.0
40979728497	64	34.17975633386044	0.0	0	64	0.5340586927165694	0.0
40979728498	64	37.068632981559	0.0	0	64	0.5791973903368594	0.0
40979728499	64	43.21122457445437	0.0	0	64	0.6751753839758495	0.0
40979728500	64	40.8262496562786	0.0	0	64	0.6379101508793531	0.0
40979728501	64	36.42090080071625	0.0	0	64	0.5690765750111914	0.0
40979728502	3	1.4967672765102775	0.0	0	3	0.49892242550342586	0.0
40979728503	2	0.9979293526931006	0.0	0	2	0.4989646763465503	0.0
40979728504	64	32.17844811285438	0.0	0	64	0.5027882517633497	0.0
40979728505	64	32.17882055731542	0.0	0	64	0.5027940712080534	0.0
40979728506	64	32.177563824254776	0.0	0	64	0.5027744347539809	0.0
40979728507	64	32.177763592986224	0.0	0	64	0.5027775561404098	0.0
40979728508	64	32.18966382868409	0.0	0	64	0.5029634973231889	0.0
40979728509	64	35.42595774885709	0.0	0	64	0.553530589825892	0.0
40979728510	64	35.426337950235656	0.0	0	64	0.5535365304724321	0.0
40979728511	64	37.59894240612386	0.0	0	64	0.5874834750956853	0.0
40979728512	64	34.941572536284944	0.0	0	64	0.5459620708794523	0.0
40979728513	64	39.99292737748959	0.0	0	64	0.6248894902732749	0.0
40979728514	65	37.02642107291435	1.0	1	64	0.5785378292642868	0.015625
40979728515	64	32.41075891207995	0.0	0	64	0.5064181080012492	0.0
40979728516	64	36.61508309007716	0.0	0	64	0.5721106732824556	0.0
40979728517	64	36.88014854159831	0.0	0	64	0.5762523209624736	0.0
40979728518	64	36.26868545879245	0.0	0	64	0.566698210293632	0.0
40979728519	64	32.85881679352411	0.0	0	64	0.5134190123988143	0.0
40979728520	64	38.00469518349382	0.0	0	64	0.593823362242091	0.0
40979728521	64	36.2014854834347	0.0	0	64	0.5656482106786672	0.0
40979728522	55	28.544838693213457	0.0	0	55	0.5189970671493356	0.0
40979728523	64	41.641188152916044	0.0	0	64	0.6506435648893132	0.0
40979728524	64	41.010020251175746	0.0	0	64	0.640781566424621	0.0
40979728525	64	34.33204508545313	0.0	0	64	0.5364382044602052	0.0
40979728526	51	26.828844064148136	0.0	0	51	0.526055765963689	0.0
40979728527	64	37.21303081205033	0.0	0	64	0.5814536064382864	0.0
40979728528	64	36.657641137114645	0.0	0	64	0.5727756427674163	0.0
40979728529	64	39.65924097325257	0.0	0	64	0.6196756402070714	0.0
40979728530	64	39.05161610318094	0.0	0	64	0.6101815016122022	0.0
40979728531	64	34.26487332728819	0.0	0	64	0.535388645738878	0.0
40979728532	64	38.43211100801032	0.0	0	64	0.6005017345001612	0.0
40979728533	64	44.74162224800865	0.0	0	64	0.6990878476251352	0.0
40979728534	64	40.69630824686245	0.0	0	64	0.6358798163572258	0.0
40979728535	64	35.34721064617822	0.0	0	64	0.5523001663465347	0.0
40979728536	64	36.17268269957816	0.0	0	64	0.5651981671809088	0.0
40979728537	60	33.385840207948355	0.0	0	60	0.5564306701324726	0.0
40979728538	55	31.426591904970795	0.0	0	55	0.5713925800903781	0.0
40979728539	64	39.49538890598909	0.0	0	64	0.6171154516560795	0.0
40979728540	51	30.855310217119506	0.0	0	51	0.6050060826886178	0.0
40979728541	64	40.39299916832355	0.0	0	64	0.6311406120050554	0.0
40979728542	64	40.57341034341111	0.0	0	64	0.6339595366157986	0.0
40979728543	64	39.939397339219916	0.0	0	64	0.6240530834253112	0.0
40979728544	64	39.26976670564611	0.0	0	64	0.6135901047757205	0.0
40979728545	64	42.25634633894851	0.0	0	64	0.6602554115460705	0.0
40979728546	65	43.57311558054458	1.0	1	64	0.6808299309460091	0.015625
40979728547	64	43.60760553398732	0.0	0	64	0.6813688364685518	0.0
40979728548	64	47.72945096987328	0.0	0	64	0.74577267140427	0.0
40979728549	64	43.671070947016226	0.0	0	64	0.6823604835471285	0.0
40979728550	64	45.678649792710445	0.0	0	64	0.7137289030111007	0.0
40979728551	64	46.70363381233612	0.0	0	64	0.7297442783177519	0.0
40979728552	27	16.531686670895123	0.0	0	27	0.6122846915146342	0.0
40979728553	33	22.47217829758369	0.0	0	33	0.6809750999267784	0.0
40979728554	64	42.80867450467585	0.0	0	64	0.6688855391355601	0.0
40979728555	64	46.0679685847088	0.0	0	64	0.719812009136075	0.0
40979728556	64	40.93370140094429	0.0	0	64	0.6395890843897545	0.0
40979728557	64	43.031186405923336	0.0	0	64	0.6723622875925521	0.0
40979728558	64	46.17298544420045	0.0	0	64	0.721452897565632	0.0
40979728559	64	49.699480601298255	0.0	0	64	0.7765543843952852	0.0
40979728560	64	49.73524111535034	0.0	0	64	0.7771131424273491	0.0
40979728561	64	47.59323859851159	0.0	0	64	0.7436443531017436	0.0
40979728562	64	47.63051913114428	0.0	0	64	0.7442268614241294	0.0
40979728563	64	45.28729599025821	0.0	0	64	0.7076139998477845	0.0
40979728564	3	1.8562871390532019	0.0	0	3	0.6187623796844006	0.0
40979728565	3	1.9761966057077873	0.0	0	3	0.6587322019025957	0.0
40979728566	64	39.868435258855094	0.0	0	64	0.6229443009196108	0.0
40979728567	64	39.868828388429556	0.0	0	64	0.6229504435692118	0.0
40979728568	64	39.8746983514639	0.0	0	64	0.6230421617416234	0.0
40979728569	64	40.229482784477085	0.0	0	64	0.6285856685074545	0.0
40979728570	64	39.874904528083746	0.0	0	64	0.6230453832513085	0.0
40979728571	64	40.22983195818551	0.0	0	64	0.6285911243466485	0.0
40979728572	64	39.99647408751109	0.0	0	64	0.6249449076173608	0.0
40979728573	64	43.805331160796854	0.0	0	64	0.6844582993874508	0.0
40979728574	64	45.8893723034875	0.0	0	64	0.7170214422419922	0.0
40979728575	64	40.09917196591543	0.0	0	64	0.6265495619674286	0.0
40979728576	64	46.682530275024334	0.0	0	64	0.7294145355472552	0.0
40979728577	64	40.40883564620632	0.0	0	64	0.6313880569719738	0.0
40979728578	64	41.08236722236925	0.0	0	64	0.6419119878495195	0.0
40979728579	64	46.86825741184713	0.0	0	64	0.7323165220601114	0.0
40979728580	64	42.14502490420207	0.0	0	64	0.6585160141281573	0.0
40979728581	64	45.06856283204387	0.0	0	64	0.7041962942506854	0.0
40979728582	51	32.493984341818795	0.0	0	51	0.6371369478787999	0.0
40979728583	64	41.182643818310055	0.0	0	64	0.6434788096610946	0.0
40979728584	64	43.00820524489037	0.0	0	64	0.672003206951412	0.0
40979728585	51	33.25559537939534	0.0	0	51	0.6520704976352028	0.0
40979728586	64	45.22220724550059	0.0	0	64	0.7065969882109467	0.0
40979728587	64	46.46843721494734	0.0	0	64	0.7260693314835522	0.0
40979728588	64	48.5267198828683	0.0	0	64	0.7582299981698172	0.0
40979728589	64	47.91480903480788	0.0	0	64	0.7486688911688731	0.0
40979728590	64	49.4210789849815	0.0	0	64	0.7722043591403359	0.0
40979728591	64	41.885847290351336	0.0	0	64	0.6544663639117396	0.0
40979728592	64	48.483887645658626	0.0	0	64	0.757560744463416	0.0
40979728593	64	47.57714659202639	0.0	0	64	0.7433929155004123	0.0
40979728594	57	47.200510472625616	0.0	0	57	0.828079131098695	0.0
40979728595	64	52.189769839890474	0.0	0	64	0.8154651537482887	0.0
40979728596	64	50.34343538813705	0.0	0	64	0.7866161779396414	0.0
40979728597	64	42.96963031880032	0.0	0	64	0.671400473731255	0.0
40979728598	64	45.58915261409244	0.0	0	64	0.7123305095951944	0.0
40979728599	51	34.464709397764175	0.0	0	51	0.6757786156424348	0.0
40979728600	64	45.75304459013459	0.0	0	64	0.714891321720853	0.0
40979728601	64	47.627690666719424	0.0	0	64	0.744182666667491	0.0
40979728602	51	37.43765293212606	0.0	0	51	0.7340716261201189	0.0
40979728603	64	45.445228630085644	0.0	0	64	0.7100816973450882	0.0
40979728604	64	48.8188024533444	0.0	0	64	0.7627937883335062	0.0
40979728605	64	48.140928352387974	0.0	0	64	0.7522020055060621	0.0
40979728606	64	51.14764651749252	0.0	0	64	0.7991819768358206	0.0
40979728607	64	46.44165089239402	0.0	0	64	0.7256507951936566	0.0
40979728608	57	49.86767058417234	0.0	0	57	0.8748714137574094	0.0
40979728609	64	54.66512184093913	0.0	0	64	0.8541425287646739	0.0
40979728610	64	55.02668626955898	0.0	0	64	0.859791972961859	0.0
40979728611	64	53.677633524093565	0.0	0	64	0.838713023813962	0.0
40979728612	64	52.89263425594185	0.0	0	64	0.8264474102490914	0.0
40979728613	33	25.072685689926107	0.0	0	33	0.759778354240185	0.0
40979728614	29	24.03113266959601	0.0	0	29	0.8286597472274486	0.0
40979728615	64	51.712811932072796	0.0	0	64	0.8080126864386374	0.0
40979728616	64	49.82654633026976	0.0	0	64	0.778539786410465	0.0
40979728617	64	49.016082563281266	0.0	0	64	0.7658762900512698	0.0
40979728618	64	51.93505290330181	0.0	0	64	0.8114852016140908	0.0
40979728619	57	51.81388895196849	0.0	0	57	0.9090155956485699	0.0
40979728620	64	52.878709239927765	0.0	0	64	0.8262298318738713	0.0
40979728621	64	54.68077530053561	0.0	0	64	0.8543871140708689	0.0
40979728622	64	52.931129364474614	0.0	0	64	0.8270488963199158	0.0
40979728623	2	1.4771907277629972	0.0	0	2	0.7385953638814986	0.0
40979728624	3	2.3363511864598845	0.0	0	3	0.7787837288199615	0.0
40979728625	64	47.51362541912649	0.0	0	64	0.7424003971738514	0.0
40979728626	64	47.514030577544105	0.0	0	64	0.7424067277741266	0.0
40979728627	64	47.52011267541032	0.0	0	64	0.7425017605532862	0.0
40979728628	64	47.52586133824141	0.0	0	64	0.7425915834100221	0.0
40979728629	64	47.52040237941759	0.0	0	64	0.7425062871783998	0.0
40979728630	64	47.52618859022633	0.0	0	64	0.7425966967222865	0.0
40979728631	64	47.51347252915759	0.0	0	64	0.7423980082680873	0.0
40979728632	64	50.05653466341612	0.0	0	64	0.7821333541158769	0.0
40979728633	64	52.725074831770435	0.0	0	64	0.823829294246413	0.0
40979728634	64	52.724727794024844	0.0	0	64	0.8238238717816382	0.0
40979728635	64	52.705209141111354	0.0	0	64	0.8235188928298649	0.0
40979728636	64	49.461024187417934	0.0	0	64	0.7728285029284052	0.0
40979728637	64	55.42067472591661	0.0	0	64	0.8659480425924471	0.0
40979728638	64	49.07840894604177	0.0	0	64	0.7668501397819026	0.0
40979728639	64	51.2605504758363	0.0	0	64	0.8009461011849421	0.0
40979728640	64	50.62535605937797	0.0	0	64	0.7910211884277808	0.0
40979728641	64	48.058647692721756	0.0	0	64	0.7509163701987774	0.0
40979728642	64	48.423138727636164	0.0	0	64	0.7566115426193151	0.0
40979728643	64	56.89734427875619	0.0	0	64	0.8890210043555654	0.0
40979728644	64	51.03855480307209	0.0	0	64	0.7974774187980014	0.0
40979728645	64	53.98579595979265	0.0	0	64	0.8435280618717601	0.0
40979728646	51	38.58803258265108	0.0	0	51	0.7566280898559036	0.0
40979728647	64	48.6510763116554	0.0	0	64	0.7601730673696157	0.0
40979728648	64	49.60594746475831	0.0	0	64	0.7750929291368486	0.0
40979728649	51	38.9843363102659	0.0	0	51	0.7643987511816843	0.0
40979728650	64	54.322353435291454	0.0	0	64	0.848786772426429	0.0
40979728651	64	53.86226727280044	0.0	0	64	0.8415979261375068	0.0
40979728652	64	53.83460419372687	0.0	0	64	0.8411656905269823	0.0
40979728653	64	54.459831870498604	0.0	0	64	0.8509348729765407	0.0
40979728654	64	58.21718042567716	0.0	0	64	0.9096434441512056	0.0
40979728655	64	57.60521111968744	0.0	0	64	0.9000814237451162	0.0
40979728656	64	50.89491377792687	0.0	0	64	0.7952330277801073	0.0
40979728657	41	35.09952968347505	0.0	0	41	0.8560860898408548	0.0
40979728658	49	41.327449505277286	0.0	0	49	0.8434173368423936	0.0
40979728659	64	50.65740190928094	0.0	0	64	0.7915219048325147	0.0
40979728660	64	52.31448556010453	0.0	0	64	0.8174138368766333	0.0
40979728661	51	40.58733558426339	0.0	0	51	0.7958301094953606	0.0
40979728662	64	52.54070245745894	0.0	0	64	0.820948475897796	0.0
40979728663	64	54.217877199226635	0.0	0	64	0.8471543312379162	0.0
40979728664	51	42.41575998793069	0.0	0	51	0.8316815683907979	0.0
40979728665	64	57.886856364146134	0.0	0	64	0.9044821306897833	0.0
40979728666	64	57.624472220454734	0.0	0	64	0.9003823784446052	0.0
40979728667	64	54.372431195579345	0.0	0	64	0.8495692374309273	0.0
40979728668	64	57.85184501094175	0.0	0	64	0.9039350782959649	0.0
40979728669	64	57.09253136998633	0.0	0	64	0.8920708026560364	0.0
40979728670	64	55.37441505534504	0.0	0	64	0.8652252352397662	0.0
40979728671	41	36.96859966053929	0.0	0	41	0.9016731624521778	0.0
40979728672	41	36.99308779953787	0.0	0	41	0.9022704341350699	0.0
40979728673	41	37.03489286347847	0.0	0	41	0.9032900698409383	0.0
40979728674	33	30.492266240793157	0.0	0	33	0.924008067902823	0.0
40979728675	49	43.71085865030085	0.0	0	49	0.8920583398020582	0.0
40979728676	33	31.024155828154367	0.0	0	33	0.9401259341864959	0.0
40979728677	43	38.65165437064081	0.0	0	43	0.8988756830381585	0.0
40979728678	33	30.039334766751743	0.0	0	33	0.9102828717197498	0.0
40979728679	64	60.688707704282926	0.0	0	64	0.9482610578794207	0.0
40979728680	64	55.84796194298868	0.0	0	64	0.8726244053591982	0.0
40979728681	64	58.793645420731835	0.0	0	64	0.9186507096989349	0.0
40979728682	64	57.97333700119365	0.0	0	64	0.9058333906436508	0.0
40979728683	64	60.91743683114853	0.0	0	64	0.9518349504866958	0.0
40979728684	64	56.06967690527319	0.0	0	64	0.8760887016448936	0.0
40979728685	33	31.489614386766206	0.0	0	33	0.9542307389929153	0.0
40979728686	33	31.50820288408939	0.0	0	33	0.9547940267905876	0.0
40979728687	49	45.208955395026074	0.0	0	49	0.9226317427556342	0.0
40979728688	2	1.7182049008879534	0.0	0	2	0.8591024504439767	0.0
40979728689	3	2.699215404653656	0.0	0	3	0.8997384682178854	0.0
40979728690	64	55.2636026542598	0.0	0	64	0.8634937914728094	0.0
40979728691	64	55.26399443480513	0.0	0	64	0.8634999130438301	0.0
40979728692	64	55.23659171835508	0.0	0	64	0.8630717455992981	0.0
40979728693	64	55.23675742410081	0.0	0	64	0.8630743347515751	0.0
40979728694	64	55.25160866103687	0.0	0	64	0.8633063853287011	0.0
40979728695	64	57.56135092227503	0.0	0	64	0.8993961081605474	0.0
40979728696	64	57.561694924705066	0.0	0	64	0.8994014831985166	0.0
40979728697	64	60.25696239558796	0.0	0	64	0.9415150374310619	0.0
40979728698	64	61.69889658410084	0.0	0	64	0.9640452591265756	0.0
40979728699	64	58.42619158057424	0.0	0	64	0.9129092434464725	0.0
40979728700	64	55.47856167862394	0.0	0	64	0.8668525262284991	0.0
40979728701	64	59.26216661274297	0.0	0	64	0.925971353324109	0.0
40979728702	55	51.34592715737303	0.0	0	55	0.9335623119522369	0.0
40979728703	55	50.705383503127386	0.0	0	55	0.9219160636932252	0.0
40979728704	64	55.81487891451719	0.0	0	64	0.872107483039331	0.0
40979728705	64	57.42818477112483	0.0	0	64	0.8973153870488255	0.0
40979728706	64	60.029012895144696	0.0	0	64	0.9379533264866359	0.0
40979728707	61	60.01603051324039	0.0	0	61	0.9838693526760719	0.0
40979728708	51	44.77929838343591	0.0	0	51	0.8780254584987432	0.0
40979728709	51	45.232793077142205	0.0	0	51	0.8869175113165139	0.0
40979728710	64	59.50474419821913	0.0	0	64	0.9297616280971739	0.0
40979728711	64	58.89340938560042	0.0	0	64	0.9202095216500066	0.0
40979728712	31	28.95112029000529	0.0	0	31	0.9339071061292029	0.0
40979728713	31	28.95556241811675	0.0	0	31	0.9340504005844112	0.0
40979728714	9	8.057314627095744	0.0	0	9	0.895257180788416	0.0
40979728715	64	57.3297877100298	0.0	0	64	0.8957779329692156	0.0
40979728716	33	29.56536709443632	0.0	0	33	0.8959202149829187	0.0
40979728717	17	15.239512366437685	0.0	0	17	0.8964419039080991	0.0
40979728718	25	22.42718963729778	0.0	0	25	0.8970875854919111	0.0
40979728719	1	0.9082157673176556	0.0	0	1	0.9082157673176556	0.0
40979728720	9	8.185466886618373	0.0	0	9	0.9094963207353748	0.0
40979728721	64	58.42272783584473	0.0	0	64	0.9128551224350739	0.0
40979728722	28	25.776678344012776	0.0	0	28	0.9205956551433134	0.0
40979728723	51	46.783656534483555	0.0	0	51	0.9173265987153638	0.0
40979728724	28	25.781588472815827	0.0	0	28	0.9207710168862795	0.0
40979728725	27	24.86307702754021	0.0	0	27	0.9208547047237116	0.0
40979728726	27	24.86325228890898	0.0	0	27	0.9208611958855178	0.0
40979728727	33	30.85599462456856	0.0	0	33	0.9350301401384412	0.0
40979728728	14	13.130946436123581	0.0	0	14	0.9379247454373987	0.0
40979728729	54	50.729037042766244	0.0	0	54	0.9394266119030786	0.0
40979728730	30	28.23856838329874	0.0	0	30	0.9412856127766247	0.0
40979728731	25	23.60620861431549	0.0	0	25	0.9442483445726196	0.0
40979728732	1	0.9470923138390379	0.0	0	1	0.9470923138390379	0.0
40979728733	1	0.9527252974215781	0.0	0	1	0.9527252974215781	0.0
40979728734	5	4.805992859588775	0.0	0	5	0.961198571917755	0.0
40979728735	9	8.657137836827282	0.0	0	9	0.9619042040919202	0.0
40979728736	24	23.138738540840624	0.0	0	24	0.9641141058683593	0.0
40979728737	7	6.760282693552517	0.0	0	7	0.9657546705075024	0.0
40979728738	25	24.169118339758832	0.0	0	25	0.9667647335903533	0.0
40979728739	1	0.9693530933125702	0.0	0	1	0.9693530933125702	0.0
40979728740	41	39.754288619837524	0.0	0	41	0.9696167956057933	0.0
40979728741	17	16.49221272930404	0.0	0	17	0.9701301605472965	0.0
40979728742	26	25.333980155331712	0.0	0	26	0.9743838521281428	0.0
40979728743	2	1.9496210689571982	0.0	0	2	0.9748105344785991	0.0
40979728744	42	40.95078854125658	0.0	0	42	0.9750187747918233	0.0
40979728745	25	24.385233032417393	0.0	0	25	0.9754093212966957	0.0
40979728746	25	24.399508683588135	0.0	0	25	0.9759803473435253	0.0
40979728747	50	48.99422199578517	0.0	0	50	0.9798844399157034	0.0
40979728748	17	16.659375089232654	0.0	0	17	0.9799632405430972	0.0
40979728749	17	16.67288831410255	0.0	0	17	0.9807581361236795	0.0
40979728750	3	2.9428372511013134	0.0	0	3	0.9809457503671045	0.0
40979728751	1	0.9809880199467448	0.0	0	1	0.9809880199467448	0.0
40979728752	64	63.047984067066544	0.0	0	64	0.9851247510479147	0.0
40979728753	64	63.04845656452191	0.0	0	64	0.9851321338206549	0.0
40979728754	64	63.054315510485	0.0	0	64	0.9852236798513281	0.0
40979728755	64	63.06028968602019	0.0	0	64	0.9853170263440655	0.0
40979728756	64	63.05455766121516	0.0	0	64	0.9852274634564869	0.0
40979728757	64	63.06062728056185	0.0	0	64	0.985322301258779	0.0
40979728758	64	63.062212164960194	0.0	0	64	0.985347065077503	0.0
40979728759	5	4.933383704582405	0.0	0	5	0.9866767409164809	0.0
40979728760	5	4.933412371451576	0.0	0	5	0.9866824742903152	0.0
40979728761	3	2.960206113665148	0.0	0	3	0.986735371221716	0.0
40979728762	2	1.973937094321644	0.0	0	2	0.986968547160822	0.0
40979728763	29	28.631333270228744	0.0	0	29	0.9872873541458188	0.0
40979728764	49	48.400195002161816	0.0	0	49	0.9877590816767717	0.0
40979728765	64	63.290109727781676	0.0	0	64	0.9889079644965887	0.0
40979728766	13	12.863906905297927	0.0	0	13	0.9895313004075329	0.0
40979728767	7	6.946167554365313	0.0	0	7	0.9923096506236161	0.0
40979728768	7	6.9484921564073385	0.0	0	7	0.9926417366296197	0.0
40979728769	64	63.61377284552739	0.0	0	64	0.9939652007113655	0.0
40979728770	25	24.86559049366148	0.0	0	25	0.9946236197464592	0.0
40979728771	45	44.82108287468217	0.0	0	45	0.996024063881826	0.0
40979728772	21	20.947825061498865	0.0	0	21	0.9975154791189935	0.0
40979728773	22	21.98569039826263	0.0	0	22	0.9993495635573922	0.0
47200594414	1	0.949701785867256	0.0	0	1	0.949701785867256	0.0
50568891850	64	26.83415305589951	0.0	0	64	0.41928364149842984	0.0
50568891851	71	32.38553240446682	7.0	7	64	0.5060239438197941	0.109375
50568891852	64	20.078961036216263	0.0	0	64	0.3137337661908791	0.0
50568891853	64	23.63737399786809	0.0	0	64	0.3693339687166889	0.0
50568891854	51	16.22902445182763	0.0	0	51	0.3182161657221104	0.0
50568891855	56	20.299917057191863	0.0	0	56	0.3624985188784261	0.0
50568891856	64	24.69805040557437	0.0	0	64	0.38590703758709954	0.0
50568891857	59	22.66727770191986	0.0	0	59	0.38419114749016714	0.0
50568891858	64	26.60200121727395	0.0	0	64	0.4156562690199055	0.0
50568891859	64	24.618892186265846	0.0	0	64	0.38467019041040384	0.0
50568891860	64	27.579260408265686	0.0	0	64	0.43092594387915134	0.0
50568891861	64	29.788775200707438	0.0	0	64	0.4654496125110537	0.0
50568891862	64	27.995283681716355	0.0	0	64	0.43742630752681805	0.0
50568891863	64	35.66160739519786	0.0	0	64	0.5572126155499666	0.0
50568891864	68	29.0102170970107	4.0	4	64	0.45328464214079217	0.0625
50568891865	64	32.879870866434196	0.0	0	64	0.5137479822880343	0.0
50568891866	31	12.081042138498974	0.0	0	31	0.38971103672577334	0.0
51624359187	15	1.3443049498352275	0.0	0	15	0.08962032998901517	0.0
51624359189	43	3.875578143299721	0.0	0	43	0.0901297242627842	0.0
52584053131	16	0.7277641213559632	0.0	0	16	0.0454852575847477	0.0
52584053136	20	1.27598775351349	0.0	0	20	0.0637993876756745	0.0
52584053139	2	0.0	2.0	2	0	0.0	inf
52584053140	1	0.0	1.0	1	0	0.0	inf
52584053148	11	0.0	11.0	11	0	0.0	inf
52584053154	1	0.38271405776048123	0.0	0	1	0.38271405776048123	0.0
52584053155	20	13.156088292158342	0.0	0	20	0.6578044146079172	0.0
52584053160	4	0.1919787626839654	0.0	0	4	0.04799469067099135	0.0
52584053162	1	0.06510403375450773	0.0	0	1	0.06510403375450773	0.0
52584053164	1	0.7734749619067898	0.0	0	1	0.7734749619067898	0.0
52584053173	74	1.6258075344626353	51.0	51	23	0.0318785791071105	2.217391304347826
52584053174	49	1.0794129609773087	34.0	34	15	0.02767725540967458	2.2666666666666666
52584053187	1	0.04974724814918823	0.0	0	1	0.04974724814918823	0.0
52584053189	1	0.04977434115103213	0.0	0	1	0.04977434115103213	0.0
52584053191	1	0.6119168062724458	0.0	0	1	0.6119168062724458	0.0
52584053194	17	0.9460839145587899	0.0	0	17	0.055651994974046465	0.0
53250271473	19	0.0	19.0	19	0	0.0	inf
53250271474	88	11.048115035311959	33.0	33	55	0.17262679742674936	0.6
53250271476	18	0.0	18.0	18	0	0.0	inf
53250271477	89	11.074735090024085	34.0	34	55	0.17304273578162632	0.6181818181818182
53250271481	3	0.0	3.0	3	0	0.0	inf
53250271482	75	6.8505878282047385	36.0	36	39	0.10704043481569904	0.9230769230769231
53250271501	84	4.856892740716826	53.0	53	31	0.08373953001235906	1.7096774193548387
53250271505	42	0.9916366938623447	35.0	35	7	0.02833247696749556	5.0
53250271506	62	9.73971539532287	0.0	0	62	0.15709218379553017	0.0
53250271512	38	0.9978254774495164	31.0	31	7	0.02850929935570047	4.428571428571429
53250271522	12	0.7176602303737057	0.0	0	12	0.05980501919780881	0.0
53250271524	4	0.21223398550648062	0.0	0	4	0.053058496376620155	0.0
53250271542	29	4.24837649964262	0.0	0	29	0.1464957413669869	0.0
53250271545	59	8.677525826600746	0.0	0	59	0.14707670892543637	0.0
53250271546	59	8.677888940276906	0.0	0	59	0.14708286339452384	0.0
53250271548	36	0.0	36.0	36	0	0.0	inf
53250271549	110	6.850059683297426	64.0	64	46	0.10703218255152228	1.391304347826087
53250271550	61	2.8323125304796273	42.0	42	19	0.06586773326696807	2.210526315789474
53250271551	103	10.488843753871434	40.0	40	63	0.16388818365424115	0.6349206349206349
53250271554	19	2.8529298552064537	0.0	0	19	0.15015420290560283	0.0
53250271556	57	5.931099123738125	0.0	0	57	0.10405437059189693	0.0
53250271557	57	5.272581679779605	0.0	0	57	0.09250143297858955	0.0
53250271562	39	1.7711909431579826	0.0	0	39	0.045415152388666225	0.0
53250271563	8	0.31169082140810317	0.0	0	8	0.038961352676012896	0.0
53250271564	27	4.254073112432811	0.0	0	27	0.15755826342343743	0.0
53250271565	71	8.087293314683759	20.0	20	51	0.13707276804548743	0.39215686274509803
53250271570	39	1.7718814212381704	0.0	0	39	0.04543285695482488	0.0
53250271571	64	2.5179619857079354	0.0	0	64	0.03934315602668649	0.0
53250271572	28	1.1156813844996103	0.0	0	28	0.03984576373212894	0.0
53250271573	47	1.9091243384417316	0.0	0	47	0.04061966677535599	0.0
53250271574	42	1.7762454180787446	0.0	0	42	0.04229155757330344	0.0
53250271575	64	3.87567606033128	0.0	0	64	0.06055743844267625	0.0
53250271576	51	2.375694946739206	0.0	0	51	0.04658225385763149	0.0
53250271577	6	0.26234378523636	0.0	0	6	0.04372396420606	0.0
53250271578	38	1.7151313628364502	0.0	0	38	0.04513503586411711	0.0
53250271579	35	1.7265121098973097	0.0	0	35	0.04932891742563742	0.0
53250271580	64	8.97608441145119	0.0	0	64	0.14025131892892484	0.0
53250271581	64	8.367490826039772	0.0	0	64	0.13074204415687143	0.0
53250271582	38	1.845438583987069	0.0	0	38	0.04856417326281761	0.0
53250271583	2	0.09939309427487772	0.0	0	2	0.04969654713743886	0.0
53250271584	1	0.050003338847115206	0.0	0	1	0.050003338847115206	0.0
53250271585	52	7.820482893973281	0.0	0	52	0.1503939018071785	0.0
53250271586	55	3.0142799230963457	0.0	0	55	0.05480508951084265	0.0
53250271587	41	2.228122850687432	0.0	0	41	0.054344459772864194	0.0
53250271588	13	0.6944169080117267	0.0	0	13	0.053416685231671285	0.0
53250271589	45	2.4579055693094074	0.0	0	45	0.05462012376243128	0.0
53250271590	10	0.54910747108075	0.0	0	10	0.054910747108074996	0.0
53250271591	3	0.16743902332089153	0.0	0	3	0.05581300777363051	0.0
53250271592	7	0.38766218421757326	0.0	0	7	0.055380312031081895	0.0
53250271593	15	0.8409736347993757	0.0	0	15	0.05606490898662505	0.0
53250271594	2	0.11158269672273607	0.0	0	2	0.05579134836136804	0.0
53250271595	41	2.3047534390687385	0.0	0	41	0.05621349851387167	0.0
53250271596	61	3.580196746906171	0.0	0	61	0.058691749949281495	0.0
53250271597	32	0.9034055790898686	16.0	16	16	0.05646284869311679	1.0
53250271598	82	12.885593897711662	18.0	18	64	0.2013374046517447	0.28125
53250271599	1	0.056802108442606566	0.0	0	1	0.056802108442606566	0.0
53250271600	64	3.684347866948853	0.0	0	64	0.05756793542107583	0.0
53250271601	64	5.984146996510287	0.0	0	64	0.09350229682047323	0.0
53250271602	16	0.4640248778960003	8.0	8	8	0.058003109737000035	1.0
53250271603	128	11.055711980480446	64.0	64	64	0.17274549969500697	1.0
53250271604	2	0.11716801460908621	0.0	0	2	0.058584007304543106	0.0
53250271605	105	9.186293616641441	41.0	41	64	0.14353583776002252	0.640625
53250271606	3	0.17820247713226983	0.0	0	3	0.05940082571075661	0.0
53250271607	50	5.265062191367427	2.0	2	48	0.10968879565348806	0.041666666666666664
53250271608	66	3.839544675685526	26.0	26	40	0.09598861689213814	0.65
53250271609	2	0.12036206593020168	0.0	0	2	0.06018103296510084	0.0
53250271610	64	2.408621262992556	32.0	32	32	0.07526941446851737	1.0
53250271611	28	1.8182379970694593	0.0	0	28	0.06493707132390926	0.0
53250271612	106	16.34841611613162	42.0	42	64	0.25544400181455656	0.65625
53250271613	113	13.807058142930982	49.0	49	64	0.2157352834832966	0.765625
53250271614	64	4.82388863044988	0.0	0	64	0.07537325985077938	0.0
53250271615	64	6.589334058511441	0.0	0	64	0.10295834466424127	0.0
53250271616	51	4.0610777438746775	0.0	0	51	0.07962897537009171	0.0
53250271617	64	6.7498235582307275	0.0	0	64	0.10546599309735512	0.0
53250271618	64	9.361986449901663	0.0	0	64	0.14628103827971348	0.0
53250271619	51	6.919317490185251	0.0	0	51	0.13567289196441668	0.0
53250271620	64	8.983497326561505	0.0	0	64	0.1403671457275235	0.0
53250271621	64	12.521861242010656	0.0	0	64	0.1956540819064165	0.0
53250271622	64	11.657489596174875	0.0	0	64	0.18214827494023242	0.0
53250271623	64	9.968957490518015	0.0	0	64	0.155764960789344	0.0
53250271624	68	18.77016129666882	4.0	4	64	0.2932837702604503	0.0625
53250271625	87	19.126238324433864	23.0	23	64	0.2988474738192791	0.359375
53250271626	84	17.09728141399838	20.0	20	64	0.2671450220937247	0.3125
53250271627	64	16.05659480763182	0.0	0	64	0.2508842938692472	0.0
53250271628	33	6.708725722815434	0.0	0	33	0.20329471887319495	0.0
53250271629	25	3.221716536151845	0.0	0	25	0.12886866144607378	0.0
53250271630	64	15.533428155092485	0.0	0	64	0.24270981492332008	0.0
53250271631	64	10.442891099847715	0.0	0	64	0.16317017343512055	0.0
53250271632	64	13.312394789779665	0.0	0	64	0.20800616859030727	0.0
53250271633	93	12.521325565023995	29.0	29	64	0.19564571195349992	0.453125
53250271634	64	15.62818384928826	0.0	0	64	0.24419037264512905	0.0
53250271635	126	10.667735135216562	62.0	62	64	0.16668336148775878	0.96875
53250271636	94	16.315200320709195	30.0	30	64	0.2549250050110812	0.46875
53250271637	71	16.367073751198102	7.0	7	64	0.25573552736247035	0.109375
53250271638	2	0.2858621971232853	0.0	0	2	0.14293109856164266	0.0
53250271639	3	0.42902622804932855	0.0	0	3	0.1430087426831095	0.0
53250271640	64	9.410836706093539	0.0	0	64	0.14704432353271155	0.0
53250271641	64	9.41717804239234	0.0	0	64	0.14714340691238031	0.0
53250271642	64	9.411224551970562	0.0	0	64	0.14705038362454004	0.0
53250271643	64	9.417408613955752	0.0	0	64	0.14714700959305863	0.0
53250271644	64	9.427843354333966	0.0	0	64	0.14731005241146822	0.0
53250271645	64	13.564342506806417	0.0	0	64	0.21194285166885027	0.0
53250271646	64	13.564690668742971	0.0	0	64	0.21194829169910892	0.0
53250271647	64	15.227774913589062	0.0	0	64	0.2379339830248291	0.0
53250271648	88	16.38849802018732	24.0	24	64	0.2560702815654269	0.375
53250271649	84	12.973475951194823	20.0	20	64	0.2027105617374191	0.3125
53250271650	64	9.638412525465734	0.0	0	64	0.1506001957104021	0.0
53250271651	64	14.253321590784154	0.0	0	64	0.2227081498560024	0.0
53250271652	64	13.04956175664279	0.0	0	64	0.2038994024475436	0.0
53250271653	64	12.454304448446065	0.0	0	64	0.19459850700696976	0.0
53250271654	64	9.92183185565928	0.0	0	64	0.15502862274467624	0.0
53250271655	64	10.184763930018663	0.0	0	64	0.1591369364065416	0.0
53250271656	64	11.571534630814574	0.0	0	64	0.1808052286064777	0.0
53250271657	64	14.503881269247552	0.0	0	64	0.226623144831993	0.0
53250271658	65	18.236559004398515	1.0	1	64	0.2849462344437268	0.015625
53250271659	63	10.30430218882226	0.0	0	63	0.16356035220352794	0.0
53250271660	64	15.830200625364943	0.0	0	64	0.24734688477132724	0.0
53250271661	64	14.572536509787321	0.0	0	64	0.2276958829654269	0.0
53250271662	64	11.452305187264354	0.0	0	64	0.17894226855100553	0.0
53250271663	51	8.592519678400448	0.0	0	51	0.1684807780078519	0.0
53250271664	64	15.211023793951087	0.0	0	64	0.23767224678048574	0.0
53250271665	64	14.717411559336037	0.0	0	64	0.22995955561462558	0.0
53250271666	64	17.873933339523877	0.0	0	64	0.2792802084300606	0.0
53250271667	64	17.259794682262047	0.0	0	64	0.2696842919103445	0.0
53250271668	64	11.427965329051814	0.0	0	64	0.1785619582664346	0.0
53250271669	64	16.045575263122508	0.0	0	64	0.2507121134862892	0.0
53250271670	65	22.213269028112197	1.0	1	64	0.3470823285642531	0.015625
53250271671	64	19.97441285193079	0.0	0	64	0.3121002008114186	0.0
53250271672	72	18.095238084531513	8.0	8	64	0.2827380950708049	0.125
53250271673	64	12.491063918574406	0.0	0	64	0.1951728737277251	0.0
53250271674	64	14.042853709256788	0.0	0	64	0.2194195892071373	0.0
53250271675	52	10.364436061977095	0.0	0	52	0.19931607811494415	0.0
53250271676	63	14.093090767401971	0.0	0	63	0.22369985345082494	0.0
53250271677	64	15.962174009919414	0.0	0	64	0.24940896890499084	0.0
53250271678	51	11.948654939256592	0.0	0	51	0.23428735175012924	0.0
53250271679	64	18.409279926468916	0.0	0	64	0.2876449988510768	0.0
53250271680	64	18.632555827884573	0.0	0	64	0.29113368481069646	0.0
53250271681	64	17.804905542103988	0.0	0	64	0.2782016490953748	0.0
53250271682	64	20.470215685026876	0.0	0	64	0.31984712007854493	0.0
53250271683	64	15.812330486057448	0.0	0	64	0.24706766384464762	0.0
53250271684	64	18.779705452978128	0.0	0	64	0.29343289770278325	0.0
53250271685	70	25.08628918732912	6.0	6	64	0.3919732685520175	0.09375
53250271686	75	25.117720666879062	11.0	11	64	0.39246438541998535	0.171875
53250271687	66	25.179795568124504	2.0	2	64	0.3934343057519454	0.03125
53250271688	64	21.038044645219955	0.0	0	64	0.3287194475815618	0.0
53250271689	69	23.03006255223272	5.0	5	64	0.35984472737863626	0.078125
53250271690	64	22.23210563437758	0.0	0	64	0.34737665053714967	0.0
53250271691	64	24.057096084375477	0.0	0	64	0.3758921263183668	0.0
53250271692	29	10.124223212159789	0.0	0	29	0.3491111452468893	0.0
53250271693	25	6.19474921885592	0.0	0	25	0.24778996875423678	0.0
53250271694	64	19.238698564610512	0.0	0	64	0.30060466507203926	0.0
53250271695	64	22.117028614931545	0.0	0	64	0.3455785721083054	0.0
53250271696	75	21.317778877486347	11.0	11	64	0.3330902949607242	0.171875
53250271697	76	19.455209984254584	12.0	12	64	0.30398765600397787	0.1875
53250271698	64	24.941323303151815	0.0	0	64	0.3897081766117471	0.0
53250271699	105	23.174439697610623	41.0	41	64	0.362100620275166	0.640625
53250271700	64	18.80224098471932	0.0	0	64	0.29378501538623936	0.0
53250271701	2	0.5226534593716268	0.0	0	2	0.2613267296858134	0.0
53250271702	3	0.784118689382219	0.0	0	3	0.26137289646073963	0.0
53250271703	64	16.993716671954118	0.0	0	64	0.2655268229992831	0.0
53250271704	64	16.994114972806948	0.0	0	64	0.26553304645010856	0.0
53250271705	64	16.992997864262037	0.0	0	64	0.2655155916290943	0.0
53250271706	64	16.993212359894894	0.0	0	64	0.2655189431233577	0.0
53250271707	64	17.58225997455281	0.0	0	64	0.27472281210238764	0.0
53250271708	64	18.286442616909678	0.0	0	64	0.2857256658892137	0.0
53250271709	64	18.286757390375087	0.0	0	64	0.28573058422461073	0.0
53250271710	68	21.76668552309616	4.0	4	64	0.3401044612983775	0.0625
53250271711	71	19.407766315776694	7.0	7	64	0.30324634868401085	0.109375
53250271712	64	17.214231672820862	0.0	0	64	0.26897236988782597	0.0
53250271713	64	24.25434853921504	0.0	0	64	0.378974195925235	0.0
53250271714	64	22.67800270840083	0.0	0	64	0.35434379231876295	0.0
53250271715	64	21.97533176561159	0.0	0	64	0.3433645588376811	0.0
53250271716	64	17.527550772397877	0.0	0	64	0.2738679808187168	0.0
53250271717	64	18.962966676956768	0.0	0	64	0.2962963543274495	0.0
53250271718	64	20.377886781830295	0.0	0	64	0.31840448096609836	0.0
53250271719	64	23.31515973741598	0.0	0	64	0.36429937089712466	0.0
53250271720	51	14.273356022504503	0.0	0	51	0.27986972593146087	0.0
53250271721	56	16.072948413350623	0.0	0	56	0.2870169359526897	0.0
53250271722	64	23.67251665657519	0.0	0	64	0.36988307275898735	0.0
53250271723	64	23.048126277221442	0.0	0	64	0.36012697308158503	0.0
53250271724	64	20.323309447273534	0.0	0	64	0.31755171011364897	0.0
53250271725	59	18.214111384389437	0.0	0	59	0.3087137522777871	0.0
53250271726	64	27.38287121965499	0.0	0	64	0.42785736280710923	0.0
53250271727	64	26.7765441156136	0.0	0	64	0.4183835018064625	0.0
53250271728	64	31.469033823083375	0.0	0	64	0.49170365348567774	0.0
53250271729	64	19.007507122311754	0.0	0	64	0.29699229878612116	0.0
58691864693	4	1.9621273559950743	0.0	0	4	0.49053183899876857	0.0
58691864694	8	4.40767536872901	0.0	0	8	0.5509594210911263	0.0
58691864695	4	2.441847288552611	0.0	0	4	0.6104618221381527	0.0
58691864696	6	2.4663547636354806	0.0	0	6	0.4110591272725801	0.0
58691864697	6	3.1829366700519808	0.0	0	6	0.5304894450086635	0.0
58691864699	8	3.925075258963006	0.0	0	8	0.4906344073703757	0.0
58691864700	4	2.203579064236945	0.0	0	4	0.5508947660592363	0.0
58691864701	8	4.884873178894979	0.0	0	8	0.6106091473618723	0.0
58691864702	4	2.2035236416232147	0.0	0	4	0.5508809104058037	0.0
58691864703	7	3.3162825793347173	0.0	0	7	0.4737546541906739	0.0
58691864704	8	5.364777703606157	0.0	0	8	0.6705972129507696	0.0
58691864705	9	4.657485998763839	0.0	0	9	0.5174984443070932	0.0
58691864706	2	0.9811166273911822	0.0	0	2	0.4905583136955911	0.0
58691864707	4	1.963893459974193	0.0	0	4	0.49097336499354827	0.0
58691864708	2	1.220979066890036	0.0	0	2	0.610489533445018	0.0
58691864709	7	4.396144542176609	0.0	0	7	0.6280206488823727	0.0
58691864710	8	4.887087048128638	0.0	0	8	0.6108858810160798	0.0
58691864711	2	1.221071812643236	0.0	0	2	0.610535906321618	0.0
58691864712	2	0.9815634932929644	0.0	0	2	0.4907817466464822	0.0
58691864713	2	0.743044911653206	0.0	0	2	0.371522455826603	0.0
58691864714	2	1.4616886966872116	0.0	0	2	0.7308443483436058	0.0
58691864720	13	0.0	13.0	13	0	0.0	inf
58691864721	86	2.9976794450453874	64.0	64	22	0.04683874132883418	2.909090909090909
58691864722	37	0.0	37.0	37	0	0.0	inf
58691864723	110	6.28713984013555	64.0	64	46	0.09823656000211797	1.391304347826087
58691864724	63	0.8215573956812631	57.0	57	6	0.01441328764353093	9.5
61706707298	64	26.027786065563262	0.0	0	64	0.406684157274426	0.0
61706707299	124	28.699535349397422	60.0	60	64	0.4484302398343347	0.9375
66146203465	6	3.1844896274273813	0.0	0	6	0.5307482712378969	0.0
66146203466	6	3.1841744042855957	0.0	0	6	0.5306957340475993	0.0
66146203467	6	3.902648436486472	0.0	0	6	0.6504414060810787	0.0
66146203468	6	3.183028404033327	0.0	0	6	0.5305047340055545	0.0
66146203469	8	4.885882252689795	0.0	0	8	0.6107352815862244	0.0
66146203470	6	3.1826169501464037	0.0	0	6	0.530436158357734	0.0
66146203471	8	3.927708451420224	0.0	0	8	0.490963556427528	0.0
66146203472	4	1.9622111082206914	0.0	0	4	0.49055277705517286	0.0
66146203473	7	3.7958017313889627	0.0	0	7	0.5422573901984232	0.0
