page	access#	AVF	wr_ratio	wr#	rd#	mean_AVF	page_wr_ratio
4034320	1	0.0	1.0	1	0	0.0	inf
4034321	2	0.0	2.0	2	0	0.0	inf
4034322	16	0.06405028555467383	13.0	13	3	0.004003142847167115	4.333333333333333
4034323	1	0.0	1.0	1	0	0.0	inf
120862541	2	0.9078562913356312	0.0	0	2	0.4539281456678156	0.0
120862542	2	0.45395767367391726	1.0	1	1	0.45395767367391726	1.0
120862543	31	9.666896987358884	10.0	10	21	0.46032842796947065	0.47619047619047616
120862544	3	0.9081632546556188	1.0	1	2	0.4540816273278094	0.5
120862545	11	3.7276423584062246	4.0	4	7	0.532520336915175	0.5714285714285714
120862546	2	0.9083225106064294	0.0	0	2	0.4541612553032147	0.0
120862547	3	0.908379176095904	1.0	1	2	0.454189588047952	0.5
120862548	3	0.7333337889916564	0.5	1	2	0.7333337889916564	0.5
120862549	2	0.9772854213769364	0.0	0	2	0.9772854213769364	0.0
120862550	3	2.254975544784137	0.0	0	3	0.7516585149280456	0.0
120862551	8	1.844034856245579	4.0	4	4	0.46100871406139476	1.0
120862552	3	1.2191346058568413	1.0	1	2	0.6095673029284207	0.5
120862553	4	0.9089528342121647	2.0	2	2	0.45447641710608233	1.0
120862554	2	0.9089593660630013	0.0	0	2	0.45447968303150066	0.0
120862555	44	13.292571161063755	15.0	15	29	0.4583645227953019	0.5172413793103449
120862556	1	0.4545664489057584	0.0	0	1	0.4545664489057584	0.0
120862557	3	0.7231631585296696	0.5	1	2	0.7231631585296696	0.5
200685420	3	2.431697227030671	0.0	0	3	0.8105657423435569	0.0
200685421	2	1.6212045022499026	0.0	0	2	0.8106022511249513	0.0
200685422	21	17.17961364236979	0.0	0	21	0.8180768401128472	0.0
200685423	1	0.8107047742476192	0.0	0	1	0.8107047742476192	0.0
200685424	1	0.8107159861359109	0.0	0	1	0.8107159861359109	0.0
200685425	1	0.8107414738219074	0.0	0	1	0.8107414738219074	0.0
200685426	4	3.24327040074622	0.0	0	4	0.810817600186555	0.0
200685427	2	1.6216207898980683	0.0	0	2	0.8108103949490342	0.0
200685428	20	16.34337465110573	0.0	0	20	0.8171687325552865	0.0
200685429	2	1.6727270009239201	0.0	0	2	0.8363635004619601	0.0
200685430	1	0.8109605265102742	0.0	0	1	0.8109605265102742	0.0
200685431	1	0.8109883710496654	0.0	0	1	0.8109883710496654	0.0
200685432	3	2.4332014382058125	0.0	0	3	0.8110671460686042	0.0
200685433	17	13.821957267756426	0.0	0	17	0.813056309868025	0.0
200685434	1	0.8112205547783738	0.0	0	1	0.8112205547783738	0.0
200685435	5	4.056594177824656	0.0	0	5	0.8113188355649312	0.0
200685436	3	2.4339375171902993	0.0	0	3	0.8113125057300997	0.0
511174637	2	0.1890465103805756	1.0	1	1	0.1890465103805756	1.0
511174638	1	0.18905391763410168	0.0	0	1	0.18905391763410168	0.0
511174639	1	0.18905778960753578	0.0	0	1	0.18905778960753578	0.0
511174640	1	0.1890583619862173	0.0	0	1	0.1890583619862173	0.0
511174641	4	0.3782028501293424	2.0	2	2	0.1891014250646712	1.0
511174642	11	1.2847411217080102	5.0	5	6	0.21412352028466838	0.8333333333333334
511174643	4	0.3783395476262328	2.0	2	2	0.1891697738131164	1.0
511174644	24	2.857751945018516	9.0	9	15	0.19051679633456772	0.6
511174645	6	0.820104174940204	2.0	2	4	0.205026043735051	0.5
511174646	3	0.49180318375204124	0.5	1	2	0.49180318375204124	0.5
511174647	8	6.127063656623699	0.0	0	8	0.7658829570779624	0.0
511174648	2	0.18933623500144794	1.0	1	1	0.18933623500144794	1.0
511174649	7	1.6174280150476334	0.5	1	6	0.5391426716825445	0.16666666666666666
511174650	5	0.5782069443203823	2.0	2	3	0.1927356481067941	0.6666666666666666
511174651	2	0.1893851902133885	1.0	1	1	0.1893851902133885	1.0
511174652	4	0.3788020296009339	2.0	2	2	0.18940101480046695	1.0
511174653	5	0.7180193933344887	2.0	2	3	0.23933979777816292	0.6666666666666666
1518296732	15	0.4024644336513278	8.0	8	7	0.05030805420641597	1.1428571428571428
1518296733	15	0.10663364333474956	10.0	10	5	0.0071089095556499705	2.0
1518296734	2	0.0	2.0	2	0	0.0	inf
1518296735	1	0.0	1.0	1	0	0.0	inf
1518296736	4	0.0	4.0	4	0	0.0	inf
1518296737	3	0.039226895522069455	2.0	2	1	0.039226895522069455	2.0
1518296738	2	0.0	2.0	2	0	0.0	inf
1518296739	1	0.0	1.0	1	0	0.0	inf
1518296740	7	0.1813523267883627	5.0	5	2	0.04533808169709067	2.5
1960456235	1	0.23677117549443502	0.0	0	1	0.23677117549443502	0.0
1960456236	3	0.2685097754029824	0.5	1	2	0.2685097754029824	0.5
1960456237	2	1.0645330701379032	0.0	0	2	0.5322665350689516	0.0
1960456238	1	0.23678238738272675	0.0	0	1	0.23678238738272675	0.0
1960456239	2	0.23680056882319986	1.0	1	1	0.23680056882319986	1.0
2438249725	1	0.6530187571524187	0.0	0	1	0.6530187571524187	0.0
2438249726	3	1.3209584837917676	1.0	1	2	0.6604792418958838	0.5
2438249727	4	2.8738160894098597	0.0	0	4	0.7184540223524649	0.0
2438249728	2	1.6066553095513134	0.0	0	2	0.8033276547756567	0.0
2438249729	2	1.3063125927653287	0.0	0	2	0.6531562963826644	0.0
2438249730	1	0.6532342072220251	0.0	0	1	0.6532342072220251	0.0
2438249731	4	2.6135761758754037	0.0	0	4	0.6533940439688509	0.0
2438249732	2	1.3067800578014928	0.0	0	2	0.6533900289007464	0.0
2438249733	2	1.479117117331266	0.0	0	2	0.739558558665633	0.0
2438249734	29	17.68278702762303	2.0	2	27	0.6549180380601122	0.07407407407407407
2438249735	13	7.855324150336675	1.0	1	12	0.6546103458613896	0.08333333333333333
2438249736	3	1.6522737557943663	1.0	1	2	0.8261368778971832	0.5
2438249737	16	10.501847419533405	0.0	0	16	0.6563654637208378	0.0
2438249738	4	1.9652031134572052	1.0	1	3	0.655067704485735	0.3333333333333333
2438249739	14	8.531247953535779	1.0	1	13	0.6562498425796753	0.07692307692307693
2438249740	2	1.312725186820193	0.0	0	2	0.6563625934100965	0.0
2438249741	1	0.6563552534952388	0.0	0	1	0.6563552534952388	0.0
2438249742	1	0.6580560599128294	0.0	0	1	0.6580560599128294	0.0
2438249743	1	0.6580703357105342	0.0	0	1	0.6580703357105342	0.0
2438249744	2	0.6580706050652079	1.0	1	1	0.6580706050652079	1.0
2438249745	2	1.316281274560727	0.0	0	2	0.6581406372803635	0.0
2438249746	23	13.17605984414398	3.0	3	20	0.658802992207199	0.15
2438249747	11	7.245658903315039	0.0	0	11	0.6586962639377308	0.0
2438249748	4	2.6335879823641375	0.0	0	4	0.6583969955910344	0.0
2438249749	2	0.6584255135171098	1.0	1	1	0.6584255135171098	1.0
2438249750	8	6.325224085412097	0.0	0	8	0.7906530106765122	0.0
2438249751	8	6.674966449350194	0.0	0	8	0.8343708061687742	0.0
2438249752	12	6.592672771747469	2.0	2	10	0.6592672771747469	0.2
2438249753	3	1.4360177433350962	1.0	1	2	0.7180088716675481	0.5
2438249754	9	4.611419183648609	2.0	2	7	0.6587741690926584	0.2857142857142857
2438249755	2	1.3174272776892144	0.0	0	2	0.6587136388446072	0.0
2438249756	2	0.6592827684354167	1.0	1	1	0.6592827684354167	1.0
2438249757	23	13.850746130964216	2.0	2	21	0.6595593395697246	0.09523809523809523
2438249758	38	18.190160662318902	11.0	11	27	0.6737096541599593	0.4074074074074074
2438249759	3	1.3227443389475715	1.0	1	2	0.6613721694737857	0.5
2438249760	2	0.6613244095232096	1.0	1	1	0.6613244095232096	1.0
2438249761	2	0.661336059112846	1.0	1	1	0.661336059112846	1.0
2438249762	5	3.3069066544981207	0.0	0	5	0.6613813308996241	0.0
2438249763	2	0.6613974719784441	1.0	1	1	0.6613974719784441	1.0
2438249764	21	9.924794356965714	6.0	6	15	0.6616529571310477	0.4
2438249765	3	1.3230919074846157	1.0	1	2	0.6615459537423078	0.5
2438249766	1	0.661546963822334	0.0	0	1	0.661546963822334	0.0
2438249767	2	0.661564640222794	1.0	1	1	0.661564640222794	1.0
2438249768	2	0.6615709700576254	1.0	1	1	0.6615709700576254	1.0
2438249769	1	0.6615726871936701	0.0	0	1	0.6615726871936701	0.0
2438249770	2	1.5512907358119867	0.0	0	2	0.7756453679059934	0.0
2438249771	6	2.6466370042076903	2.0	2	4	0.6616592510519226	0.5
2438249772	5	3.309381485239852	0.0	0	5	0.6618762970479704	0.0
2438249773	3	1.3241263304395328	1.0	1	2	0.6620631652197664	0.5
2438249774	2	1.4435255334931258	0.0	0	2	0.7217627667465629	0.0
2438249775	5	1.9952539706498356	2.0	2	3	0.6650846568832786	0.6666666666666666
2438249776	45	22.055830725671463	12.0	12	33	0.6683585068385292	0.36363636363636365
2438249777	5	3.5041203352778836	0.0	0	5	0.7008240670555768	0.0
2438249778	1	0.6621740888413193	0.0	0	1	0.6621740888413193	0.0
2438249779	2	0.6623292371333566	1.0	1	1	0.6623292371333566	1.0
2438249780	2	1.618792835179148	0.0	0	2	0.809396417589574	0.0
2438249781	5	2.658391372812221	1.0	1	4	0.6645978432030553	0.25
2438249782	2	0.6623667111023317	1.0	1	1	0.6623667111023317	1.0
2438249783	5	3.505259974902205	0.0	0	5	0.701051994980441	0.0
2438249784	2	0.6624328713440533	1.0	1	1	0.6624328713440533	1.0
2438249785	35	18.18591630604846	8.0	8	27	0.6735524557795726	0.2962962962962963
2438249786	1	0.6625460676456654	0.0	0	1	0.6625460676456654	0.0
2438249787	4	2.843451366683729	0.0	0	4	0.7108628416709323	0.0
2438249788	2	0.6626058643832214	1.0	1	1	0.6626058643832214	1.0
2438249789	1	0.662622833727663	0.0	0	1	0.662622833727663	0.0
2438249790	5	3.507323938758579	0.0	0	5	0.7014647877517157	0.0
2438249791	2	1.3257407413455418	0.0	0	2	0.6628703706727709	0.0
2438249792	36	18.013314235189117	9.0	9	27	0.6671597864884858	0.3333333333333333
2438249793	1	0.6630170342925873	0.0	0	1	0.6630170342925873	0.0
2438249794	5	3.5081610594150283	0.0	0	5	0.7016322118830056	0.0
2438249795	2	1.326117703211351	0.0	0	2	0.6630588516056755	0.0
2438249796	2	1.3261870620398222	0.0	0	2	0.6630935310199111	0.0
2438249797	2	1.3264594132842427	0.0	0	2	0.6632297066421213	0.0
2438249798	1	0.6632309019034857	0.0	0	1	0.6632309019034857	0.0
2438249799	1	0.6632364573436302	0.0	0	1	0.6632364573436302	0.0
2438249800	3	1.9981472438771222	0.0	0	3	0.6660490812923741	0.0
2438249801	3	1.3265524753239974	1.0	1	2	0.6632762376619987	0.5
2438249802	5	3.5092981738392846	0.0	0	5	0.701859634767857	0.0
2438249803	36	20.78011527504631	5.0	5	31	0.6703262991950423	0.16129032258064516
2438249804	2	0.663485408400775	1.0	1	1	0.663485408400775	1.0
2438249805	1	0.6634857114247829	0.0	0	1	0.6634857114247829	0.0
2438249806	1	0.6635031184705692	0.0	0	1	0.6635031184705692	0.0
2438249807	1	0.6635034214945771	0.0	0	1	0.6635034214945771	0.0
2438249808	4	2.6626309143678735	0.0	0	4	0.6656577285919684	0.0
2438249809	2	1.3270856965698725	0.0	0	2	0.6635428482849363	0.0
2438249810	5	3.317974135015444	0.0	0	5	0.6635948270030888	0.0
2438249811	5	4.242737886556363	0.0	0	5	0.8485475773112727	0.0
2438249812	38	19.470057810583533	9.0	9	29	0.6713813038132252	0.3103448275862069
2438249813	5	3.319305555167423	0.0	0	5	0.6638611110334847	0.0
2438249814	2	1.3277740997771192	0.0	0	2	0.6638870498885596	0.0
2438249815	2	1.3279433891895243	0.0	0	2	0.6639716945947621	0.0
2438249816	2	0.6639584288770836	1.0	1	1	0.6639584288770836	1.0
2438249817	1	0.6639704824987306	0.0	0	1	0.6639704824987306	0.0
2438249818	1	0.6639744218108331	0.0	0	1	0.6639744218108331	0.0
2438249819	2	0.6639864417631459	1.0	1	1	0.6639864417631459	1.0
2438249820	1	0.6639976536514376	0.0	0	1	0.6639976536514376	0.0
2438249821	2	0.6640330401216917	1.0	1	1	0.6640330401216917	1.0
2438249822	2	1.3281412638666732	0.0	0	2	0.6640706319333366	0.0
2438249823	1	0.6641042844328789	0.0	0	1	0.6641042844328789	0.0
2438249824	2	0.6642183224678464	1.0	1	1	0.6642183224678464	1.0
2438249825	1	0.6642295343561381	0.0	0	1	0.6642295343561381	0.0
2438249826	2	0.6642428000738166	1.0	1	1	0.6642428000738166	1.0
2438249827	1	0.6642498369646664	0.0	0	1	0.6642498369646664	0.0
2438249828	9	3.351166442097819	4.0	4	5	0.6702332884195638	0.8
2438249829	36	18.053040716292195	9.0	9	27	0.6686311376404517	0.3333333333333333
2438249830	2	1.328614318012316	0.0	0	2	0.664307159006158	0.0
2438249831	8	3.7059386678734656	0.5	1	7	0.7411877335746931	0.14285714285714285
2438249832	1	0.6643749858799229	0.0	0	1	0.6643749858799229	0.0
2438249833	1	0.6644870037548378	0.0	0	1	0.6644870037548378	0.0
2438249834	6	2.665985996183177	2.0	2	4	0.6664964990457942	0.5
2438249835	2	0.6645306728813075	1.0	1	1	0.6645306728813075	1.0
2438249836	6	3.7245509411471147	0.0	0	6	0.7449101882294229	0.0
2438249837	1	0.6647385810200509	0.0	0	1	0.6647385810200509	0.0
2438249838	2	0.6647807013571468	1.0	1	1	0.6647807013571468	1.0
2438249839	5	3.524861183860254	0.0	0	5	0.7049722367720508	0.0
2438249840	2	0.6648484777269105	1.0	1	1	0.6648484777269105	1.0
2438249841	23	11.383773643490303	6.0	6	17	0.6696337437347237	0.35294117647058826
2438249842	5	1.6836627333364826	0.5	1	4	0.8418313666682413	0.25
2438249843	1	0.6649692496287198	0.0	0	1	0.6649692496287198	0.0
2438249844	2	0.9975739224542035	0.0	0	2	0.9975739224542035	0.0
2438249845	2	0.9975611954458724	0.0	0	2	0.9975611954458724	0.0
2438249846	2	0.9975935180067135	0.0	0	2	0.9975935180067135	0.0
2438249847	3	0.7598183903048209	0.5	1	2	0.7598183903048209	0.5
2438249848	3	1.9952063285419288	0.0	0	3	0.665068776180643	0.0
2438249849	3	1.3302009180482681	1.0	1	2	0.6651004590241341	0.5
2438249850	16	8.221807715307733	4.0	4	12	0.6851506429423111	0.3333333333333333
2438249851	1	0.6651822755062631	0.0	0	1	0.6651822755062631	0.0
2438249852	1	0.6651892787277787	0.0	0	1	0.6651892787277787	0.0
2438249853	1	0.6651937230798942	0.0	0	1	0.6651937230798942	0.0
2438249854	2	0.6651971236826494	1.0	1	1	0.6651971236826494	1.0
2438249855	3	1.9960463447611205	0.0	0	3	0.6653487815870401	0.0
2438249856	17	9.519406213008978	3.0	3	14	0.6799575866434984	0.21428571428571427
2438249857	5	3.526879593107443	0.0	0	5	0.7053759186214885	0.0
2438249858	5	3.1124007289141504	1.0	1	4	0.7781001822285376	0.25
2438249859	27	14.175746786674503	6.0	6	21	0.6750355612702145	0.2857142857142857
2438249860	3	0.665639269379488	0.5	1	2	0.665639269379488	0.5
2438249861	2	0.9053176908749068	0.0	0	2	0.9053176908749068	0.0
2438249862	1	0.6654441892570784	0.0	0	1	0.6654441892570784	0.0
2438249863	3	1.9968135005410832	0.0	0	3	0.6656045001803611	0.0
2438249864	3	1.371439152257342	1.0	1	2	0.685719576128671	0.5
2438249865	20	13.476297748292568	0.0	0	20	0.6738148874146284	0.0
2438249866	1	0.6656783931458393	0.0	0	1	0.6656783931458393	0.0
2438249867	1	0.6656929046288836	0.0	0	1	0.6656929046288836	0.0
2438249868	2	0.6657248904963826	1.0	1	1	0.6657248904963826	1.0
2438249869	2	1.3315710579345876	0.0	0	2	0.6657855289672938	0.0
2438249870	6	4.194953795067624	0.0	0	6	0.699158965844604	0.0
2438249871	4	1.3316699110998267	2.0	2	2	0.6658349555499133	1.0
2438249872	17	9.36306558883945	3.0	3	14	0.6687903992028179	0.21428571428571427
2438249873	3	1.3320304423305416	1.0	1	2	0.6660152211652708	0.5
2438249874	7	4.15678977308788	1.0	1	6	0.6927982955146467	0.16666666666666666
2438249875	5	3.5301425219550153	0.0	0	5	0.7060285043910031	0.0
2438249876	24	14.938844805816661	2.0	2	22	0.6790384002643937	0.09090909090909091
2438249877	2	0.6661320200856433	1.0	1	1	0.6661320200856433	1.0
2438249878	1	0.6661338382296906	0.0	0	1	0.6661338382296906	0.0
2438249879	1	0.6661450501179824	0.0	0	1	0.6661450501179824	0.0
2438249880	2	1.3324142054018608	0.0	0	2	0.6662071027009304	0.0
2438249881	5	3.3311061854371578	0.0	0	5	0.6662212370874315	0.0
2438249882	1	0.6662463611446187	0.0	0	1	0.6662463611446187	0.0
2438249883	1	0.6662576403715789	0.0	0	1	0.6662576403715789	0.0
2438249884	28	14.195313484564986	7.0	7	21	0.6759673087888088	0.3333333333333333
2438249885	2	1.332801470083938	0.0	0	2	0.666400735041969	0.0
2438249886	4	1.999204797664641	1.0	1	3	0.666401599221547	0.3333333333333333
2438249887	1	0.6664192531757842	0.0	0	1	0.6664192531757842	0.0
2438249888	1	0.666430465064076	0.0	0	1	0.666430465064076	0.0
2438249889	6	4.198771628212302	0.0	0	6	0.6997952713687171	0.0
2438249890	3	1.999548595236254	0.0	0	3	0.6665161984120846	0.0
2438249891	2	1.3716231551687965	0.0	0	2	0.6858115775843983	0.0
2438249892	25	13.493814926471057	5.0	5	20	0.6746907463235529	0.25
2438249893	5	3.3335190982732783	0.0	0	5	0.6667038196546556	0.0
2438249894	3	2.000117371299054	0.0	0	3	0.666705790433018	0.0
2438249895	3	1.3716007987308816	1.0	1	2	0.6858003993654408	0.5
2438249896	21	11.579755262323339	4.0	4	17	0.6811620742543141	0.23529411764705882
2438249897	7	3.373395475252248	2.0	2	5	0.6746790950504497	0.4
2438249898	9	6.303671839544613	0.0	0	9	0.7004079821716237	0.0
2438249899	3	2.000795168666025	0.0	0	3	0.666931722888675	0.0
2438249900	4	1.3339143089182288	2.0	2	2	0.6669571544591144	1.0
2438249901	26	13.50264252086076	6.0	6	20	0.6751321260430381	0.3
2438249902	3	0.6682638949891175	0.5	1	2	0.6682638949891175	0.5
2438249903	1	0.6670431459386854	0.0	0	1	0.6670431459386854	0.0
2438249904	1	0.6670476239601353	0.0	0	1	0.6670476239601353	0.0
2438249905	2	0.6670543578269771	1.0	1	1	0.6670543578269771	1.0
2438249906	1	0.6670743574114976	0.0	0	1	0.6670743574114976	0.0
2438249907	1	0.6670855692997893	0.0	0	1	0.6670855692997893	0.0
2438249908	3	2.0015080158099074	0.0	0	3	0.6671693386033025	0.0
2438249909	24	13.54591929857888	4.0	4	20	0.6772959649289441	0.2
2438249910	2	1.4359873399263052	0.0	0	2	0.7179936699631526	0.0
2438249911	1	0.6673208842765792	0.0	0	1	0.6673208842765792	0.0
2438249912	6	4.203586780705599	0.0	0	6	0.7005977967842666	0.0
2438249913	3	2.002161773272252	0.0	0	3	0.6673872577574174	0.0
2438249914	3	1.3716406295532515	1.0	1	2	0.6858203147766258	0.5
2438249915	19	10.092331549879924	4.0	4	15	0.6728221033253283	0.26666666666666666
2438249916	1	0.6675983532597993	0.0	0	1	0.6675983532597993	0.0
2438249917	1	0.6676109455907936	0.0	0	1	0.6676109455907936	0.0
2438249918	7	4.165295555981211	1.0	1	6	0.6942159259968684	0.16666666666666666
2438249919	7	4.498451631493044	0.0	0	7	0.749741938582174	0.0
2438249920	3	2.00308542411762	0.0	0	3	0.66769514137254	0.0
2438249921	1	0.6678847446165849	0.0	0	1	0.6678847446165849	0.0
2438249922	2	1.3384148888220064	0.0	0	2	0.6692074444110032	0.0
2438249923	1	0.6679406020420384	0.0	0	1	0.6679406020420384	0.0
2438249924	1	0.6679720155308558	0.0	0	1	0.6679720155308558	0.0
2438249925	1	0.6679885135046184	0.0	0	1	0.6679885135046184	0.0
2438249926	1	0.6679997927315786	0.0	0	1	0.6679997927315786	0.0
2438249927	3	2.5935813387311115	0.0	0	3	0.8645271129103705	0.0
2438249928	1	0.6693839390609293	0.0	0	1	0.6693839390609293	0.0
2438249929	3	2.111642764862427	0.0	0	3	0.703880921620809	0.0
2438249930	2	1.6314310238066771	0.0	0	2	0.8157155119033386	0.0
2438249931	1	0.6694737351752659	0.0	0	1	0.6694737351752659	0.0
2438249932	3	2.2059826905279443	0.0	0	3	0.7353275635093147	0.0
2438249933	1	0.6695666962070181	0.0	0	1	0.6695666962070181	0.0
2438249934	2	1.5616358407638469	0.0	0	2	0.7808179203819234	0.0
2438249935	2	1.5349572030776328	0.0	0	2	0.7674786015388164	0.0
2438249936	5	3.8980184485729708	0.0	0	5	0.7796036897145942	0.0
2438249937	1	0.6696534957506102	0.0	0	1	0.6696534957506102	0.0
2438249938	1	0.669661340705481	0.0	0	1	0.669661340705481	0.0
2438249939	2	1.3395175931867005	0.0	0	2	0.6697587965933502	0.0
2438249940	2	1.3697986476173205	0.0	0	2	0.6848993238086603	0.0
2438249941	1	0.669706996322669	0.0	0	1	0.669706996322669	0.0
2438249942	2	1.4356837435397387	0.0	0	2	0.7178418717698694	0.0
2438249943	1	0.6697727862017142	0.0	0	1	0.6697727862017142	0.0
2438249944	2	1.3398925685617913	0.0	0	2	0.6699462842808956	0.0
2438249945	1	0.6698630200173956	0.0	0	1	0.6698630200173956	0.0
2438249946	1	0.6698742319056874	0.0	0	1	0.6698742319056874	0.0
2438249947	1	0.669899079874334	0.0	0	1	0.669899079874334	0.0
2438249948	1	0.6699143320827308	0.0	0	1	0.6699143320827308	0.0
2438249949	1	0.6699278334857488	0.0	0	1	0.6699278334857488	0.0
2438249950	1	0.6699510653263533	0.0	0	1	0.6699510653263533	0.0
2438249951	1	0.6699622772146451	0.0	0	1	0.6699622772146451	0.0
2438249952	2	1.3399612203342444	0.0	0	2	0.6699806101671222	0.0
2438249953	1	0.6700551372383947	0.0	0	1	0.6700551372383947	0.0
2438249954	4	3.0757198747756656	0.0	0	4	0.7689299686939164	0.0
2438249955	2	1.3401749195984716	0.0	0	2	0.6700874597992358	0.0
2438249956	1	0.6701052372076984	0.0	0	1	0.6701052372076984	0.0
2438249957	2	1.3403629964993657	0.0	0	2	0.6701814982496829	0.0
2438249958	1	0.6701682325320043	0.0	0	1	0.6701682325320043	0.0
2438249959	2	1.5528870999548596	0.0	0	2	0.7764435499774298	0.0
2438249960	1	0.6702533822782201	0.0	0	1	0.6702533822782201	0.0
2438249961	1	0.6702811594789428	0.0	0	1	0.6702811594789428	0.0
2438249962	1	0.6703060074475894	0.0	0	1	0.6703060074475894	0.0
2438249963	1	0.6703304177148912	0.0	0	1	0.6703304177148912	0.0
2438249964	1	0.6703574878595956	0.0	0	1	0.6703574878595956	0.0
2438249965	1	0.6703807197002002	0.0	0	1	0.6703807197002002	0.0
2438249966	1	0.6703965779566128	0.0	0	1	0.6703965779566128	0.0
2438249967	1	0.6704229073759647	0.0	0	1	0.6704229073759647	0.0
2438249968	1	0.6704475196592717	0.0	0	1	0.6704475196592717	0.0
2438249969	1	0.6704865760869547	0.0	0	1	0.6704865760869547	0.0
2438249970	2	1.3410840926301295	0.0	0	2	0.6705420463150648	0.0
2438249971	2	1.55339836879483	0.0	0	2	0.776699184397415	0.0
2438249972	2	1.415239084090408	0.0	0	2	0.707619542045204	0.0
2438249973	2	1.3412062113053071	0.0	0	2	0.6706031056526536	0.0
2438249974	2	1.3412006558651628	0.0	0	2	0.6706003279325814	0.0
2438249975	2	0.6720509206929943	1.0	1	1	0.6720509206929943	1.0
2438249976	19	10.911817286489368	3.0	3	16	0.6819885804055855	0.1875
2438249977	4	1.3445127082713466	2.0	2	2	0.6722563541356733	1.0
2438249978	1	0.6722029040676158	0.0	0	1	0.6722029040676158	0.0
2438249979	5	3.5591404380589133	0.0	0	5	0.7118280876117826	0.0
2438249980	3	1.344578531819726	1.0	1	2	0.672289265909863	0.5
2438249981	18	10.125675907675587	3.0	3	15	0.6750450605117059	0.2
2631670712	8	0.08914646453304322	4.0	4	4	0.022286616133260804	1.0
2631670713	2	0.044036155881879493	0.0	0	2	0.022018077940939747	0.0
2631670714	12	1.3726054579943576	4.0	5	7	0.2745210915988715	0.7142857142857143
2631670715	12	0.8055480126894334	5.0	6	6	0.1611096025378867	1.0
2631670716	8	0.8149883216230828	4.0	4	4	0.2037470804057707	1.0
2631670717	6	4.344802634908224	0.0	0	6	0.724133772484704	0.0
2631670718	9	1.1337369523333471	2.0	3	6	0.2834342380833368	0.5
2631670719	3	0.04461159847285327	0.5	1	2	0.04461159847285327	0.5
2631670720	11	1.9125661261515206	5.0	5	6	0.31876102102525344	0.8333333333333334
2631670721	10	2.8069912150309873	2.5	3	7	0.4678318691718312	0.42857142857142855
2631670722	1	0.02228586699057464	0.0	0	1	0.02228586699057464	0.0
2631670723	2	0.022297078878866387	1.0	1	1	0.022297078878866387	1.0
2631670724	3	1.1964271651326301	0.0	0	3	0.5982135825663151	0.0
2631670725	3	0.5489879553680652	0.0	0	3	0.2744939776840326	0.0
2631670726	4	0.08955305541295656	0.0	0	4	0.02238826385323914	0.0
2631670727	9	0.11288149333732696	4.0	4	5	0.02257629866746539	0.8
2631670728	3	1.1081030067489843	0.0	0	3	0.3693676689163281	0.0
2631670729	4	0.1419497783497225	0.5	1	3	0.07097488917486125	0.3333333333333333
2631670730	6	0.481151014472191	0.5	1	5	0.12028775361804775	0.2
2631670731	2	0.022564918432502596	1.0	1	1	0.022564918432502596	1.0
2631670732	2	0.5863266072890001	0.0	0	2	0.5863266072890001	0.0
2631670733	1	0.022577914795507446	0.0	0	1	0.022577914795507446	0.0
2631670734	2	0.2824181396635632	0.0	0	2	0.1412090698317816	0.0
2631670735	4	0.09058007111434756	0.0	0	4	0.02264501777858689	0.0
2631670736	10	0.11406170450937096	5.0	5	5	0.022812340901874194	1.0
2631670737	2	0.04528111318360828	0.0	0	2	0.02264055659180414	0.0
2631670738	1	0.022834811815525585	0.0	0	1	0.022834811815525585	0.0
2631670739	15	3.2134258692336255	5.0	5	10	0.32134258692336254	0.5
2631670740	1	0.022862252322906288	0.0	0	1	0.022862252322906288	0.0
2631670741	3	0.0686417389914829	0.0	0	3	0.022880579663827633	0.0
2631670742	11	0.207548819608697	2.0	2	9	0.02306097995652189	0.2222222222222222
2631670743	5	0.11554712819602367	0.0	0	5	0.023109425639204734	0.0
2631670744	14	4.189725755528917	3.0	4	10	0.5237157194411146	0.4
2631670745	2	0.04620516806098675	0.0	0	2	0.023102584030493374	0.0
2631670746	6	2.4607957471051862	0.0	0	6	0.410132624517531	0.0
2631670747	1	0.024815208384391475	0.0	0	1	0.024815208384391475	0.0
2631670748	1	0.024844130342477396	0.0	0	1	0.024844130342477396	0.0
2631670749	2	0.024849584774619328	1.0	1	1	0.024849584774619328	1.0
2631670750	1	0.024855880940116495	0.0	0	1	0.024855880940116495	0.0
2631670751	8	0.41152084483632106	1.5	2	6	0.08230416896726421	0.3333333333333333
2631670752	3	1.7708525718506118	0.0	0	3	0.5902841906168707	0.0
2631670753	15	0.330536533971668	3.0	3	12	0.027544711164305666	0.25
2631670754	2	0.052691868320446006	0.0	0	2	0.026345934160223003	0.0
2631670755	22	0.4908072111767913	4.0	4	18	0.02726706728759952	0.2222222222222222
2631670756	10	1.1635658612748685	4.0	4	6	0.1939276435458114	0.6666666666666666
2631670757	7	0.1507107411270278	1.0	1	6	0.02511845685450463	0.16666666666666666
2631670758	26	18.26721963385474	0.0	0	26	0.7306887853541896	0.0
2631670759	9	0.1271800851813954	4.0	4	5	0.02543601703627908	0.8
2631670760	28	0.5939875255790141	5.0	5	23	0.02582554459039192	0.21739130434782608
2631670761	8	0.10251201178749923	4.0	4	4	0.025628002946874808	1.0
2631670762	2	0.0510718346356239	0.0	0	2	0.02553591731781195	0.0
2631670763	12	0.9616793146081779	6.0	6	6	0.16027988576802965	1.0
2631670764	10	3.7435417924146157	0.0	0	10	0.3743541792414616	0.0
2631670765	12	0.9115027475691835	5.0	5	7	0.13021467822416907	0.7142857142857143
2631670766	16	3.832758558517488	6.5	7	9	0.479094819814686	0.7777777777777778
2631670767	17	2.1413947730446137	7.5	8	9	0.2676743466305767	0.8888888888888888
2631670768	18	1.3514812167033432	8.0	9	9	0.1689351520879179	1.0
2631670769	10	6.21198849168689	0.0	0	10	0.7764985614608613	0.0
2631670770	9	1.82988151390929	3.0	4	5	0.4574703784773225	0.8
2631670771	7	3.740800165868608	0.5	1	6	0.7481600331737216	0.16666666666666666
2631670772	9	6.126214179321595	0.0	0	9	0.7657767724151994	0.0
2631670773	3	0.35018487999761083	0.5	1	2	0.35018487999761083	0.5
2631670774	8	1.2435308667156644	2.333333333333333	3	5	0.41451028890522146	0.6
2631670775	8	0.10461254054082444	4.0	4	4	0.02615313513520611	1.0
2631670776	10	0.1318179686300793	5.0	5	5	0.02636359372601586	1.0
2631670777	8	0.10623762462577797	4.0	4	4	0.026559406156444493	1.0
2631670778	24	0.5376390665554187	4.0	4	20	0.026881953327770935	0.2
2631670779	12	0.6141970383982258	4.5	5	7	0.10236617306637097	0.7142857142857143
2631670780	8	0.10816155772117461	4.0	4	4	0.027040389430293653	1.0
2631670781	17	2.948228011559491	7.5	8	9	0.3685285014449364	0.8888888888888888
2631670782	8	1.7302347961323497	1.5	2	6	0.34604695922646994	0.3333333333333333
2631670783	3	0.21879872057876779	0.5	1	2	0.21879872057876779	0.5
2631670784	3	0.10978091801931253	0.5	1	2	0.10978091801931253	0.5
2631670785	2	0.027058798138772672	1.0	1	1	0.027058798138772672	1.0
2631670786	4	1.392743558155711	0.0	0	4	0.34818588953892776	0.0
2631670787	3	0.37974908063357743	0.5	1	2	0.37974908063357743	0.5
2631670788	1	0.027062973136214644	0.0	0	1	0.027062973136214644	0.0
2631670789	2	0.3185135177494798	0.0	0	2	0.1592567588747399	0.0
2631670790	5	1.4455708108690133	1.0	1	4	0.3613927027172533	0.25
2631670791	8	0.10904807129090954	4.0	4	4	0.027262017822727386	1.0
2631670792	23	19.0838722306678	0.0	0	23	0.8297335752464261	0.0
2631670793	8	0.1098786937658568	4.0	4	4	0.0274696734414642	1.0
2631670794	7	2.0069742995574806	0.0	0	7	0.2867106142224972	0.0
2631670795	8	0.11075254766592896	4.0	4	4	0.02768813691648224	1.0
2631670796	1	0.027590302248603118	0.0	0	1	0.027590302248603118	0.0
2631670797	4	0.05545847751243686	2.0	2	2	0.02772923875621843	1.0
2631670798	9	0.13923229271634321	4.0	4	5	0.027846458543268643	0.8
2631670799	4	0.11558123523157784	0.0	0	4	0.02889530880789446	0.0
2631670800	15	3.5762437527812976	4.0	5	10	0.4470304690976622	0.5
2631670801	10	0.14044839539865453	5.0	5	5	0.028089679079730905	1.0
2631670802	8	1.5009916797351381	3.0	3	5	0.3001983359470276	0.6
2631670803	3	0.05602422333515832	0.5	1	2	0.05602422333515832	0.5
2631670804	8	2.3434339091339416	3.0	3	5	0.4686867818267883	0.6
2631670805	4	0.6664429227177335	1.0	1	3	0.2221476409059112	0.3333333333333333
2631670806	3	0.040276638024051827	0.5	1	2	0.040276638024051827	0.5
2631670807	3	0.30027345896551577	0.5	1	2	0.30027345896551577	0.5
2631670808	3	0.32935261917286096	1.0	1	2	0.16467630958643048	0.5
2631670809	6	0.25297760649214796	1.0	3	3	0.25297760649214796	1.0
2631670810	7	0.27269524400789386	0.6666666666666666	2	5	0.09089841466929795	0.4
2631670811	4	0.08921427457214104	1.0	1	3	0.029738091524047012	0.3333333333333333
2631670812	9	1.8772949396977174	3.0	4	5	0.46932373492442936	0.8
2631670813	2	0.029904765951495216	1.0	1	1	0.029904765951495216	1.0
2631670814	2	0.05982276395133475	0.0	0	2	0.029911381975667374	0.0
2631670815	5	0.749147164181808	1.0	1	4	0.24971572139393602	0.25
2631670816	2	0.029937694560352064	1.0	1	1	0.029937694560352064	1.0
2631670817	1	0.029937963915025737	0.0	0	1	0.029937963915025737	0.0
2631670818	7	2.8802127242003084	0.5	1	6	0.5760425448400617	0.16666666666666666
2631670819	4	0.20027365088072077	1.0	2	2	0.20027365088072077	1.0
2631670820	9	1.667670472973676	4.0	4	5	0.3335340945947352	0.8
2631670821	15	2.0058922681639917	7.0	7	8	0.25073653352049896	0.875
2631670822	4	0.5993246200912258	1.0	1	3	0.2996623100456129	0.3333333333333333
2631670823	14	3.40000650491537	6.0	6	8	0.4250008131144212	0.75
2631670824	2	0.06059406105940493	0.0	0	2	0.030297030529702465	0.0
2631670825	1	0.030294791518977536	0.0	0	1	0.030294791518977536	0.0
2631670826	1	0.03031657557821105	0.0	0	1	0.03031657557821105	0.0
2631670827	3	0.060657696101060796	1.0	1	2	0.030328848050530398	0.5
2631670828	2	0.030579162715710585	1.0	1	1	0.030579162715710585	1.0
2631670829	1	0.03058700767058139	0.0	0	1	0.03058700767058139	0.0
2631670830	2	0.030598253228207348	1.0	1	1	0.030598253228207348	1.0
2631670831	1	0.030606098183078148	0.0	0	1	0.030606098183078148	0.0
2631670832	1	0.030620710674125053	0.0	0	1	0.030620710674125053	0.0
2631670833	2	0.11406924644023389	0.0	0	2	0.057034623220116945	0.0
2631670834	13	0.24670871315568965	5.0	5	8	0.030838589144461206	0.625
2631670835	8	3.5217521238700193	0.5	1	7	0.7043504247740039	0.14285714285714285
2631670836	3	1.5727356101726775	0.0	0	3	0.7863678050863387	0.0
2631670837	2	0.7164096961352688	0.0	0	2	0.7164096961352688	0.0
2631670838	3	0.4741734153199578	0.5	1	2	0.4741734153199578	0.5
2631670839	12	0.4631694688362871	3.0	3	9	0.05146327431514301	0.3333333333333333
2631670840	3	0.061672456164799536	1.0	1	2	0.030836228082399768	0.5
2694252958	2	0.5658678067193015	1.0	1	1	0.5658678067193015	1.0
2694252959	6	3.2446000027541517	1.0	1	5	0.6489200005508303	0.2
2694252960	3	1.6978692732208223	0.0	0	3	0.5659564244069407	0.0
2694252961	1	0.56596369698313	0.0	0	1	0.56596369698313	0.0
2694252962	2	0.5659749088714218	1.0	1	1	0.5659749088714218	1.0
2694252963	3	1.3502075394595336	1.0	1	2	0.6751037697297668	0.5
2694252964	3	1.69870669690128	0.0	0	3	0.56623556563376	0.0
2694252965	9	5.095207786424101	0.0	0	9	0.5661341984915668	0.0
2694252966	12	5.672862789348787	2.0	2	10	0.5672862789348787	0.2
2705421061	3	1.050993923796263	1.0	1	2	0.5254969618981316	0.5
2705421062	28	10.19213385365025	9.0	9	19	0.5364280975605394	0.47368421052631576
2873915798	7	2.75648660766879	2.0	2	5	0.551297321533758	0.4
2873915799	1	0.5176668888730493	0.0	0	1	0.5176668888730493	0.0
2873915800	2	0.5176981003458615	1.0	1	1	0.5176981003458615	1.0
2873915801	1	0.5177293454880079	0.0	0	1	0.5177293454880079	0.0
2873915802	2	0.5177405573762996	1.0	1	1	0.5177405573762996	1.0
2873915803	6	2.7579390017385834	1.0	1	5	0.5515878003477167	0.2
2873915804	3	1.0357298637937387	1.0	1	2	0.5178649318968693	0.5
2873915805	7	3.2771385523741814	1.0	1	6	0.5461897587290302	0.16666666666666666
2873915806	2	1.0361132901717158	0.0	0	2	0.5180566450858579	0.0
2873915807	3	1.0361834570642086	1.0	1	2	0.5180917285321043	0.5
2873915808	9	2.760096633682728	4.0	4	5	0.5520193267365456	0.8
2873915809	2	1.0365375574520894	0.0	0	2	0.5182687787260447	0.0
2873915810	8	2.7609896791032993	3.0	3	5	0.5521979358206599	0.6
2873915811	2	0.518474111160721	1.0	1	1	0.518474111160721	1.0
2873915812	8	2.593144041418399	3.0	3	5	0.5186288082836799	0.6
2873915813	2	0.5186575416934941	1.0	1	1	0.5186575416934941	1.0
2873915814	8	2.7628327047885906	3.0	3	5	0.5525665409577181	0.6
3296274496	6	0.7629284603750824	2.0	2	4	0.1907321150937706	0.5
3296274497	4	0.7944403309870633	0.5	1	3	0.3972201654935317	0.3333333333333333
3296274498	17	2.1189419398256946	8.0	8	9	0.23543799331396606	0.8888888888888888
3296274499	2	0.1880358243062762	1.0	1	1	0.1880358243062762	1.0
3296274500	48	6.147807905808825	16.0	16	32	0.19211899705652577	0.5
3296274501	3	0.3763610028707485	1.0	1	2	0.18818050143537424	0.5
3296274502	12	1.1295699008542481	3.5	5	7	0.22591398017084963	0.7142857142857143
3296274503	2	0.1882349447487909	1.0	1	1	0.1882349447487909	1.0
3296274504	11	1.7908161638527575	5.0	5	6	0.29846936064212626	0.8333333333333334
3762187999	11	2.1600724995039666	5.0	5	6	0.3600120832506611	0.8333333333333334
3762188000	2	0.33281335535891393	1.0	1	1	0.33281335535891393	1.0
3762188001	30	6.90981382642657	10.0	10	20	0.3454906913213285	0.5
3762188002	8	2.3257168361182528	2.0	2	6	0.3876194726863755	0.3333333333333333
3762188003	3	0.9988784071388147	0.0	0	3	0.33295946904627155	0.0
3762188004	3	0.6659681177667117	1.0	1	2	0.33298405888335586	0.5
3762188005	19	4.977142495053217	5.0	5	14	0.3555101782180869	0.35714285714285715
3762188006	1	0.33310405639047835	0.0	0	1	0.33310405639047835	0.0
3762188007	1	0.3331152682787701	0.0	0	1	0.3331152682787701	0.0
3762188008	14	3.1235027541683733	5.0	5	9	0.3470558615742637	0.5555555555555556
3762188009	15	2.3866773205418594	2.5	5	10	0.4773354641083719	0.5
3762188010	3	0.9995639147833192	0.0	0	3	0.33318797159443975	0.0
3762188011	30	7.729158993565688	9.0	9	21	0.3680551901697947	0.42857142857142855
3762188012	6	4.342910721349661	0.0	0	6	0.7238184535582768	0.0
3762188013	13	3.398093413345588	5.0	5	8	0.4247616766681985	0.625
3762188014	15	3.751474859933044	7.0	7	8	0.4689343574916305	0.875
3762188015	6	4.688936394823044	0.0	0	6	0.781489399137174	0.0
3762188016	4	0.7233826825887153	0.5	1	3	0.36169134129435765	0.3333333333333333
3762188017	3	0.4942443114902293	0.5	1	2	0.4942443114902293	0.5
3762188018	2	0.7555727882690114	0.0	0	2	0.7555727882690114	0.0
3762188019	2	0.755573360647693	0.0	0	2	0.755573360647693	0.0
3762188020	9	1.6671264438715196	4.0	4	5	0.33342528877430394	0.8
3762188021	3	1.0002695566896809	0.0	0	3	0.333423185563227	0.0
3762188022	4	0.6669195458128025	2.0	2	2	0.3334597729064013	1.0
3762188023	34	9.582466148767212	10.0	10	24	0.4166289629898788	0.4166666666666667
3762188024	9	1.668015954011999	4.0	4	5	0.3336031908023998	0.8
3762188025	3	1.0008162119999056	0.0	0	3	0.3336054039999685	0.0
3762188026	3	0.6672645891497809	1.0	1	2	0.33363229457489046	0.5
3762188027	17	4.7132833637765845	3.0	3	14	0.3366630974126132	0.21428571428571427
3762188028	5	1.673360152753729	0.0	0	5	0.3346720305507458	0.0
3762188029	10	3.3645673084838608	0.0	0	10	0.33645673084838607	0.0
3762188030	1	0.3346278294487956	0.0	0	1	0.3346278294487956	0.0
3762188031	2	0.6696645392922309	0.0	0	2	0.33483226964611545	0.0
3924601816	9	2.3554330537981754	4.0	4	5	0.4710866107596351	0.8
3924601817	10	5.733697013769109	2.0	2	8	0.7167121267211386	0.25
3924601818	7	3.392578847772758	0.5	1	6	0.6785157695545516	0.16666666666666666
3924601819	2	0.9871718489888611	0.0	0	2	0.49358592449443056	0.0
3924601820	1	0.18836362894413944	0.0	0	1	0.18836362894413944	0.0
3924601821	2	0.1883869954620808	1.0	1	1	0.1883869954620808	1.0
3924601822	1	0.18838726481675447	0.0	0	1	0.18838726481675447	0.0
3924601823	1	0.1884015406144593	0.0	0	1	0.1884015406144593	0.0
3924601824	2	0.1884463881676263	1.0	1	1	0.1884463881676263	1.0
3924601825	14	5.183010743514184	4.0	4	10	0.5183010743514184	0.4
3924601826	2	0.37697290935067107	0.0	0	2	0.18848645467533554	0.0
3924601827	2	0.18851726211613717	1.0	1	1	0.18851726211613717	1.0
3924601828	43	6.083841221210994	12.0	12	31	0.1962529426197095	0.3870967741935484
3924601829	5	1.9295821699596343	1.0	1	4	0.6431940566532114	0.25
3924601830	16	3.9854451845225976	8.0	8	8	0.4981806480653247	1.0
3924601831	2	0.18859180602207692	1.0	1	1	0.18859180602207692	1.0
3924601832	1	0.18860237819301867	0.0	0	1	0.18860237819301867	0.0
3924601833	5	1.7766917771438888	0.5	1	4	0.8883458885719444	0.25
3924601834	1	0.18860295057170023	0.0	0	1	0.18860295057170023	0.0
3924601835	6	0.5863663371033673	3.0	3	3	0.19545544570112242	1.0
3924601836	3	0.37728158980670334	1.0	1	2	0.18864079490335167	0.5
3924601837	10	1.093274594261796	3.5	4	6	0.21865491885235921	0.6666666666666666
3924601838	2	0.18870227510761814	1.0	1	1	0.18870227510761814	1.0
3924601839	3	0.6664104654795555	0.5	1	2	0.6664104654795555	0.5
3924601840	3	1.9931263380824715	0.0	0	3	0.9965631690412358	0.0
3924601841	2	0.9965643474679331	0.0	0	2	0.9965643474679331	0.0
3924601842	3	0.7882111001263038	0.5	1	2	0.7882111001263038	0.5
3924601843	6	0.7660885630759792	2.0	2	4	0.1915221407689948	0.5
3924601844	33	4.465522618604185	10.0	10	23	0.19415315733061672	0.43478260869565216
3924601845	3	1.162772510752891	1.0	1	2	0.5813862553764455	0.5
3924601846	9	0.9445462698636866	4.0	4	5	0.18890925397273733	0.8
3924601847	3	0.3778633285631743	1.0	1	2	0.18893166428158714	0.5
3924601848	3	0.378101034062693	1.0	1	2	0.1890505170313465	0.5
4071541330	4	0.7758326367428663	2.0	2	2	0.38791631837143314	1.0
4071541331	2	0.38314193944186414	1.0	1	1	0.38314193944186414	1.0
4071541332	8	1.9159816780910643	3.0	3	5	0.38319633561821287	0.6
4071541333	4	0.7664401045944601	2.0	2	2	0.38322005229723005	1.0
4071541334	7	2.4104938291349303	2.0	2	5	0.4820987658269861	0.4
4071541335	15	5.983080351495728	4.0	4	11	0.5983080351495728	0.36363636363636365
4071541336	4	1.1512681032855312	1.0	1	3	0.3837560344285104	0.3333333333333333
4071541337	2	0.38358573493607895	1.0	1	1	0.38358573493607895	1.0
4071541338	13	4.4558119112475	4.0	4	9	0.4950902123608334	0.4444444444444444
5203088138	2	0.5481927193633721	1.0	1	1	0.5481927193633721	1.0
5203088139	2	0.5482127526172268	1.0	1	1	0.5482127526172268	1.0
5203088140	1	0.5482239645055185	0.0	0	1	0.5482239645055185	0.0
5203088141	1	0.5482439977593732	0.0	0	1	0.5482439977593732	0.0
5203088142	1	0.5482552096476649	0.0	0	1	0.5482552096476649	0.0
5203088143	3	1.0966680591180984	1.0	1	2	0.5483340295590492	0.5
5203088144	3	1.839671344201368	0.0	0	3	0.613223781400456	0.0
5203088145	3	1.645028485435168	0.0	0	3	0.5483428284783893	0.0
5203088146	2	0.5483676988932586	1.0	1	1	0.5483676988932586	1.0
5203088147	20	7.717390887872801	6.0	6	14	0.5512422062766287	0.42857142857142855
5203088148	15	6.229792330576836	4.0	4	11	0.5663447573251669	0.36363636363636365
5203088149	7	2.9370692871464588	2.0	2	5	0.5874138574292918	0.4
5203088150	3	1.645497229906032	0.0	0	3	0.548499076635344	0.0
5203088151	2	0.5485251030306879	1.0	1	1	0.5485251030306879	1.0
5203088152	23	8.976384632009497	7.0	7	16	0.5610240395005935	0.4375
5203088153	9	2.9459959030480745	2.0	3	6	0.5891991806096148	0.5
5203088154	3	1.6459836844466902	0.0	0	3	0.5486612281488967	0.0
5203088155	2	0.5486825071681171	1.0	1	1	0.5486825071681171	1.0
5203088156	31	12.349347388978487	9.0	9	22	0.5613339722262949	0.4090909090909091
5203088157	9	2.755406697443356	2.5	3	6	0.5510813394886712	0.5
5203088158	3	1.6463930698813427	0.0	0	3	0.5487976899604475	0.0
5203088159	4	1.097654974642446	2.0	2	2	0.548827487321223	1.0
5203088160	5	2.421967967870836	0.5	1	4	0.8073226559569453	0.25
5203088161	7	2.6321888195117293	0.5	1	6	0.6580472048779323	0.16666666666666666
5203088162	5	2.7486122257998886	0.0	0	5	0.5497224451599777	0.0
5203088163	1	0.5496511065746547	0.0	0	1	0.5496511065746547	0.0
5203088164	26	11.558089045759553	5.0	5	21	0.5503851926552168	0.23809523809523808
5203088165	1	0.5498837953433762	0.0	0	1	0.5498837953433762	0.0
5203088166	4	2.225389593758271	0.0	0	4	0.5563473984395677	0.0
5203088167	1	0.5501138915733637	0.0	0	1	0.5501138915733637	0.0
5203088168	1	0.5502720027668112	0.0	0	1	0.5502720027668112	0.0
5203088169	2	0.5502722721214849	1.0	1	1	0.5502722721214849	1.0
5203088170	2	1.1007941350174644	0.0	0	2	0.5503970675087322	0.0
5203088171	3	1.1011345319863222	1.0	1	2	0.5505672659931611	0.5
5203088172	3	1.6526218293714234	0.0	0	3	0.5508739431238078	0.0
5203088173	6	4.918076920758919	0.0	0	6	0.8196794867931532	0.0
5203088174	1	0.5508555933366637	0.0	0	1	0.5508555933366637	0.0
5203088175	2	0.8503453985484544	0.0	0	2	0.8503453985484544	0.0
5203088176	10	7.234839835145513	0.5	1	9	0.9043549793931891	0.1111111111111111
5203088177	5	2.7582934051504715	0.0	0	5	0.5516586810300943	0.0
5203088178	2	1.2213269845538899	0.0	0	2	0.6106634922769449	0.0
5203088179	1	0.5513113751138571	0.0	0	1	0.5513113751138571	0.0
5203088180	2	0.5513377382025431	1.0	1	1	0.5513377382025431	1.0
5203088181	2	0.5513383105812246	1.0	1	1	0.5513383105812246	1.0
5203088182	2	1.4192526034055117	0.0	0	2	0.7096263017027559	0.0
5203088183	1	0.5530593185993409	0.0	0	1	0.5530593185993409	0.0
5203088184	2	1.3808066680904307	0.0	0	2	0.6904033340452154	0.0
5203088185	1	0.5532070933071862	0.0	0	1	0.5532070933071862	0.0
5203088186	3	1.1064454654258529	1.0	1	2	0.5532227327129264	0.5
5203088187	1	0.5533650024846285	0.0	0	1	0.5533650024846285	0.0
5203088188	1	0.5533762143729203	0.0	0	1	0.5533762143729203	0.0
5203088189	3	0.5797015597352742	0.5	1	2	0.5797015597352742	0.5
5203088190	3	1.8849729283401757	0.0	0	3	0.9424864641700879	0.0
5203088191	3	0.5976114570279802	0.5	1	2	0.5976114570279802	0.5
5203088192	1	0.5534165839046374	0.0	0	1	0.5534165839046374	0.0
5203088193	2	0.5534103550778087	1.0	1	1	0.5534103550778087	1.0
5203088194	1	0.5534215669661005	0.0	0	1	0.5534215669661005	0.0
5203088195	1	0.5535769172741428	0.0	0	1	0.5535769172741428	0.0
5203088196	1	0.5536002837920841	0.0	0	1	0.5536002837920841	0.0
5203088197	11	3.9277537904347244	4.0	4	7	0.5611076843478178	0.5714285714285714
5203088198	1	0.5537718963885497	0.0	0	1	0.5537718963885497	0.0
5203088199	2	1.4282163902520948	0.0	0	2	0.7141081951260474	0.0
5203088200	1	0.5538034782240382	0.0	0	1	0.5538034782240382	0.0
5203088201	3	1.107638235259557	1.0	1	2	0.5538191176297785	0.5
5203088202	11	5.137351692054074	2.0	2	9	0.570816854672675	0.2222222222222222
5203088203	2	0.553865328790981	1.0	1	1	0.553865328790981	1.0
5203088204	7	3.5176423775977446	1.0	1	6	0.5862737295996241	0.16666666666666666
5203088205	2	1.1078006897971178	0.0	0	2	0.5539003448985589	0.0
5203088206	6	5.23561550926703	0.0	0	6	0.8726025848778383	0.0
5203088207	11	5.880402753922587	3.0	3	8	0.7350503442403233	0.375
5203088208	3	1.108250343755485	1.0	1	2	0.5541251718777425	0.5
5203088209	2	1.1828837091162114	0.0	0	2	0.5914418545581057	0.0
5203088210	6	2.2276904213808084	2.0	2	4	0.5569226053452021	0.5
5203088211	34	15.097145422938521	7.0	7	27	0.5591535341829081	0.25925925925925924
5203088212	2	1.3694782502329834	0.0	0	2	0.6847391251164917	0.0
5203088213	2	0.5541705076362555	1.0	1	1	0.5541705076362555	1.0
5203088214	6	2.9651154721802584	1.0	1	5	0.5930230944360517	0.2
5203088215	3	1.1084837059108907	1.0	1	2	0.5542418529554454	0.5
5203088216	2	0.5543623218332467	1.0	1	1	0.5543623218332467	1.0
5203088217	1	0.5543735337215385	0.0	0	1	0.5543735337215385	0.0
5203088218	2	1.2948394641094492	0.0	0	2	0.6474197320547246	0.0
5203088219	2	0.5544014119302639	1.0	1	1	0.5544014119302639	1.0
5203088220	11	5.763349360722036	1.0	1	10	0.5763349360722037	0.1
5203088221	5	2.0494054719469297	2.0	2	3	0.6831351573156432	0.6666666666666666
5203088222	45	18.00430950643214	13.0	13	32	0.5626346720760044	0.40625
5203088223	2	0.5546819784922313	1.0	1	1	0.5546819784922313	1.0
5203088224	5	2.967672658113466	0.0	0	5	0.5935345316226932	0.0
5203088225	2	1.1094468845546206	0.0	0	2	0.5547234422773103	0.0
5203088226	4	1.8954837200856804	1.0	1	3	0.6318279066952268	0.3333333333333333
5203088227	3	0.7480168172937283	0.5	1	2	0.7480168172937283	0.5
5203088228	1	0.5548498874619339	0.0	0	1	0.5548498874619339	0.0
5203088229	2	0.5548611330195599	1.0	1	1	0.5548611330195599	1.0
5203088230	2	0.5548841628441591	1.0	1	1	0.5548841628441591	1.0
5203088231	1	0.5548986743272034	0.0	0	1	0.5548986743272034	0.0
5203088232	1	0.554899246705885	0.0	0	1	0.554899246705885	0.0
5203088233	47	18.535874355741498	14.0	14	33	0.561693162295197	0.42424242424242425
5203088234	2	0.5549405926482941	1.0	1	1	0.5549405926482941	1.0
5203088235	5	2.9689291303274947	0.0	0	5	0.5937858260654989	0.0
5203088236	2	1.1099705437095801	0.0	0	2	0.5549852718547901	0.0
5203088237	2	1.3021110302186651	0.0	0	2	0.6510555151093326	0.0
5203088238	3	1.1103132301931642	1.0	1	2	0.5551566150965821	0.5
5203088239	2	0.5551808570172128	1.0	1	1	0.5551808570172128	1.0
5203088240	5	1.6756921245104097	2.0	2	3	0.5585640415034699	0.6666666666666666
5203088241	3	1.1104699272745748	1.0	1	2	0.5552349636372874	0.5
5203088242	6	3.5256492146274265	0.0	0	6	0.5876082024379045	0.0
5203088243	4	2.8136006736829744	0.0	0	4	0.7034001684207436	0.0
5203088244	1	0.5553923004360481	0.0	0	1	0.5553923004360481	0.0
5203088245	2	1.4575267914467904	0.0	0	2	0.7287633957233952	0.0
5203088246	6	2.232035347952536	2.0	2	4	0.558008836988134	0.5
5203088247	33	14.657964209969101	7.0	7	26	0.5637678542295809	0.2692307692307692
5203088248	2	0.5554438481867229	1.0	1	1	0.5554438481867229	1.0
5203088249	9	2.9712879028742063	4.0	4	5	0.5942575805748412	0.8
5203088250	4	1.1110415652307828	2.0	2	2	0.5555207826153914	1.0
5203088251	3	1.1112218645154746	1.0	1	2	0.5556109322577373	0.5
5203088252	1	0.5556103093750544	0.0	0	1	0.5556103093750544	0.0
5203088253	3	1.1112774189169201	1.0	1	2	0.5556387094584601	0.5
5203088254	1	0.5556415545172008	0.0	0	1	0.5556415545172008	0.0
5203088255	7	2.972546193232282	2.0	2	5	0.5945092386464564	0.4
5203088256	4	1.1115753588553396	2.0	2	2	0.5557876794276698	1.0
5203088257	48	19.76638613265172	13.0	13	35	0.5647538895043349	0.37142857142857144
5203088258	2	1.2974564131108792	0.0	0	2	0.6487282065554396	0.0
5203088259	1	0.5558805057820853	0.0	0	1	0.5558805057820853	0.0
5203088260	6	2.973634049420589	0.0	0	6	0.5947268098841179	0.0
5203088261	2	1.111932287467294	0.0	0	2	0.555966143733647	0.0
5203088262	1	0.5561517796078108	0.0	0	1	0.5561517796078108	0.0
5203088263	2	0.5561629914961026	1.0	1	1	0.5561629914961026	1.0
5203088264	7	2.8178480265241626	2.0	2	5	0.5635696053048325	0.4
5203088265	11	3.0838977856924656	2.5	4	7	0.6167795571384931	0.5714285714285714
5203088266	4	1.1125558772061874	2.0	2	2	0.5562779386030937	1.0
5203088267	45	17.482733910881382	14.0	14	31	0.5639591584155285	0.45161290322580644
5203088268	6	2.2353171316272658	2.0	2	4	0.5588292829068164	0.5
5203088269	2	0.5564013030436371	1.0	1	1	0.5564013030436371	1.0
5203088270	7	2.794168585790659	0.5	1	6	0.5588337171581318	0.16666666666666666
5203088271	4	1.1129419971309014	2.0	2	2	0.5564709985654507	1.0
5203088272	4	1.4267795514147064	0.5	1	3	0.7133897757073532	0.3333333333333333
5203088273	1	0.5565566196823453	0.0	0	1	0.5565566196823453	0.0
5203088274	1	0.5565766529362	0.0	0	1	0.5565766529362	0.0
5203088275	1	0.5565878648244917	0.0	0	1	0.5565878648244917	0.0
5203088276	3	1.4133998630398823	1.0	1	2	0.7066999315199411	0.5
5203088277	6	2.236186675852559	2.0	2	4	0.5590466689631397	0.5
5203088278	3	1.4242229041908456	1.0	1	2	0.7121114520954228	0.5
5203088279	6	2.7835633178933623	1.0	1	5	0.5567126635786724	0.2
5203088280	6	3.3536783427765156	1.0	1	5	0.6707356685553031	0.2
5203088281	5	1.4332408649961716	0.5	1	4	0.7166204324980858	0.25
5203088282	2	1.1571926940103636	0.0	0	2	0.5785963470051818	0.0
5203088283	1	0.5568772190826877	0.0	0	1	0.5568772190826877	0.0
5203088284	2	0.5569157704703576	1.0	1	1	0.5569157704703576	1.0
5203088285	3	1.8644428497899557	0.0	0	3	0.6214809499299853	0.0
5203088286	3	1.1139822448806367	1.0	1	2	0.5569911224403183	0.5
5203088287	2	0.7937330729526595	0.0	0	2	0.7937330729526595	0.0
5203088288	3	0.5925955342947926	0.5	1	2	0.5925955342947926	0.5
5203088289	8	4.928689562240407	0.5	1	7	0.8214482603734012	0.14285714285714285
5203088290	1	0.5571339477560349	0.0	0	1	0.5571339477560349	0.0
5203088291	3	1.114277289256314	1.0	1	2	0.557138644628157	0.5
5203088292	9	3.3909597904986284	3.0	3	6	0.5651599650831047	0.5
5203088293	8	2.990297642638198	3.0	3	5	0.5980595285276397	0.6
5203088294	3	1.1144994731927622	1.0	1	2	0.5572497365963811	0.5
5203088295	26	10.78495567954026	7.0	7	19	0.5676292462915926	0.3684210526315789
5203088296	5	1.6725238401613003	2.0	2	3	0.5575079467204335	0.6666666666666666
5203088297	5	2.9917495316679785	0.0	0	5	0.5983499063335957	0.0
5203088298	2	1.114850038300551	0.0	0	2	0.5574250191502755	0.0
5203088299	30	12.000315852024217	9.0	9	21	0.5714436120011532	0.42857142857142855
5203088300	1	0.557578753330276	0.0	0	1	0.557578753330276	0.0
5203088301	2	1.557042973215001	0.0	0	2	0.7785214866075005	0.0
5203088302	1	0.5576178097579589	0.0	0	1	0.5576178097579589	0.0
5203088303	4	1.6733056084323095	1.0	1	3	0.5577685361441032	0.3333333333333333
5203088304	11	2.800744779140447	2.5	4	7	0.5601489558280894	0.5714285714285714
5203088305	2	0.557728110496829	1.0	1	1	0.557728110496829	1.0
5203088306	27	10.746217696420247	8.0	8	19	0.5655904050747499	0.42105263157894735
5203088307	4	1.1158554046200453	2.0	2	2	0.5579277023100226	1.0
5203088308	4	1.1159560085906632	2.0	2	2	0.5579780042953316	1.0
5203088309	9	4.705688235365615	1.0	1	8	0.5882110294207019	0.125
5203088310	4	1.1163321623924514	2.0	2	2	0.5581660811962257	1.0
5203088311	24	9.076507501510827	8.0	8	16	0.5672817188444267	0.5
5203088312	10	3.2602056381522306	2.0	3	7	0.6520411276304461	0.42857142857142855
5203088313	2	0.5582076964933086	1.0	1	1	0.5582076964933086	1.0
5203088314	28	11.359172336386143	8.0	8	20	0.5679586168193071	0.4
5203088315	1	0.5583532826944302	0.0	0	1	0.5583532826944302	0.0
5203088316	3	1.1167838701802053	1.0	1	2	0.5583919350901027	0.5
5203088317	1	0.5583880967860028	0.0	0	1	0.5583880967860028	0.0
5203088318	31	12.578907401149277	9.0	9	22	0.571768518234058	0.4090909090909091
5203088319	2	1.117218776970189	0.0	0	2	0.5586093884850944	0.0
5203088320	4	1.675849764333179	1.0	1	3	0.5586165881110596	0.3333333333333333
5203088321	3	1.6761282097270909	0.0	0	3	0.5587094032423636	0.0
5203088322	3	1.117479209270299	1.0	1	2	0.5587396046351495	0.5
5203088323	14	5.6369543434064004	4.0	4	10	0.5636954343406401	0.4
5203088324	4	1.434540265611317	1.0	1	3	0.7172701328056585	0.3333333333333333
5203088325	1	0.5588905442604105	0.0	0	1	0.5588905442604105	0.0
5203088326	3	1.117803444958736	1.0	1	2	0.558901722479368	0.5
5203088327	2	1.5136547836699823	0.0	0	2	0.7568273918349911	0.0
5203088328	1	0.5588993319566391	0.0	0	1	0.5588993319566391	0.0
5203088329	16	7.556946510572491	3.0	3	13	0.5813035777363454	0.23076923076923078
5203088330	5	2.9985404343620203	0.0	0	5	0.5997080868724041	0.0
5203088331	3	1.6769722662663877	0.0	0	3	0.5589907554221293	0.0
5203088332	3	1.1180346859460866	1.0	1	2	0.5590173429730433	0.5
5203088333	27	10.160059974511638	9.0	9	18	0.5644477763617577	0.5
5203088334	1	0.5591245461331662	0.0	0	1	0.5591245461331662	0.0
5203088335	5	2.999555160756424	0.0	0	5	0.5999110321512848	0.0
5203088336	3	1.6776240372380142	0.0	0	3	0.5592080124126714	0.0
5203088337	3	1.1184686836640465	1.0	1	2	0.5592343418320233	0.5
5203088338	28	12.035053581546805	7.0	7	21	0.5730977895974669	0.3333333333333333
5203088339	2	1.3124593674266092	0.0	0	2	0.6562296837133046	0.0
5203088340	3	1.1189148360116559	1.0	1	2	0.5594574180058279	0.5
5203088341	3	1.8817889877506584	0.0	0	3	0.6272629959168862	0.0
5203088342	3	1.6783953006767502	0.0	0	3	0.5594651002255834	0.0
5203088343	3	1.1658793822364026	1.0	1	2	0.5829396911182013	0.5
5203088344	27	9.561233997260056	10.0	10	17	0.5624255292505915	0.5882352941176471
5203088345	3	1.6789912142229233	0.0	0	3	0.5596637380743078	0.0
5203088346	3	1.1658690794201345	1.0	1	2	0.5829345397100673	0.5
5203088347	27	10.829616165886385	8.0	8	19	0.5699797982045466	0.42105263157894735
5203088348	5	3.0027171826093717	0.0	0	5	0.6005434365218744	0.0
5203088349	3	1.6797601544775989	0.0	0	3	0.559920051492533	0.0
5203088350	3	1.1659052402850756	1.0	1	2	0.5829526201425378	0.5
5203088351	30	11.393470883113306	10.0	10	20	0.5696735441556653	0.5
5203088352	4	2.4434798442066032	0.0	0	4	0.6108699610516508	0.0
5203088353	3	1.6803839799018316	0.0	0	3	0.5601279933006106	0.0
5203088354	3	1.1659009306102968	1.0	1	2	0.5829504653051484	0.5
5203088355	1	0.5601654336002515	0.0	0	1	0.5601654336002515	0.0
5203088356	22	9.108121794237473	6.0	6	16	0.569257612139842	0.375
5203088357	7	3.0043508523745484	2.0	2	5	0.6008701704749096	0.4
5203088358	3	1.6808387515989989	0.0	0	3	0.5602795838663329	0.0
5203088359	3	1.1658545679370904	1.0	1	2	0.5829272839685452	0.5
5203088360	19	8.084492689158612	5.0	5	14	0.5774637635113294	0.35714285714285715
5203088361	12	5.138511230254913	3.0	3	9	0.5709456922505459	0.3333333333333333
5203088362	3	1.6813705587328371	0.0	0	3	0.5604568529109457	0.0
5203088363	31	13.278768249157917	8.0	8	23	0.5773377499633877	0.34782608695652173
5203088364	1	0.5606358952071602	0.0	0	1	0.5606358952071602	0.0
5203088365	2	0.5606671403493065	1.0	1	1	0.5606671403493065	1.0
5203088366	2	0.5606904731979137	1.0	1	1	0.5606904731979137	1.0
5203088367	1	0.5606907425525873	0.0	0	1	0.5606907425525873	0.0
5203088368	3	1.12148326750249	1.0	1	2	0.560741633751245	0.5
5203088369	6	2.5525956581979425	2.0	2	4	0.6381489145494856	0.5
5203088370	27	10.19192624853551	9.0	9	18	0.5662181249186395	0.5
5203088371	2	0.5609449123565345	1.0	1	1	0.5609449123565345	1.0
5203088372	1	0.5609451817112082	0.0	0	1	0.5609451817112082	0.0
5203088373	10	4.988584816268295	0.5	1	9	0.7126549737526136	0.1111111111111111
5203088374	3	1.6831069536366872	0.0	0	3	0.5610356512122291	0.0
5203088375	3	1.1659553402543792	1.0	1	2	0.5829776701271896	0.5
5203088376	3	0.6544580875205387	0.5	1	2	0.6544580875205387	0.5
5203088377	1	0.5612718415917084	0.0	0	1	0.5612718415917084	0.0
5203088378	1	0.5612830534800001	0.0	0	1	0.5612830534800001	0.0
5203088379	5	3.057481869821088	1.0	1	4	0.764370467455272	0.25
5203088380	1	0.5613216048676699	0.0	0	1	0.5613216048676699	0.0
5203088381	2	1.1254264852477642	0.0	0	2	0.5627132426238821	0.0
5203088382	2	1.1227526350715205	0.0	0	2	0.5613763175357602	0.0
5203088383	1	0.5613916034134914	0.0	0	1	0.5613916034134914	0.0
5203088384	3	1.122912328723676	1.0	1	2	0.561456164361838	0.5
5203088385	2	1.4301522422918016	0.0	0	2	0.7150761211459008	0.0
5203088386	4	2.838979338375361	0.0	0	4	0.7097448345938403	0.0
5203088387	1	0.562882481532286	0.0	0	1	0.562882481532286	0.0
5203088388	1	0.5628940974525882	0.0	0	1	0.5628940974525882	0.0
5203088389	1	0.5629614697903413	0.0	0	1	0.5629614697903413	0.0
5203088390	2	1.5247974141412617	0.0	0	2	0.7623987070706308	0.0
5203088391	3	1.98598662108602	0.0	0	3	0.6619955403620067	0.0
5203088392	3	1.7785393145199642	0.0	0	3	0.5928464381733214	0.0
5203088393	2	1.126062633648318	0.0	0	2	0.563031316824159	0.0
5203088394	1	0.563053185056728	0.0	0	1	0.563053185056728	0.0
5753193471	2	0.4514311268348398	1.0	1	1	0.4514311268348398	1.0
5753193472	2	0.45144237239246576	1.0	1	1	0.45144237239246576	1.0
5753193473	6	2.4415786715811327	1.0	1	5	0.48831573431622655	0.2
5753193474	2	0.45149930723661397	1.0	1	1	0.45149930723661397	1.0
5753193475	31	9.61478386122416	10.0	10	21	0.4578468505344838	0.47619047619047616
5753193476	6	2.4460418448546033	1.0	1	5	0.4892083689709207	0.2
5753193477	3	1.3549889889492868	0.0	0	3	0.4516629963164289	0.0
5753193478	2	0.4516928385696499	1.0	1	1	0.4516928385696499	1.0
5753193479	31	10.1207816322469	9.0	9	22	0.4600355287384954	0.4090909090909091
5753193480	3	0.9035791074643331	1.0	1	2	0.45178955373216656	0.5
5753193481	1	0.4517817256119629	0.0	0	1	0.4517817256119629	0.0
5753193482	2	0.45178199496663657	1.0	1	1	0.45178199496663657	1.0
5753193483	3	0.90357860242432	1.0	1	2	0.45178930121216	0.5
5753193484	2	0.9611301004285534	0.0	0	2	0.4805650502142767	0.0
5753193485	14	6.3257645455648275	4.0	4	10	0.6325764545564827	0.4
5753193486	3	1.3555855422128098	0.0	0	3	0.45186184740426993	0.0
5753193487	4	0.9037869482644081	2.0	2	2	0.45189347413220404	1.0
5753193488	23	6.806333013216526	8.0	8	15	0.4537555342144351	0.5333333333333333
5753193489	4	1.2634738530852743	1.0	1	3	0.6317369265426371	0.3333333333333333
5753193490	1	0.45203168674913385	0.0	0	1	0.45203168674913385	0.0
5753193491	8	2.8151440086244675	2.0	2	6	0.4691906681040779	0.3333333333333333
5753193492	2	0.9042350197640676	0.0	0	2	0.4521175098820338	0.0
5753193493	2	0.45214818264549855	1.0	1	1	0.45214818264549855	1.0
5753193494	30	9.148919734563087	10.0	10	20	0.45744598672815434	0.5
5753193495	6	3.449482244762794	0.0	0	6	0.5749137074604657	0.0
5753193496	6	2.9515104686209046	1.0	1	5	0.590302093724181	0.2
5753193497	10	3.6584239647277363	4.0	4	6	0.6097373274546227	0.6666666666666666
5753193498	2	0.45226346644583176	1.0	1	1	0.45226346644583176	1.0
5753193499	4	0.9046466610441124	2.0	2	2	0.4523233305220562	1.0
5753193500	3	0.9047472650147301	1.0	1	2	0.45237363250736506	0.5
5753193501	28	9.178628241965477	8.0	8	20	0.4589314120982738	0.4
5753193502	3	0.6171376843787454	0.5	1	2	0.6171376843787454	0.5
5753193503	2	0.45245871491491235	1.0	1	1	0.45245871491491235	1.0
5753193504	1	0.45247679534738283	0.0	0	1	0.45247679534738283	0.0
5753193505	1	0.4524770647020565	0.0	0	1	0.4524770647020565	0.0
5753193506	1	0.4524773677260644	0.0	0	1	0.4524773677260644	0.0
5753193507	3	1.3577036800279267	0.0	0	3	0.45256789334264225	0.0
5753193508	3	0.9052075248133734	1.0	1	2	0.4526037624066867	0.5
5753193509	26	8.7079588952647	7.0	7	19	0.4583136260665631	0.3684210526315789
5753193510	4	2.63181569595002	0.0	0	4	0.657953923987505	0.0
5753193511	8	2.4513285027041696	3.0	3	5	0.4902657005408339	0.6
5753193512	3	1.35839541649926	0.0	0	3	0.45279847216642	0.0
5753193513	2	0.45282200703103237	1.0	1	1	0.45282200703103237	1.0
5753193514	32	12.577822440523708	10.0	10	22	0.5717192018419867	0.45454545454545453
5753193515	8	2.9059834009508956	2.0	2	6	0.48433056682514924	0.3333333333333333
5753193516	3	1.3589700173568784	0.0	0	3	0.45299000578562615	0.0
5753193517	10	3.7278171359201053	2.0	2	8	0.46597714199001317	0.25
5753193518	21	6.901308346557245	6.0	6	15	0.46008722310381633	0.4
5753193519	3	1.3596644473749486	0.0	0	3	0.4532214824583162	0.0
5753193520	2	0.4532467793514189	1.0	1	1	0.4532467793514189	1.0
5753193521	28	9.197635793222746	8.0	8	20	0.4598817896611373	0.4
5753193522	7	2.4551491977422555	2.0	2	5	0.4910298395484511	0.4
5753193523	3	1.360451232376755	0.0	0	3	0.453483744125585	0.0
5753193524	4	0.9070195410418578	2.0	2	2	0.4535097705209289	1.0
5753193525	31	10.161249007049248	9.0	9	22	0.46187495486587493	0.4090909090909091
5753193526	11	2.9096534593877292	5.0	5	6	0.4849422432312882	0.8333333333333334
5753193527	3	1.360973847782354	0.0	0	3	0.4536579492607847	0.0
5753193528	4	0.9073730690510571	2.0	2	2	0.45368653452552854	1.0
5753193529	22	6.859321946072702	7.0	7	15	0.45728812973818017	0.4666666666666667
5753193530	2	0.4538109763847667	1.0	1	1	0.4538109763847667	1.0
5753193531	1	0.4538221882730584	0.0	0	1	0.4538221882730584	0.0
5753193532	2	0.4538363630627606	1.0	1	1	0.4538363630627606	1.0
5753193533	2	0.45385370276987846	1.0	1	1	0.45385370276987846	1.0
5753193534	9	3.307490211398638	2.0	2	7	0.47249860162837687	0.2857142857142857
5753193535	7	2.911073194203339	1.0	1	6	0.4851788657005565	0.16666666666666666
5797244857	3	0.961391105107345	0.0	0	3	0.4806955525536725	0.0
5797244858	8	0.5449295884997944	4.0	4	4	0.1362323971249486	1.0
5797244859	21	1.9759813070550016	7.0	7	14	0.14114152193250012	0.5
5797244860	3	0.27228303034916745	1.0	1	2	0.13614151517458373	0.5
5797244861	2	0.1361439056973126	1.0	1	1	0.1361439056973126	1.0
5797244862	12	0.8501438539138766	5.0	6	6	0.1700287707827753	1.0
5797244863	5	1.1991679499452823	0.5	1	4	0.5995839749726412	0.25
5797244864	4	0.2724731947487825	2.0	2	2	0.13623659737439126	1.0
5797244865	18	1.7972149198112617	5.0	5	13	0.1382473015239432	0.38461538461538464
5797244866	8	3.0237510554073674	2.0	2	6	0.5039585092345612	0.3333333333333333
5797244867	2	0.38270605624118853	0.0	0	2	0.38270605624118853	0.0
5797244868	4	2.4315431898266624	0.0	0	4	0.6078857974566656	0.0
5797244869	8	6.240356286201058	0.0	0	8	0.7800445357751322	0.0
5797244870	9	6.310013694328303	0.0	0	9	0.7887517117910379	0.0
5797244871	6	3.2971888092425825	1.0	1	5	0.6594377618485165	0.2
5797244872	4	0.2729451714757306	2.0	2	2	0.1364725857378653	1.0
5797244873	10	1.0485594289169144	3.0	3	7	0.1497942041309878	0.42857142857142855
5797244874	8	0.7098268025879731	4.0	4	4	0.1774567006469933	1.0
5797244875	1	0.13647841053268356	0.0	0	1	0.13647841053268356	0.0
5797244876	1	0.13653268549942918	0.0	0	1	0.13653268549942918	0.0
5797244877	31	2.9861645971866504	10.0	10	21	0.14219831415174525	0.47619047619047616
5797244878	2	0.13664180781160204	1.0	1	1	0.13664180781160204	1.0
5797244879	10	1.4630762721191954	4.0	4	6	0.24384604535319923	0.6666666666666666
5797244880	3	0.2734685612760166	1.0	1	2	0.1367342806380083	0.5
5797244881	31	2.9915518926761693	10.0	10	21	0.14245485203219854	0.47619047619047616
5797244882	8	2.5321940618270657	3.0	3	5	0.5064388123654131	0.6
5797244883	7	5.183341578392126	0.0	0	7	0.8638902630653543	0.0
5797244884	9	3.32870145424925	1.0	2	7	0.66574029084985	0.2857142857142857
5797244885	8	5.142012638996691	0.5	1	7	0.8570021064994485	0.14285714285714285
5797244886	6	1.0599036040227716	1.5	2	4	0.35330120134092385	0.5
5797244887	2	0.8973635463532627	0.0	0	2	0.4486817731766313	0.0
5797244888	2	0.5530393190148205	0.0	0	2	0.5530393190148205	0.0
5797244889	1	0.13688449637258376	0.0	0	1	0.13688449637258376	0.0
5797244890	9	0.848442239432265	4.0	4	5	0.16968844788645301	0.8
5797244891	4	0.27396999867039795	2.0	2	2	0.13698499933519898	1.0
5797244892	26	2.376837524957815	9.0	9	17	0.13981397205634205	0.5294117647058824
5797244893	3	0.4114385906528474	0.0	0	3	0.13714619688428245	0.0
5797244894	2	0.13716752079594846	1.0	1	1	0.13716752079594846	1.0
5797244895	14	1.6246452388514354	3.0	3	11	0.14769502171376686	0.2727272727272727
5797244896	1	0.1372742189160582	0.0	0	1	0.1372742189160582	0.0
5797244897	10	2.7772642905027864	1.3333333333333333	2	8	0.6943160726256966	0.25
5797244898	7	1.427024798845088	0.3333333333333333	1	6	0.47567493294836266	0.16666666666666666
5797244899	2	0.8007115811769163	0.0	0	2	0.8007115811769163	0.0
5797244900	5	2.1516070188036833	0.5	1	4	0.7172023396012278	0.25
5797244901	2	0.8007445771244416	0.0	0	2	0.8007445771244416	0.0
5797244902	3	1.7495319373331537	0.0	0	3	0.8747659686665769	0.0
5797244903	15	1.4424881476367986	5.0	5	10	0.14424881476367984	0.5
5797244904	10	1.5146830788060734	4.0	4	6	0.2524471798010122	0.6666666666666666
5797244905	3	0.4121077013315918	0.0	0	3	0.13736923377719726	0.0
5797244906	5	0.4938368452076265	2.0	2	3	0.1646122817358755	0.6666666666666666
5797244907	28	2.8689784794706448	8.0	8	20	0.14344892397353223	0.4
5797244908	6	0.45680953362012644	2.0	3	3	0.22840476681006322	1.0
5797244909	8	0.5503144597972494	4.0	4	4	0.13757861494931234	1.0
5797244910	2	0.27517317232837285	0.0	0	2	0.13758658616418643	0.0
5797244911	3	0.8590897286746602	1.0	1	2	0.4295448643373301	0.5
5797244912	1	0.1376271408772417	0.0	0	1	0.1376271408772417	0.0
5797244913	31	3.010215073983143	10.0	10	21	0.14334357495157823	0.47619047619047616
5797244914	2	0.13770996743939698	1.0	1	1	0.13770996743939698	1.0
5797244915	2	1.0952627684468643	0.0	0	2	0.5476313842234322	0.0
5797244916	2	0.833573693098699	0.0	0	2	0.4167868465493495	0.0
5797244917	1	0.13771340171148633	0.0	0	1	0.13771340171148633	0.0
5797244918	3	0.2757899271924216	1.0	1	2	0.1378949635962108	0.5
5797244919	13	0.9936586839256571	5.0	6	7	0.1656097806542762	0.8571428571428571
5797244920	1	0.13777686840647116	0.0	0	1	0.13777686840647116	0.0
5797244921	2	0.13781218753805688	1.0	1	1	0.13781218753805688	1.0
5797244922	13	2.0832420417394024	3.0	3	10	0.23147133797104472	0.3
5797244923	3	0.27225872108986826	0.5	1	2	0.27225872108986826	0.5
5797244924	1	0.13792137718889813	0.0	0	1	0.13792137718889813	0.0
5797244925	3	0.27590756784614945	1.0	1	2	0.13795378392307472	0.5
5797244926	1	0.13796588804872303	0.0	0	1	0.13796588804872303	0.0
5797244927	2	0.1380053821777507	1.0	1	1	0.1380053821777507	1.0
5797244928	21	2.0266625100751274	7.0	7	14	0.1447616078625091	0.5
5797244929	9	0.8548816679464941	4.0	4	5	0.1709763335892988	0.8
5797244930	6	2.9450419498019187	1.0	1	5	0.5890083899603837	0.2
5797244931	29	2.881018465037275	9.0	9	20	0.14405092325186375	0.45
5797244932	2	0.13822342478609115	1.0	1	1	0.13822342478609115	1.0
5797244933	4	0.27662071801403987	2.0	2	2	0.13831035900701993	1.0
5797244934	31	3.208480012384929	9.0	9	22	0.14584000056295132	0.4090909090909091
5797244935	4	0.7343965278566436	0.3333333333333333	1	3	0.7343965278566436	0.3333333333333333
5797244936	5	0.9288617135462203	0.5	1	4	0.3096205711820734	0.25
5797244937	3	0.2768152930964364	1.0	1	2	0.1384076465482182	0.5
5797244938	3	0.22446742436360834	0.5	1	2	0.22446742436360834	0.5
5797244939	1	0.13840123254005127	0.0	0	1	0.13840123254005127	0.0
5797244940	1	0.1384088081402484	0.0	0	1	0.1384088081402484	0.0
5797244941	1	0.13842884139410302	0.0	0	1	0.13842884139410302	0.0
5797244942	3	0.3007362776335589	1.0	1	2	0.15036813881677946	0.5
5797244943	10	0.8568614247980102	5.0	5	5	0.17137228495960205	1.0
5797244944	4	0.2770712810444308	2.0	2	2	0.1385356405222154	1.0
5797244945	25	2.4500086984724927	8.0	8	17	0.14411815873367603	0.47058823529411764
5797244946	1	0.13862860155396772	0.0	0	1	0.13862860155396772	0.0
5797244947	2	0.13863981344225945	1.0	1	1	0.13863981344225945	1.0
5797244948	2	0.7493501565977568	0.0	0	2	0.3746750782988784	0.0
5797244949	1	0.13866765798165068	0.0	0	1	0.13866765798165068	0.0
5797244950	9	1.0634606008353296	2.0	2	7	0.15192294297647566	0.2857142857142857
5797244951	18	2.268149681873612	9.0	9	9	0.2520166313192902	1.0
5797244952	3	0.27752864528033205	1.0	1	2	0.13876432264016603	0.5
5797244953	1	0.13888522921931218	0.0	0	1	0.13888522921931218	0.0
5797244954	4	1.6687758708851064	1.0	1	3	0.5562586236283688	0.3333333333333333
5797244955	2	0.13891398283072706	1.0	1	1	0.13891398283072706	1.0
5797244956	1	0.1389251947190188	0.0	0	1	0.1389251947190188	0.0
5797244957	26	2.430566644457252	9.0	9	17	0.1429745084974854	0.5294117647058824
5797244958	14	1.283101088438668	5.0	6	8	0.1833001554912383	0.75
5797244959	2	0.27799422483378033	0.0	0	2	0.13899711241689017	0.0
5797244960	4	0.2780639203555939	2.0	2	2	0.13903196017779695	1.0
5797244961	21	1.837853065476721	8.0	8	13	0.14137331272897852	0.6153846153846154
5797244962	4	0.27855970130182817	2.0	2	2	0.13927985065091408	1.0
5797244963	2	0.13922986852428015	1.0	1	1	0.13922986852428015	1.0
5797244964	4	0.6404633614177105	2.0	2	2	0.32023168070885527	1.0
5797244965	13	2.763649455497844	5.0	5	8	0.3454561819372305	0.625
5797244966	3	0.2786303058956654	1.0	1	2	0.1393151529478327	0.5
5797244967	27	2.7619625208459477	8.0	8	19	0.1453664484655762	0.42105263157894735
5797244968	5	2.791407128006802	0.0	0	5	0.5582814256013604	0.0
5797244969	14	3.234398497512695	6.0	6	8	0.4042998121890869	0.75
5797244970	1	0.139442355692476	0.0	0	1	0.139442355692476	0.0
5797244971	3	0.2789126232630117	1.0	1	2	0.13945631163150585	0.5
5797244972	1	0.13946679962911207	0.0	0	1	0.13946679962911207	0.0
5797244973	3	1.633376404267965	0.0	0	3	0.544458801422655	0.0
5797244974	9	0.6976905900641728	4.0	4	5	0.13953811801283456	0.8
5797244975	3	0.4186148052075821	0.0	0	3	0.13953826840252737	0.0
5797244976	4	0.27913487453812824	2.0	2	2	0.13956743726906412	1.0
5797244977	30	2.906180231878684	10.0	10	20	0.1453090115939342	0.5
5797244978	8	2.3092793661491946	1.3333333333333333	2	6	0.5773198415372987	0.3333333333333333
5797244979	7	1.6319451545400554	3.0	3	4	0.40798628863501385	0.75
5797244980	8	2.262023378167531	3.0	3	5	0.4524046756335062	0.6
5797244981	3	0.33020957106716	0.5	1	2	0.33020957106716	0.5
5797244982	3	0.4190983641854983	0.0	0	3	0.13969945472849943	0.0
5797244983	4	0.6356151793075544	0.5	1	3	0.3178075896537772	0.3333333333333333
5797244984	2	0.2794337908872398	0.0	0	2	0.1397168954436199	0.0
5797244985	4	0.4191445585120336	1.0	1	3	0.13971485283734453	0.3333333333333333
5797244986	1	0.13972642386520118	0.0	0	1	0.13972642386520118	0.0
5797244987	3	0.2794740257416201	1.0	1	2	0.13973701287081006	0.5
5797244988	11	0.9855058903321773	5.0	5	6	0.16425098172202954	0.8333333333333334
5797244989	3	0.41941869423116696	0.0	0	3	0.13980623141038898	0.0
5797244990	5	0.8002621965732227	2.0	2	3	0.26675406552440756	0.6666666666666666
5797244991	18	2.097259865005498	4.0	4	14	0.14980427607182129	0.2857142857142857
5797244992	1	0.13992864188646317	0.0	0	1	0.13992864188646317	0.0
5797244993	2	0.4382834875113874	0.0	0	2	0.4382834875113874	0.0
5797244994	3	0.22848427694279885	0.5	1	2	0.22848427694279885	0.5
5797244995	3	1.4323195710041983	0.0	0	3	0.7161597855020991	0.0
5797244996	1	0.13993615014799188	0.0	0	1	0.13993615014799188	0.0
5797244997	3	0.36584886435187525	0.5	1	2	0.36584886435187525	0.5
5797244998	11	1.00735486404205	4.0	4	7	0.14390783772029286	0.5714285714285714
5797244999	10	1.5315786537363851	3.0	4	6	0.3828946634340963	0.6666666666666666
5797245000	3	0.4200455498954786	0.0	0	3	0.14001518329849286	0.0
5797245001	2	0.1400312660171336	1.0	1	1	0.1400312660171336	1.0
5797245002	29	3.110207171790404	8.0	8	21	0.14810510341859068	0.38095238095238093
5797245003	13	1.148271431532887	6.0	6	7	0.16403877593326957	0.8571428571428571
5797245004	3	0.4208501123057477	0.0	0	3	0.14028337076858258	0.0
5797245005	11	1.062248605811792	5.0	5	6	0.1770414343019653	0.8333333333333334
5797245006	25	2.498003122292039	8.0	8	17	0.1469413601348258	0.47058823529411764
5797245007	14	1.9429428688299641	5.5	6	8	0.27756326697570916	0.75
5797245008	8	1.6436067304595052	4.0	4	4	0.4109016826148763	1.0
5797245009	1	0.14044704862528615	0.0	0	1	0.14044704862528615	0.0
5797245010	3	0.2614803591454009	0.5	1	2	0.2614803591454009	0.5
5797245011	1	0.14048947198639006	0.0	0	1	0.14048947198639006	0.0
5797245012	9	0.8673293891504004	4.0	4	5	0.17346587783008008	0.8
5797245013	3	0.4217042359759732	0.0	0	3	0.14056807865865772	0.0
5797245014	4	0.28120358577062554	2.0	2	2	0.14060179288531277	1.0
5797245015	27	4.124511016050609	8.0	8	19	0.21707952716055837	0.42105263157894735
5797245016	4	0.8538734397335921	0.3333333333333333	1	3	0.8538734397335921	0.3333333333333333
5797245017	9	2.359291256474571	4.0	4	5	0.4718582512949142	0.8
5797245018	3	0.3966366085930134	0.5	1	2	0.3966366085930134	0.5
5797245019	4	2.9791835300929943	0.0	0	4	0.9930611766976648	0.0
5797245020	5	1.7340372087219602	0.5	1	4	0.8670186043609801	0.25
5797245021	6	2.979280430436849	0.0	0	6	0.993093476812283	0.0
5797245022	2	0.9931082913193352	0.0	0	2	0.9931082913193352	0.0
5797245023	4	1.7338402767861691	0.5	1	3	0.8669201383930846	0.3333333333333333
5797245024	13	1.6038498459476451	3.0	3	10	0.16038498459476452	0.3
5797245025	11	1.0096633682727871	5.0	5	6	0.16827722804546452	0.8333333333333334
5797245026	3	0.4226142170716521	0.0	0	3	0.1408714056905507	0.0
5797245027	2	0.14089821770369282	1.0	1	1	0.14089821770369282	1.0
5797245028	4	0.4931093519033628	1.0	1	3	0.1643697839677876	0.3333333333333333
5797245029	6	4.097651237346349	0.0	0	6	0.6829418728910581	0.0
5797245030	3	0.4712160356803362	0.5	1	2	0.4712160356803362	0.5
5797245031	1	0.141026363189694	0.0	0	1	0.141026363189694	0.0
5797245032	4	3.0622195155070346	0.0	0	4	0.7655548788767587	0.0
5797245033	3	0.282093230588442	1.0	1	2	0.141046615294221	0.5
5797245034	1	0.14105050410232217	0.0	0	1	0.14105050410232217	0.0
5797245035	4	1.027848276687316	0.5	1	3	0.513924138343658	0.3333333333333333
5797245036	2	0.8565219705705104	0.0	0	2	0.4282609852852552	0.0
5797245037	24	2.312717274526654	8.0	8	16	0.14454482965791587	0.5
5797245038	8	0.7333900504491202	4.0	4	4	0.18334751261228005	1.0
5797245039	3	0.42337487467011203	0.0	0	3	0.14112495822337068	0.0
5797245040	3	0.2823032262259063	1.0	1	2	0.14115161311295316	0.5
5797245041	2	0.14116535020131063	1.0	1	1	0.14116535020131063	1.0
5797245042	31	3.106537753070921	10.0	10	21	0.14793036919385338	0.47619047619047616
5797245043	4	0.5075684791329419	0.3333333333333333	1	3	0.5075684791329419	0.3333333333333333
5797245044	3	0.2825231206476283	1.0	1	2	0.14126156032381415	0.5
5797245045	1	0.14125935498242342	0.0	0	1	0.14125935498242342	0.0
5797245046	1	0.1412688834040047	0.0	0	1	0.1412688834040047	0.0
5797245047	3	0.9884692631132882	0.0	0	3	0.32948975437109607	0.0
5797245048	2	0.6464297694556311	0.0	0	2	0.32321488472781557	0.0
5797245049	9	0.8758274954355325	4.0	4	5	0.1751654990871065	0.8
5797245050	3	0.42414509435948755	0.0	0	3	0.14138169811982917	0.0
5797245051	4	1.9861350018418809	1.0	1	3	0.6620450006139603	0.3333333333333333
5797245052	25	2.516035777977272	8.0	8	17	0.14800210458689836	0.47058823529411764
5797245053	15	2.9128478038015166	7.0	7	8	0.3641059754751896	0.875
5797245054	2	0.741287058110611	0.0	0	2	0.741287058110611	0.0
5797245055	7	4.572650460426462	0.0	0	7	0.762108410071077	0.0
5797245056	8	3.069967570033983	0.5	1	7	0.6139935140067966	0.14285714285714285
5797245057	10	0.8766968376448205	5.0	5	5	0.17533936752896412	1.0
5797245058	3	0.4247571018474128	0.0	0	3	0.14158570061580425	0.0
5797245059	14	5.661900626508871	4.0	4	10	0.5661900626508871	0.4
5797245060	18	1.9514889202470105	5.0	5	13	0.1501145323266931	0.38461538461538464
5797245061	14	6.922982879446579	1.0	1	13	0.5769152399538816	0.07692307692307693
5797245062	10	1.062065545641695	5.0	5	5	0.212413109128339	1.0
5797245063	9	1.2119943501510422	4.0	4	5	0.24239887003020844	0.8
5797245064	18	2.318502272191854	7.0	8	10	0.28981278402398175	0.8
5797245065	18	3.2334066662655525	7.0	8	10	0.40417583328319406	0.8
5797245066	3	0.19761912690231317	0.5	1	2	0.19761912690231317	0.5
5797245067	8	1.255151265039376	4.0	4	4	0.313787816259844	1.0
5797245068	2	0.14173513634413723	1.0	1	1	0.14173513634413723	1.0
5797245069	3	1.0448464757482985	0.0	0	3	0.5224232378741492	0.0
5797245070	14	1.5279440827778088	4.0	4	10	0.15279440827778087	0.4
5797245071	9	0.8777912930226333	4.0	4	5	0.17555825860452665	0.8
5797245072	3	0.42544604376400663	0.0	0	3	0.14181534792133554	0.0
5797245073	4	0.5337146026292989	1.0	1	3	0.17790486754309964	0.3333333333333333
5797245074	31	3.3145631957746873	9.0	9	22	0.15066196344430396	0.4090909090909091
5797245075	7	5.02995079193136	0.0	0	7	0.83832513198856	0.0
5797245076	13	6.07116252837441	0.6666666666666666	2	11	0.7588953160468013	0.18181818181818182
5797245077	4	0.6200543241239735	0.3333333333333333	1	3	0.6200543241239735	0.3333333333333333
5797245078	2	0.5973444255383651	0.0	0	2	0.5973444255383651	0.0
5797245079	3	0.4260407788834825	0.0	0	3	0.14201359296116084	0.0
5797245080	2	0.14204122426143537	1.0	1	1	0.14204122426143537	1.0
5797245081	3	0.7162313160026271	1.0	1	2	0.35811565800131356	0.5
5797245082	2	0.14206570186740566	1.0	1	1	0.14206570186740566	1.0
5797245083	30	3.1480272278518653	9.0	9	21	0.14990605846913643	0.42857142857142855
5797245084	8	0.7371835743344994	4.0	4	4	0.18429589358362486	1.0
5797245085	3	0.4265971309619595	0.0	0	3	0.1421990436539865	0.0
5797245086	4	0.2844468853963539	2.0	2	2	0.14222344269817694	1.0
5797245087	14	2.721902645995536	0.0	0	14	0.22682522049962803	0.0
5797245088	70	9.408320473611708	12.5	21	49	0.3034942088261841	0.42857142857142855
5797245089	2	1.1167915131190709	0.0	0	2	0.5583957565595354	0.0
5797245090	4	1.9429454613686983	0.0	0	4	0.48573636534217457	0.0
5797245091	6	0.5660636612363978	1.0	2	4	0.18868788707879927	0.5
5797245092	2	0.14239795085738455	1.0	1	1	0.14239795085738455	1.0
5797245093	10	0.8813933730736974	5.0	5	5	0.17627867461473948	1.0
5797245094	5	0.30510500842457244	1.0	2	3	0.15255250421228622	0.6666666666666666
5797245095	2	0.1424690268219007	1.0	1	1	0.1424690268219007	1.0
5797245096	2	0.31901636925589794	0.0	0	2	0.15950818462794897	0.0
5797245097	2	0.6982347201743317	0.0	0	2	0.3491173600871659	0.0
5797245098	8	3.8292123695612115	2.0	2	6	0.6382020615935352	0.3333333333333333
5797245099	9	0.8835938324109563	4.0	4	5	0.17671876648219126	0.8
5797245100	6	1.3930571880038722	2.0	2	4	0.34826429700096806	0.5
5797245101	70	10.93016161920138	12.5	19	51	0.3312170187636782	0.37254901960784315
5797245102	9	1.2255527890211844	3.0	4	5	0.3063881972552961	0.8
5797245103	5	1.9601262155597643	1.0	1	4	0.4900315538899411	0.25
5797245104	3	0.18787828549151017	0.5	1	2	0.18787828549151017	0.5
5797245105	3	0.5359551958129355	0.5	1	2	0.5359551958129355	0.5
5797245106	2	0.14278932319823523	1.0	1	1	0.14278932319823523	1.0
5797245107	3	0.5985632891060815	1.0	1	2	0.29928164455304074	0.5
5797245108	2	0.884448629467866	0.0	0	2	0.884448629467866	0.0
5797245109	1	0.14280046774785857	0.0	0	1	0.14280046774785857	0.0
5797245110	1	0.14280100645720592	0.0	0	1	0.14280100645720592	0.0
5797245111	2	0.14280440705996109	1.0	1	1	0.14280440705996109	1.0
5797245112	4	0.28570073140231395	2.0	2	2	0.14285036570115697	1.0
5797245113	11	0.9031282077406002	4.5	5	6	0.18062564154812005	0.8333333333333334
5797245114	2	0.28578594848719807	0.0	0	2	0.14289297424359904	0.0
5797245115	11	2.606972474679566	5.0	5	6	0.43449541244659434	0.8333333333333334
5797245116	4	0.6575515249397007	0.3333333333333333	1	3	0.6575515249397007	0.3333333333333333
5797245117	4	1.544893326626851	0.5	1	3	0.7724466633134255	0.3333333333333333
5797245118	3	1.8433252750271147	0.0	0	3	0.9216626375135574	0.0
5797245119	2	0.9983388560581081	0.0	0	2	0.9983388560581081	0.0
5797245120	3	0.79269407096829	0.5	1	2	0.79269407096829	0.5
5797245121	3	1.250763612082537	0.0	0	3	0.6253818060412685	0.0
5797245122	3	0.7908446481094988	0.5	1	2	0.7908446481094988	0.5
5797245123	2	0.9983860604646698	0.0	0	2	0.9983860604646698	0.0
5797245124	7	0.6150245296250917	2.0	3	4	0.20500817654169723	0.75
5797245125	66	11.971584933740605	10.0	16	50	0.3990528311246868	0.32
5797245126	2	0.143094704059515	1.0	1	1	0.143094704059515	1.0
5797245127	10	0.8864937721664166	5.0	5	5	0.1772987544332833	1.0
5797245128	4	0.2863272503732835	2.0	2	2	0.14316362518664175	1.0
5797245129	4	0.4949130854756317	0.3333333333333333	1	3	0.4949130854756317	0.3333333333333333
5797245130	2	0.4553949502126505	0.0	0	2	0.4553949502126505	0.0
5797245131	8	0.8773417737416028	2.0	3	5	0.2193354434354007	0.6
5797245132	3	0.2865752923584045	1.0	1	2	0.14328764617920225	0.5
5797245133	11	1.0307986194360876	5.0	5	6	0.17179976990601462	0.8333333333333334
5797245134	50	7.270373272043472	9.0	13	37	0.2908149308817389	0.35135135135135137
5797245135	2	0.14344648126333537	1.0	1	1	0.14344648126333537	1.0
5797245136	9	0.8883117478670561	4.0	4	5	0.17766234957341123	0.8
5797245137	3	0.28704380114392913	1.0	1	2	0.14352190057196457	0.5
5797245138	1	0.1436278916360559	0.0	0	1	0.1436278916360559	0.0
5797245139	1	0.14363910352434767	0.0	0	1	0.14363910352434767	0.0
5797245140	11	1.2579173691913539	3.0	3	8	0.15723967114891924	0.375
5797245141	2	0.28744359081833215	0.0	0	2	0.14372179540916608	0.0
5797245142	8	1.4688583405523192	3.0	3	5	0.29377166811046385	0.6
5797245143	2	0.14378118811471155	1.0	1	1	0.14378118811471155	1.0
5797245144	2	0.14377785485062483	1.0	1	1	0.14377785485062483	1.0
5797245145	71	10.545456984950853	12.5	21	50	0.3401760317726082	0.42
5797245146	8	1.1250439679418107	3.0	3	5	0.22500879358836215	0.6
5797245147	11	2.1805704575093507	5.0	5	6	0.3634284095848918	0.8333333333333334
5797245148	10	1.6967487577783316	5.0	5	5	0.3393497515556663	1.0
5797245149	3	1.2638673129248459	0.0	0	3	0.6319336564624229	0.0
5797245150	8	1.9386410390060247	3.0	3	5	0.3877282078012049	0.6
5797245151	11	5.330996221391629	3.0	3	8	0.6663745276739537	0.375
5797245152	1	0.14387943523193475	0.0	0	1	0.14387943523193475	0.0
5797245153	7	4.0423042053301455	0.5	1	6	0.8084608410660291	0.16666666666666666
5797245154	5	2.354486204781537	0.5	1	4	0.7848287349271791	0.25
5797245155	2	0.5464757853346952	0.0	0	2	0.5464757853346952	0.0
5797245156	4	0.28789294175269153	2.0	2	2	0.14394647087634577	1.0
5797245157	9	0.8905103217215993	4.0	4	5	0.17810206434431985	0.8
5797245158	2	0.2879760713388547	0.0	0	2	0.14398803566942736	0.0
5797245159	12	1.3504885100535116	6.0	6	6	0.22508141834225193	1.0
5797245160	8	3.142016241615452	2.0	2	6	0.5236693736025754	0.3333333333333333
5797245161	1	0.14413980019337647	0.0	0	1	0.14413980019337647	0.0
5797245162	1	0.1441517191376866	0.0	0	1	0.1441517191376866	0.0
5797245163	4	0.16777213752832137	1.0	2	2	0.16777213752832137	1.0
5797245164	4	0.7548513554449054	1.0	1	3	0.3774256777224527	0.3333333333333333
5797245165	1	0.14417612940498845	0.0	0	1	0.14417612940498845	0.0
5797245166	1	0.14418003504775675	0.0	0	1	0.14418003504775675	0.0
5797245167	1	0.1441912469360485	0.0	0	1	0.1441912469360485	0.0
5797245168	7	0.6718276593378514	2.0	3	4	0.22394255311261713	0.75
5797245169	64	9.234289341531184	11.5	17	47	0.2798269497433692	0.3617021276595745
5797245170	2	0.1442372392465786	1.0	1	1	0.1442372392465786	1.0
5797245171	9	0.8919094509046732	4.0	4	5	0.17838189018093464	0.8
5797245172	4	0.6421177714927606	0.5	1	3	0.3210588857463803	0.3333333333333333
5797245173	9	2.3571953740893665	1.5	2	7	0.5892988435223416	0.2857142857142857
5797245174	2	0.5396019214011615	0.0	0	2	0.5396019214011615	0.0
5797245175	3	0.3210614446157802	0.5	1	2	0.3210614446157802	0.5
5797245176	2	0.6647042382991573	0.0	0	2	0.6647042382991573	0.0
5797245177	3	0.6647090530139492	0.5	1	2	0.6647090530139492	0.5
5797245178	3	0.8960233048357211	0.0	0	3	0.44801165241786056	0.0
5797245179	8	0.5949441050332389	2.0	3	5	0.14873602625830973	0.6
5797245180	6	1.6689318272411646	1.0	2	4	0.5563106090803882	0.5
5797245181	21	2.362668122349108	10.0	10	11	0.21478801112264617	0.9090909090909091
5797245182	4	0.3341007023524124	1.0	2	2	0.3341007023524124	1.0
5797245183	5	1.0891326264366832	1.0	1	4	0.5445663132183416	0.25
5797245184	2	1.0996756734043607	0.0	0	2	0.5498378367021803	0.0
5797245185	1	0.14463271924620286	0.0	0	1	0.14463271924620286	0.0
5797245186	2	0.14463662488897117	1.0	1	1	0.14463662488897117	1.0
5797245187	2	0.1446566244734916	1.0	1	1	0.1446566244734916	1.0
5797245188	42	6.673751592433248	7.0	10	32	0.30335234511060216	0.3125
5797245189	5	0.5266693954539732	1.5	2	3	0.2633346977269866	0.6666666666666666
5797245190	11	0.7525347369046239	4.0	5	6	0.1505069473809248	0.8333333333333334
5797245191	4	0.41211332411040486	1.0	2	2	0.41211332411040486	1.0
5797245192	9	3.9176842353140335	1.5	2	7	0.6529473725523389	0.2857142857142857
5797245193	6	3.8861683580512825	0.0	0	6	0.7772336716102565	0.0
5797245194	3	0.3196557499125355	0.5	1	2	0.3196557499125355	0.5
5797245195	3	0.376017575661812	0.5	1	2	0.376017575661812	0.5
5797245196	2	0.14488449852742116	1.0	1	1	0.14488449852742116	1.0
5797245197	2	0.3215731848264297	0.0	0	2	0.16078659241321486	0.0
5797245198	2	0.7992621163391993	0.0	0	2	0.7992621163391993	0.0
5797245199	1	0.1448939259409998	0.0	0	1	0.1448939259409998	0.0
5797245200	1	0.14490119851718905	0.0	0	1	0.14490119851718905	0.0
5797245201	3	1.3576729062564592	0.0	0	3	0.4525576354188197	0.0
5797245202	6	0.8749149891397878	1.0	2	4	0.2916383297132626	0.5
5797245203	5	0.6301468080612601	1.0	2	3	0.31507340403063006	0.6666666666666666
5797245204	9	0.7249556802136468	4.0	4	5	0.14499113604272934	0.8
5797245205	4	0.16973862866215877	1.0	2	2	0.16973862866215877	1.0
5797245206	63	9.898801327932006	16.5	20	43	0.2828228950837716	0.46511627906976744
5797245207	10	1.7586172368068986	4.0	4	6	0.29310287280114977	0.6666666666666666
5797245208	3	0.3166362840206316	0.5	1	2	0.3166362840206316	0.5
5797245209	8	4.513229371632246	0.5	1	7	0.7522048952720409	0.14285714285714285
5797245210	11	2.1861935393463376	5.0	5	6	0.3643655898910563	0.8333333333333334
5797245211	3	0.3304343812116765	0.5	1	2	0.3304343812116765	0.5
5797245212	2	0.14512173265626097	1.0	1	1	0.14512173265626097	1.0
5797245213	1	0.14513328123789482	0.0	0	1	0.14513328123789482	0.0
5797245214	3	0.2902788181134419	1.0	1	2	0.14513940905672096	0.5
5797245215	1	0.14513385361657638	0.0	0	1	0.14513385361657638	0.0
5797245216	1	0.14514115986209983	0.0	0	1	0.14514115986209983	0.0
5797245217	3	0.23976532204701337	0.5	1	2	0.23976532204701337	0.5
5797245218	9	0.8966161544724813	4.0	4	5	0.17932323089449625	0.8
5797245219	2	0.29044009422430517	0.0	0	2	0.14522004711215258	0.0
5797245220	2	0.14524587149149124	1.0	1	1	0.14524587149149124	1.0
5797245221	13	2.3452835003394035	2.0	2	11	0.26058705559326706	0.18181818181818182
5797245222	3	1.0856484900633547	0.0	0	3	0.36188283002111826	0.0
5797245223	21	2.2826565185497656	6.0	6	15	0.15217710123665104	0.4
5797245224	3	0.43632756854849175	0.0	0	3	0.14544252284949724	0.0
5797245225	3	0.45166802427033753	0.5	1	2	0.45166802427033753	0.5
5797245226	30	3.2088849871367997	9.0	9	21	0.15280404700651426	0.42857142857142855
5797245227	3	0.5196746249412934	0.5	1	2	0.5196746249412934	0.5
5797245228	4	0.2913118942949906	2.0	2	2	0.1456559471474953	1.0
5797245229	5	0.6075409813876931	2.0	2	3	0.20251366046256436	0.6666666666666666
5797245230	3	0.4370052312381254	0.0	0	3	0.14566841041270848	0.0
5797245231	5	0.5687412487087389	1.0	2	3	0.28437062435436944	0.6666666666666666
5797245232	24	2.3581419537513315	8.0	8	16	0.14738387210945822	0.5
5797245233	2	0.5310349949969053	0.0	0	2	0.26551749749845266	0.0
5797245234	1	0.14580000139391044	0.0	0	1	0.14580000139391044	0.0
5797245235	11	1.047570291216509	5.0	5	6	0.17459504853608485	0.8333333333333334
5797245236	3	0.4376013804696381	0.0	0	3	0.1458671268232127	0.0
5797245237	4	0.488164134772015	1.0	2	2	0.488164134772015	1.0
5797245238	21	2.315914447164515	6.0	6	15	0.15439429647763434	0.4
5797245239	14	2.8496895872567225	6.0	6	8	0.3562111984070903	0.75
5797245240	1	0.14595306218722662	0.0	0	1	0.14595306218722662	0.0
5797245241	8	1.5579965897678152	4.0	4	4	0.3894991474419538	1.0
5797245242	1	0.14596477911553152	0.0	0	1	0.14596477911553152	0.0
5797245243	2	0.8986312304555828	0.0	0	2	0.8986312304555828	0.0
5797245244	11	4.015086487933904	3.0	4	7	0.6691810813223174	0.5714285714285714
5797245245	4	0.5939559100741914	0.3333333333333333	1	3	0.5939559100741914	0.3333333333333333
5797245246	3	0.6594949189102705	0.5	1	2	0.6594949189102705	0.5
5797245247	3	1.1262105430334999	0.0	0	3	0.5631052715167499	0.0
5797245248	5	1.5255713374574003	0.5	1	4	0.7627856687287001	0.25
5797245249	14	1.5617316300196729	4.0	4	10	0.1561731630019673	0.4
5797245250	11	1.0491284069957199	5.0	5	6	0.17485473449928665	0.8333333333333334
5797245251	2	0.2922413362658426	0.0	0	2	0.1461206681329213	0.0
5797245252	31	3.2005396049516412	10.0	10	21	0.15240664785484007	0.47619047619047616
5797245253	2	0.14627837529435836	1.0	1	1	0.14627837529435836	1.0
5797245254	2	0.3993945647661124	0.0	0	2	0.1996972823830562	0.0
5797245255	4	2.652175508677143	0.0	0	4	0.6630438771692857	0.0
5797245256	1	0.14631073152453364	0.0	0	1	0.14631073152453364	0.0
5797245257	10	1.0762853512437132	3.5	4	6	0.21525707024874263	0.6666666666666666
5797245258	4	0.6334957957270719	1.0	1	3	0.21116526524235732	0.3333333333333333
5797245259	3	0.2928240177636714	1.0	1	2	0.1464120088818357	0.5
5797245260	30	3.2279848260391355	9.0	9	21	0.15371356314472073	0.42857142857142855
5797245261	1	0.14651170378042988	0.0	0	1	0.14651170378042988	0.0
5797245262	2	0.14652291566872164	1.0	1	1	0.14652291566872164	1.0
5797245263	1	0.14653924529581322	0.0	0	1	0.14653924529581322	0.0
5797245264	2	0.14655045718410498	1.0	1	1	0.14655045718410498	1.0
5797245265	2	0.3783331167833988	0.0	0	2	0.1891665583916994	0.0
5797245266	1	0.1465740593873858	0.0	0	1	0.1465740593873858	0.0
5797245267	11	0.9105521275871138	4.0	5	6	0.18211042551742276	0.8333333333333334
5797245268	2	0.2932755908740886	0.0	0	2	0.1466377954370443	0.0
5797245269	4	0.2933481146199758	2.0	2	2	0.1466740573099879	1.0
5797245270	24	2.373353321245818	8.0	8	16	0.14833458257786364	0.5
5797245271	5	0.44064023989804657	2.0	2	3	0.14688007996601551	0.6666666666666666
5797245272	9	0.7341206413321312	4.0	4	5	0.14682412826642624	0.8
5797245273	1	0.146812000572244	0.0	0	1	0.146812000572244	0.0
5797245274	3	0.3188862036098442	1.0	1	2	0.1594431018049221	0.5
5797245275	31	3.213498392979513	10.0	10	21	0.15302373299902441	0.47619047619047616
5797245276	8	6.764870776926957	0.0	0	8	0.8456088471158696	0.0
5797245277	2	0.14692267167379047	1.0	1	1	0.14692267167379047	1.0
5797245278	1	0.1469299105806455	0.0	0	1	0.1469299105806455	0.0
5797245279	2	0.1469309879993402	1.0	1	1	0.1469309879993402	1.0
5797245280	2	0.5140590850351695	0.0	0	2	0.25702954251758475	0.0
5797245281	4	0.2940306593630698	2.0	2	2	0.1470153296815349	1.0
5797245282	9	0.9096905629940281	4.0	4	5	0.1819381125988056	0.8
5797245283	3	0.3188833417164364	1.0	1	2	0.1594416708582182	0.5
5797245284	32	3.3882344599103793	10.0	10	22	0.1540106572686536	0.45454545454545453
5797245285	15	2.0212071015225037	5.5	6	9	0.25265088769031296	0.6666666666666666
5797245286	11	1.6104148947478094	4.5	5	6	0.3220829789495619	0.8333333333333334
5797245287	6	3.8914065657289205	0.0	0	6	0.7782813131457841	0.0
5797245288	10	1.9490555364556905	5.0	5	5	0.3898111072911381	1.0
5797245289	9	4.540970579836776	1.0	1	8	0.567621322479597	0.125
5797245290	1	0.1471919590087977	0.0	0	1	0.1471919590087977	0.0
5797245291	4	0.6703175223598891	1.0	1	3	0.33515876117994453	0.3333333333333333
5797245292	3	0.3694299010690586	1.0	1	2	0.1847149505345293	0.5
5797245293	4	0.29452021148247526	2.0	2	2	0.14726010574123763	1.0
5797245294	8	4.722986933234417	1.0	1	7	0.6747124190334882	0.14285714285714285
5797245295	26	2.5557055262521984	9.0	9	17	0.15033561919130578	0.5294117647058824
5797245296	5	1.8509315479877069	1.0	1	4	0.4627328869969267	0.25
5797245297	7	2.816217117644391	2.0	2	5	0.5632434235288782	0.4
5797245298	1	0.14741067500382232	0.0	0	1	0.14741067500382232	0.0
5797245299	3	0.29482353851436827	1.0	1	2	0.14741176925718413	0.5
5797245300	2	0.147410944358496	1.0	1	1	0.147410944358496	1.0
5797245301	2	0.4922688643134922	0.0	0	2	0.4922688643134922	0.0
5797245302	4	0.29493363723723315	2.0	2	2	0.14746681861861657	1.0
5797245303	15	3.046972256502281	4.5	5	10	0.3808715320627851	0.5
5797245304	3	0.2950256555276276	1.0	1	2	0.1475128277638138	0.5
5797245305	12	1.6264651673734591	2.0	2	10	0.16264651673734593	0.2
5797245306	12	1.6199972546024886	6.0	6	6	0.2699995424337481	1.0
5797245307	13	2.622793122445908	5.0	5	8	0.3278491403057385	0.625
5797245308	16	3.042796215310948	8.0	8	8	0.3803495269138685	1.0
5797245309	3	0.27414575259497137	0.5	1	2	0.27414575259497137	0.5
5797245310	9	2.239627715478099	4.0	4	5	0.4479255430956198	0.8
5797245311	2	0.14763875107375715	1.0	1	1	0.14763875107375715	1.0
5797245312	1	0.1476392897831045	0.0	0	1	0.1476392897831045	0.0
5797245313	1	0.14765376759681456	0.0	0	1	0.14765376759681456	0.0
5797245314	2	0.14765403695148824	1.0	1	1	0.14765403695148824	1.0
5797245315	18	1.7970885587999739	6.0	6	12	0.14975737989999782	0.5
5797245316	18	1.8979494264378414	8.0	8	10	0.18979494264378413	0.8
5797245317	3	0.44320271191672544	0.0	0	3	0.14773423730557514	0.0
5797245318	32	3.405163838852236	10.0	10	22	0.15478017449328346	0.45454545454545453
5797245319	13	3.216584658830488	5.0	5	8	0.402073082353811	0.625
5797245320	5	3.2720371768707706	0.0	0	5	0.6544074353741541	0.0
5797245321	8	2.5556058650229385	3.0	3	5	0.5111211730045877	0.6
5797245322	8	2.425934956166062	3.0	3	5	0.4851869912332124	0.6
5797245323	3	0.18581486034448375	0.5	1	2	0.18581486034448375	0.5
5797245324	3	1.0490701590475378	0.0	0	3	0.34969005301584594	0.0
5797245325	3	1.3182095510002367	0.0	0	3	0.4394031836667456	0.0
5797245326	11	1.4089826484076071	4.0	4	7	0.20128323548680102	0.5714285714285714
5797245327	3	0.4440119206951156	0.0	0	3	0.14800397356503853	0.0
5797245328	29	2.8957915251390225	10.0	10	19	0.15241008027047487	0.5263157894736842
5797245329	12	2.148316548440728	5.0	5	7	0.3069023640629611	0.7142857142857143
5797245330	11	2.0645196360735536	3.5	4	7	0.34408660601225893	0.5714285714285714
5797245331	6	1.241345592248134	2.0	2	4	0.3103363980620335	0.5
5797245332	6	2.8866313787353306	1.0	1	5	0.5773262757470661	0.2
5797245333	5	2.5999796906576047	1.0	1	4	0.6499949226644012	0.25
5797245334	4	0.4221061131490972	0.5	1	3	0.2110530565745486	0.3333333333333333
5797245335	3	0.37200671622411075	0.5	1	2	0.37200671622411075	0.5
5797245336	2	0.7801265542732665	0.0	0	2	0.39006327713663325	0.0
5797245337	2	0.6032513061934033	0.0	0	2	0.6032513061934033	0.0
5797245338	4	1.206572274239286	1.0	1	3	0.603286137119643	0.3333333333333333
5797245339	1	0.14817877352514258	0.0	0	1	0.14817877352514258	0.0
5797245340	11	1.0633945752709448	5.0	5	6	0.17723242921182414	0.8333333333333334
5797245341	2	0.29650804897420147	0.0	0	2	0.14825402448710073	0.0
5797245342	5	1.1986882629408002	2.0	2	3	0.39956275431360005	0.6666666666666666
5797245343	20	2.3307497618652167	5.0	5	15	0.1553833174576811	0.3333333333333333
5797245344	9	0.943488278374823	3.0	3	6	0.15724804639580384	0.5
5797245345	20	3.2073318544190514	9.0	9	11	0.2915756231290047	0.8181818181818182
5797245346	3	0.4452475515912683	0.0	0	3	0.14841585053042275	0.0
5797245347	27	2.929400860594916	8.0	8	19	0.1541789926628903	0.42105263157894735
5797245348	3	0.25180561063765106	0.5	1	2	0.25180561063765106	0.5
5797245349	5	1.3053124451926368	0.5	1	4	0.6526562225963184	0.25
5797245350	2	0.7528045966183127	0.0	0	2	0.7528045966183127	0.0
5797245351	2	0.9085531455457643	0.0	0	2	0.45427657277288214	0.0
5797245352	13	2.4530389048820096	6.0	6	7	0.35043412926885853	0.8571428571428571
5797245353	3	0.4460064583843494	0.0	0	3	0.1486688194614498	0.0
5797245354	4	0.2973783339248474	2.0	2	2	0.1486891669624237	1.0
5797245355	27	2.7571424526298562	9.0	9	18	0.15317458070165868	0.5
5797245356	12	1.9926589067156417	5.0	5	7	0.28466555810223454	0.7142857142857143
5797245357	3	0.44641840268840205	0.0	0	3	0.14880613422946734	0.0
5797245358	2	0.14882498905662464	1.0	1	1	0.14882498905662464	1.0
5797245359	2	0.14883290135016386	1.0	1	1	0.14883290135016386	1.0
5797245360	24	2.8649079243033904	6.0	6	18	0.15916155135018836	0.3333333333333333
5797245361	8	0.7709779901205418	3.0	3	5	0.15419559802410837	0.6
5797245362	11	0.7821512596859519	4.0	5	6	0.15643025193719037	0.8333333333333334
5797245363	3	0.44704084766993224	0.0	0	3	0.1490136158899774	0.0
5797245364	6	1.6355925535149658	2.0	2	4	0.40889813837874145	0.5
5797245365	64	15.599937031611166	5.0	8	56	0.5032237752132634	0.14285714285714285
5797245366	9	0.7473383128707394	4.0	4	5	0.14946766257414787	0.8
5797245367	30	5.363633489499561	4.0	4	26	0.2332014560651983	0.15384615384615385
5797245368	4	2.321630927734599	0.0	0	4	0.7738769759115329	0.0
5797245369	3	0.8476715147028764	0.0	0	3	0.4238357573514382	0.0
6151025022	3	1.4928485829099105	1.0	1	2	0.7464242914549553	0.5
6151025023	8	5.2596459528096675	1.0	1	7	0.751377993258524	0.14285714285714285
6151025024	14	9.840499104782909	1.0	1	13	0.7569614695986853	0.07692307692307693
6151025025	5	3.9100215998879757	0.0	0	5	0.7820043199775951	0.0
6151025026	3	2.239866330049642	0.0	0	3	0.7466221100165473	0.0
6151025027	23	15.917757331438603	2.0	2	21	0.7579884443542192	0.09523809523809523
6151025028	5	3.9109465638373777	0.0	0	5	0.7821893127674755	0.0
6151025029	3	2.2403954773060777	0.0	0	3	0.7467984924353592	0.0
6151025030	3	2.597536980460709	0.0	0	3	0.8658456601535697	0.0
6151025031	26	14.327538077744313	7.0	7	19	0.754080951460227	0.3684210526315789
6151025032	1	0.7469554588714437	0.0	0	1	0.7469554588714437	0.0
6151025033	1	0.7469717211598668	0.0	0	1	0.7469717211598668	0.0
6151025034	1	0.746976266519985	0.0	0	1	0.746976266519985	0.0
6151025035	1	0.7469823943388112	0.0	0	1	0.7469823943388112	0.0
6151025036	1	0.746993606227103	0.0	0	1	0.746993606227103	0.0
6151025037	8	4.67540930210305	0.5	1	7	0.7792348836838418	0.14285714285714285
6151025038	3	2.2412096354765962	0.0	0	3	0.7470698784921987	0.0
6151025039	12	8.285645480024877	1.0	1	11	0.7532404981840798	0.09090909090909091
6151025040	9	6.825358543898263	0.0	0	9	0.7583731715442514	0.0
6151025041	6	4.663701094155721	0.0	0	6	0.7772835156926202	0.0
6151025042	3	2.2417322508821957	0.0	0	3	0.7472440836273986	0.0
6151025043	2	1.494545988724746	0.0	0	2	0.747272994362373	0.0
6151025044	21	14.300568368663857	2.0	2	19	0.7526614930875715	0.10526315789473684
6151025045	5	3.91731387263773	0.0	0	5	0.783462774527546	0.0
6151025046	3	2.242250085242337	0.0	0	3	0.747416695080779	0.0
6151025047	3	1.4952624721567231	1.0	1	2	0.7476312360783616	0.5
6151025048	3	2.6558521999728155	0.0	0	3	0.8852840666576052	0.0
6151025049	2	1.4953298781638105	0.0	0	2	0.7476649390819052	0.0
6151025050	4	1.4953383628360313	2.0	2	2	0.7476691814180156	1.0
6151025051	25	17.296086576248562	2.0	2	23	0.7520037641847201	0.08695652173913043
6151025052	7	2.991260282572581	3.0	3	4	0.7478150706431452	0.75
6151025053	3	2.243486928234521	0.0	0	3	0.7478289760781737	0.0
6151025054	1	0.7478848671729614	0.0	0	1	0.7478848671729614	0.0
6151025055	2	1.4957986226346747	0.0	0	2	0.7478993113173373	0.0
6151025056	8	5.997699037700127	0.0	0	8	0.7497123797125159	0.0
6151025057	4	2.9921978051836433	0.0	0	4	0.7480494512959108	0.0
6151025058	2	1.496084037580768	0.0	0	2	0.748042018790384	0.0
6151025059	21	15.73116992822068	0.0	0	21	0.7491033299152705	0.0
6151025060	10	8.015485806237628	0.0	0	10	0.8015485806237628	0.0
6151025061	18	13.500768250033323	0.0	0	18	0.7500426805574069	0.0
6151025062	2	1.5013167571569304	0.0	0	2	0.7506583785784652	0.0
6151025063	5	3.003228451449342	1.0	1	4	0.7508071128623355	0.25
6151025064	1	0.751772160154114	0.0	0	1	0.751772160154114	0.0
6151025065	1	0.7517800051089848	0.0	0	1	0.7517800051089848	0.0
6151025066	4	3.0431822342276593	0.0	0	4	0.7607955585569148	0.0
6151025067	1	0.7520737027112938	0.0	0	1	0.7520737027112938	0.0
6151025068	1	0.7520742750899754	0.0	0	1	0.7520742750899754	0.0
6151025069	1	0.7520849145995856	0.0	0	1	0.7520849145995856	0.0
6151025070	1	0.7522364266035282	0.0	0	1	0.7522364266035282	0.0
6151025071	1	0.7522366959582019	0.0	0	1	0.7522366959582019	0.0
6151025072	1	0.7524031908158676	0.0	0	1	0.7524031908158676	0.0
6151025073	1	0.7524144027041593	0.0	0	1	0.7524144027041593	0.0
6151025074	5	4.498256618709301	0.0	0	5	0.8996513237418602	0.0
6151025075	1	0.7526084390772084	0.0	0	1	0.7526084390772084	0.0
6151025076	1	0.7526105939145978	0.0	0	1	0.7526105939145978	0.0
6151025077	2	1.60249973931518	0.0	0	2	0.80124986965759	0.0
6151025078	1	0.7528335185763986	0.0	0	1	0.7528335185763986	0.0
6151025079	5	3.9397452248214235	0.0	0	5	0.7879490449642848	0.0
6151025080	3	0.7771711274550289	0.5	1	2	0.7771711274550289	0.5
6151025081	1	0.7531235798906131	0.0	0	1	0.7531235798906131	0.0
6151025082	1	0.7531241522692946	0.0	0	1	0.7531241522692946	0.0
6151025083	1	0.7531347917789047	0.0	0	1	0.7531347917789047	0.0
6151025084	8	3.965983669632183	0.5	1	7	0.7931967339264366	0.14285714285714285
6151025085	2	1.5065126761508019	0.0	0	2	0.7532563380754009	0.0
6151025086	1	0.7534207791036799	0.0	0	1	0.7534207791036799	0.0
6151025087	1	0.7534319909919717	0.0	0	1	0.7534319909919717	0.0
6151025088	5	3.9426183637868535	0.0	0	5	0.7885236727573707	0.0
6151025089	1	0.7535749846543592	0.0	0	1	0.7535749846543592	0.0
6151025090	4	3.189853227628234	0.0	0	4	0.7974633069070585	0.0
6151025091	1	0.753778616787658	0.0	0	1	0.753778616787658	0.0
6151025092	1	0.7537926232306891	0.0	0	1	0.7537926232306891	0.0
6151025093	5	3.789780562471143	0.0	0	5	0.7579561124942286	0.0
6151025094	5	3.94457637024847	0.0	0	5	0.7889152740496941	0.0
6151025095	2	1.5078710991088164	0.0	0	2	0.7539355495544082	0.0
6151025096	1	0.7539640001418152	0.0	0	1	0.7539640001418152	0.0
6151025097	6	4.699725261599784	0.0	0	6	0.7832875435999641	0.0
6151025098	1	0.7541265220180443	0.0	0	1	0.7541265220180443	0.0
6151025099	5	3.9465457569450493	0.0	0	5	0.7893091513890098	0.0
6151025100	2	1.5089976076927964	0.0	0	2	0.7544988038463982	0.0
6151025101	1	0.7545333485832971	0.0	0	1	0.7545333485832971	0.0
6151025102	5	3.773499890591499	0.0	0	5	0.7546999781182998	0.0
6151025103	3	1.5094582715234501	1.0	1	2	0.7547291357617251	0.5
6151025104	5	3.951108221085104	0.0	0	5	0.7902216442170208	0.0
6151025105	2	1.5097511610617382	0.0	0	2	0.7548755805308691	0.0
6151025106	2	1.5101653948805172	0.0	0	2	0.7550826974402586	0.0
6151025107	3	2.4425248472110868	0.0	0	3	0.8141749490703623	0.0
6151025108	2	1.510510673902835	0.0	0	2	0.7552553369514176	0.0
6151025109	4	1.5105513801278942	2.0	2	2	0.7552756900639471	1.0
6151025110	20	15.242316245484057	0.0	0	20	0.7621158122742029	0.0
6151025111	5	3.9539237854890357	0.0	0	5	0.7907847570978072	0.0
6151025112	15	9.875849212156098	2.0	2	13	0.7596807086273921	0.15384615384615385
6151025113	1	0.7555865926960372	0.0	0	1	0.7555865926960372	0.0
6151025114	10	6.937839439497166	1.0	1	9	0.7708710488330185	0.1111111111111111
6151025115	8	4.738770982434472	0.5	1	7	0.7897951637390787	0.14285714285714285
6151025116	2	1.511357626004874	0.0	0	2	0.755678813002437	0.0
6151025117	2	1.5114246279799508	0.0	0	2	0.7557123139899754	0.0
6151025118	23	17.601803726838398	0.0	0	23	0.7652958142103651	0.0
6151025119	3	2.2675287856814554	0.0	0	3	0.7558429285604852	0.0
6151025120	3	2.267532724993558	0.0	0	3	0.7558442416645194	0.0
6151025121	4	2.267968810210239	1.0	1	3	0.755989603403413	0.3333333333333333
6151025122	5	3.9561803379370875	0.0	0	5	0.7912360675874175	0.0
6151025123	2	1.5119354591185765	0.0	0	2	0.7559677295592883	0.0
6151025124	20	15.233069400544778	0.0	0	20	0.7616534700272389	0.0
6151025125	1	0.7560317349636204	0.0	0	1	0.7560317349636204	0.0
6151025126	1	0.7560395799184912	0.0	0	1	0.7560395799184912	0.0
6151025127	1	0.7560508254761172	0.0	0	1	0.7560508254761172	0.0
6151025128	1	0.7560620373644089	0.0	0	1	0.7560620373644089	0.0
6151025129	2	1.5122627587164268	0.0	0	2	0.7561313793582134	0.0
6151025130	7	3.9731217368312586	0.5	1	6	0.7946243473662518	0.16666666666666666
6151025131	1	0.7561714627005897	0.0	0	1	0.7561714627005897	0.0
6151025132	21	16.044130261670993	0.0	0	21	0.764006202936714	0.0
6151025133	4	2.2692511741422745	1.0	1	3	0.7564170580474249	0.3333333333333333
6151025134	5	3.9588733122951623	0.0	0	5	0.7917746624590325	0.0
6151025135	2	1.5127708963083157	0.0	0	2	0.7563854481541579	0.0
6151025136	21	13.699727180751832	3.0	3	18	0.7610959544862129	0.16666666666666666
6151025137	4	3.026286928652021	0.0	0	4	0.7565717321630052	0.0
6151025138	9	6.889744714731012	0.0	0	9	0.765527190525668	0.0
6151025139	5	3.959816760709045	0.0	0	5	0.791963352141809	0.0
6151025140	2	1.5132140857545149	0.0	0	2	0.7566070428772574	0.0
6151025141	1	0.7567067377758516	0.0	0	1	0.7567067377758516	0.0
6151025142	3	2.365701392668038	0.0	0	3	0.788567130889346	0.0
6151025143	1	0.7567388246513532	0.0	0	1	0.7567388246513532	0.0
6151025144	1	0.7567405417873979	0.0	0	1	0.7567405417873979	0.0
6151025145	1	0.7567427302941215	0.0	0	1	0.7567427302941215	0.0
6151025146	1	0.7567429996487952	0.0	0	1	0.7567429996487952	0.0
6151025147	17	11.460224715196995	2.0	2	15	0.764014981013133	0.13333333333333333
6151025148	8	4.793869063393531	0.5	1	7	0.7989781772322552	0.14285714285714285
6151025149	3	2.270481922984967	0.0	0	3	0.7568273076616556	0.0
6151025150	2	1.513699732231152	0.0	0	2	0.756849866115576	0.0
6151025151	21	16.0342629582409	0.0	0	21	0.7635363313448048	0.0
6151025152	3	2.270899018697154	0.0	0	3	0.756966339565718	0.0
6151025153	2	1.5139373030533338	0.0	0	2	0.7569686515266669	0.0
6151025154	5	3.9620212940357438	0.0	0	5	0.7924042588071487	0.0
6151025155	2	1.514110767463181	0.0	0	2	0.7570553837315905	0.0
6151025156	19	14.46958637256593	0.0	0	19	0.76155717750347	0.0
6151025157	2	0.7572199931065405	1.0	1	1	0.7572199931065405	1.0
6151025158	1	0.7572217102425852	0.0	0	1	0.7572217102425852	0.0
6151025159	5	3.9630726863351016	0.0	0	5	0.7926145372670204	0.0
6151025160	2	1.5145781988300109	0.0	0	2	0.7572890994150054	0.0
6151025161	7	5.907083681123527	0.0	0	7	0.843869097303361	0.0
6151025162	18	12.254009234892326	2.0	2	16	0.7658755771807704	0.125
6151025163	1	0.7574012014632558	0.0	0	1	0.7574012014632558	0.0
6151025164	1	0.7574157129463001	0.0	0	1	0.7574157129463001	0.0
6151025165	1	0.7574274635439392	0.0	0	1	0.7574274635439392	0.0
6151025166	7	5.3556543286626	0.0	0	7	0.7650934755232285	0.0
6151025167	5	3.7876092607773097	0.0	0	5	0.757521852155462	0.0
6151025168	2	1.515027381417699	0.0	0	2	0.7575136907088496	0.0
6151025169	22	15.28970539568252	2.0	2	20	0.764485269784126	0.1
6151025170	1	0.757679007139818	0.0	0	1	0.757679007139818	0.0
6151025171	1	0.7576902190281097	0.0	0	1	0.7576902190281097	0.0
6151025172	3	2.2734054986130423	0.0	0	3	0.7578018328710141	0.0
6151025173	5	3.7888124007659507	0.0	0	5	0.7577624801531901	0.0
6151025174	1	0.757751665563042	0.0	0	1	0.757751665563042	0.0
6151025175	1	0.7577864796546145	0.0	0	1	0.7577864796546145	0.0
6151025176	13	9.121487947539945	1.0	1	12	0.7601239956283288	0.08333333333333333
6151025177	2	1.515809385374048	0.0	0	2	0.757904692687024	0.0
6151025178	9	6.171703032297275	1.0	1	8	0.7714628790371594	0.125
6151025179	2	1.5158295533052395	0.0	0	2	0.7579147766526197	0.0
6151025180	4	3.21114241498754	0.0	0	4	0.802785603746885	0.0
6151025181	2	0.7579430757280228	1.0	1	1	0.7579430757280228	1.0
6151025182	17	9.89268000728739	4.0	4	13	0.7609753851759531	0.3076923076923077
6151025183	1	0.7581845185236388	0.0	0	1	0.7581845185236388	0.0
6151025184	5	3.970509804560626	0.0	0	5	0.7941019609121251	0.0
6151025185	1	0.7582952569638537	0.0	0	1	0.7582952569638537	0.0
6151025186	5	3.82819558933742	0.0	0	5	0.7656391178674841	0.0
6151025187	1	0.7584682836723561	0.0	0	1	0.7584682836723561	0.0
6151025188	1	0.7584685530270298	0.0	0	1	0.7584685530270298	0.0
6151025189	1	0.7584796639073188	0.0	0	1	0.7584796639073188	0.0
6151025190	13	10.004798822866205	0.0	0	13	0.7695999094512465	0.0
6151025191	2	1.522933547138095	0.0	0	2	0.7614667735690475	0.0
6151025192	2	0.7585734666724264	1.0	1	1	0.7585734666724264	1.0
6151025193	23	16.94295475410494	1.0	1	22	0.7701343070047699	0.045454545454545456
6151025194	1	0.7586510071491107	0.0	0	1	0.7586510071491107	0.0
6151025195	6	4.731513725792296	0.0	0	6	0.7885856209653826	0.0
6151025196	3	1.5174644688357821	1.0	1	2	0.7587322344178911	0.5
6151025197	21	16.1171154457835	0.0	0	21	0.7674816878944524	0.0
6151025198	1	0.7589008336089449	0.0	0	1	0.7589008336089449	0.0
6151025199	1	0.7589120454972367	0.0	0	1	0.7589120454972367	0.0
6151025200	2	1.5180704158435496	0.0	0	2	0.7590352079217748	0.0
6151025201	13	9.146671969811267	1.0	1	12	0.762222664150939	0.08333333333333333
6151025202	1	0.7591606935303734	0.0	0	1	0.7591606935303734	0.0
6151025203	3	2.31764296344416	0.0	0	3	0.7725476544813867	0.0
6151025204	1	0.7591885380697647	0.0	0	1	0.7591885380697647	0.0
6151025205	1	0.7591997499580564	0.0	0	1	0.7591997499580564	0.0
6151025206	2	1.5184593303230032	0.0	0	2	0.7592296651615016	0.0
6151025207	10	6.181214787558117	2.0	2	8	0.7726518484447646	0.25
6151025208	6	4.734922409187661	0.0	0	6	0.7891537348646102	0.0
6151025209	3	2.2779326436215115	0.0	0	3	0.7593108812071705	0.0
6151025210	1	0.7593426426124413	0.0	0	1	0.7593426426124413	0.0
6151025211	25	16.127444524132276	4.0	4	21	0.7679735487682036	0.19047619047619047
6151025212	2	0.975027656832853	0.0	0	2	0.975027656832853	0.0
6151025213	1	0.7594651989889638	0.0	0	1	0.7594651989889638	0.0
6151025214	1	0.7595196086330462	0.0	0	1	0.7595196086330462	0.0
6151025215	4	3.2172690890562983	0.0	0	4	0.8043172722640746	0.0
6151025216	3	2.2786999677481448	0.0	0	3	0.7595666559160482	0.0
6151025217	21	15.340275927601098	1.0	1	20	0.767013796380055	0.05
6151025218	1	0.7597414222068182	0.0	0	1	0.7597414222068182	0.0
6151025219	1	0.7597526340951098	0.0	0	1	0.7597526340951098	0.0
6151025220	2	1.519611562278319	0.0	0	2	0.7598057811391595	0.0
6151025221	6	4.156927413326128	0.0	0	6	0.8313854826652255	0.0
6151025222	17	12.196429420978024	1.0	1	16	0.7622768388111265	0.0625
6151025223	1	0.7599703736794424	0.0	0	1	0.7599703736794424	0.0
6151025224	1	0.7599937065280495	0.0	0	1	0.7599937065280495	0.0
6151025225	5	3.9791950786746284	0.0	0	5	0.7958390157349257	0.0
6151025226	3	2.280201923077894	0.0	0	3	0.7600673076926313	0.0
6151025227	9	7.056680000957556	0.0	0	9	0.7840755556619506	0.0
6151025228	18	13.105531881711412	1.0	1	17	0.7709136401006713	0.058823529411764705
6151025229	5	3.980534242773475	0.0	0	5	0.796106848554695	0.0
6151025230	3	2.281116988243039	0.0	0	3	0.7603723294143463	0.0
6151025231	3	1.5208028169919836	1.0	1	2	0.7604014084959918	0.5
6151025232	1	0.7604230242085543	0.0	0	1	0.7604230242085543	0.0
6151025233	24	16.14983843601633	3.0	3	21	0.7690399255245872	0.14285714285714285
6151025234	1	0.7604951102530968	0.0	0	1	0.7604951102530968	0.0
6151025235	1	0.7605026521839596	0.0	0	1	0.7605026521839596	0.0
6151025236	3	2.281743742899348	0.0	0	3	0.760581247633116	0.0
6151025237	2	1.5212206197601887	0.0	0	2	0.7606103098800944	0.0
6151025238	1	0.7606150067522166	0.0	0	1	0.7606150067522166	0.0
6151025239	21	15.357912766593365	1.0	1	20	0.7678956383296682	0.05
6151025240	7	3.88002572471811	0.5	1	6	0.7760051449436219	0.16666666666666666
6151025241	3	2.2824485767416887	0.0	0	3	0.7608161922472295	0.0
6151025242	2	1.5216767045613901	0.0	0	2	0.7608383522806951	0.0
6151025243	19	13.038538121952149	2.0	2	17	0.7669728307030675	0.11764705882352941
6151025244	15	10.83411711615284	1.0	1	14	0.7738655082966314	0.07142857142857142
6151025245	4	3.2323628158970568	0.0	0	4	0.8080907039742642	0.0
6151025246	2	1.5220895579374665	0.0	0	2	0.7610447789687332	0.0
6151025247	1	0.7610702834893969	0.0	0	1	0.7610702834893969	0.0
6151025248	11	7.682829450984133	1.0	1	10	0.7682829450984132	0.1
6151025249	4	3.2331690954433707	0.0	0	4	0.8082922738608427	0.0
6151025250	2	1.5225732179233853	0.0	0	2	0.7612866089616926	0.0
6151025251	1	0.7613381903817015	0.0	0	1	0.7613381903817015	0.0
6151025252	8	6.563581759934482	0.0	0	8	0.8204477199918102	0.0
6151025253	8	6.6599360208577485	0.0	0	8	0.8324920026072186	0.0
6151025254	8	6.771199467000972	0.0	0	8	0.8463999333751215	0.0
6151025255	8	6.780590046327994	0.0	0	8	0.8475737557909993	0.0
6151025256	4	3.0460425115074212	0.0	0	4	0.7615106278768553	0.0
6151025257	2	1.523010279550758	0.0	0	2	0.761505139775379	0.0
6151025258	2	1.5232067401158704	0.0	0	2	0.7616033700579352	0.0
6151025259	3	2.286091497695149	0.0	0	3	0.7620304992317163	0.0
6151025260	1	0.7619163601887462	0.0	0	1	0.7619163601887462	0.0
6151025261	2	1.5271691493816442	0.0	0	2	0.7635845746908221	0.0
6151025262	1	0.7619518813363372	0.0	0	1	0.7619518813363372	0.0
6151025263	2	1.5239625829995385	0.0	0	2	0.7619812914997692	0.0
6151025264	22	16.038621857586328	1.0	1	21	0.7637438979803013	0.047619047619047616
6151025265	22	16.808641214423258	0.0	0	22	0.764029146110148	0.0
6151025266	18	12.22681602877139	2.0	2	16	0.7641760017982119	0.125
6151025267	23	18.69404467253997	0.0	0	23	0.8127845509799987	0.0
6151025268	1	0.7628849259259496	0.0	0	1	0.7628849259259496	0.0
6151025269	21	16.05682023373454	0.0	0	21	0.7646104873206925	0.0
6151025270	17	12.234844919214977	1.0	1	16	0.764677807450936	0.0625
6151025271	20	14.541285792143647	1.0	1	19	0.7653308311654551	0.05263157894736842
6151025272	15	12.85949493911187	0.0	0	15	0.857299662607458	0.0
6151025273	1	0.7638469261429821	0.0	0	1	0.7638469261429821	0.0
6151025274	2	1.5277173534812425	0.0	0	2	0.7638586767406212	0.0
6151025275	1	0.7638838950719441	0.0	0	1	0.7638838950719441	0.0
6151025276	2	1.5279000096193287	0.0	0	2	0.7639500048096644	0.0
6151025277	2	1.5278563404928591	0.0	0	2	0.7639281702464296	0.0
6151025278	2	1.527927382788041	0.0	0	2	0.7639636913940205	0.0
6151025279	2	1.5279574831728242	0.0	0	2	0.7639787415864121	0.0
6151025280	1	0.7640064177791324	0.0	0	1	0.7640064177791324	0.0
6151025281	1	0.7640194141421371	0.0	0	1	0.7640194141421371	0.0
6151025282	2	1.5280700060877523	0.0	0	2	0.7640350030438762	0.0
6151025283	1	0.7640595479885148	0.0	0	1	0.7640595479885148	0.0
6151025284	1	0.7640707598768066	0.0	0	1	0.7640707598768066	0.0
6151025285	1	0.7640847999891719	0.0	0	1	0.7640847999891719	0.0
6151025286	2	1.5284415471907535	0.0	0	2	0.7642207735953768	0.0
6151025287	1	0.7641109610618527	0.0	0	1	0.7641109610618527	0.0
6151025288	2	1.5282933011122295	0.0	0	2	0.7641466505561147	0.0
6151025289	2	1.528444510092164	0.0	0	2	0.764222255046082	0.0
6151025290	2	1.5284394596920325	0.0	0	2	0.7642197298460163	0.0
6151025291	2	1.6569285749181575	0.0	0	2	0.8284642874590787	0.0
6151025292	2	1.5285805005330362	0.0	0	2	0.7642902502665181	0.0
6151025293	2	1.5286437988813497	0.0	0	2	0.7643218994406749	0.0
6151025294	2	1.5289594152202293	0.0	0	2	0.7644797076101146	0.0
6151025295	2	1.5288176673232075	0.0	0	2	0.7644088336616037	0.0
6151025296	1	0.7644523344414024	0.0	0	1	0.7644523344414024	0.0
6151025297	2	1.5290663490256784	0.0	0	2	0.7645331745128392	0.0
6151025298	1	0.7644809870448146	0.0	0	1	0.7644809870448146	0.0
6151025299	1	0.7645000438879771	0.0	0	1	0.7645000438879771	0.0
6151025300	2	1.5290395482356478	0.0	0	2	0.7645197741178239	0.0
6151025301	2	1.5940353360335915	0.0	0	2	0.7970176680167957	0.0
6151025302	1	0.764619940387097	0.0	0	1	0.764619940387097	0.0
6151025303	2	1.529392739551505	0.0	0	2	0.7646963697757525	0.0
6151025304	3	2.3078747151953105	0.0	0	3	0.7692915717317702	0.0
6151025305	2	1.6577667729933019	0.0	0	2	0.8288833864966509	0.0
6151025306	2	1.529392268180826	0.0	0	2	0.764696134090413	0.0
6151025307	2	1.5295821632257671	0.0	0	2	0.7647910816128836	0.0
6151025308	1	0.7647999029784466	0.0	0	1	0.7647999029784466	0.0
6151025309	1	0.7648494305690686	0.0	0	1	0.7648494305690686	0.0
6151025310	1	0.7648692954762523	0.0	0	1	0.7648692954762523	0.0
6151025311	2	1.5298308785975725	0.0	0	2	0.7649154392987862	0.0
6151025312	2	1.5300347800855452	0.0	0	2	0.7650173900427726	0.0
6151025313	2	1.530051177051305	0.0	0	2	0.7650255885256525	0.0
6151025314	4	3.2695385419097525	0.0	0	4	0.8173846354774381	0.0
6151025315	4	3.3465084243872782	0.0	0	4	0.8366271060968196	0.0
6151025316	1	0.7650839374818375	0.0	0	1	0.7650839374818375	0.0
6151025317	1	0.7651065632744263	0.0	0	1	0.7651065632744263	0.0
6151025318	1	0.7651218828214915	0.0	0	1	0.7651218828214915	0.0
6151025319	1	0.7651346434991569	0.0	0	1	0.7651346434991569	0.0
6151025320	1	0.7651629257398929	0.0	0	1	0.7651629257398929	0.0
6151025321	1	0.7651875043538657	0.0	0	1	0.7651875043538657	0.0
6151025322	1	0.7652314091656749	0.0	0	1	0.7652314091656749	0.0
6151025323	1	0.7654514719340679	0.0	0	1	0.7654514719340679	0.0
6151025324	1	0.765516420079758	0.0	0	1	0.765516420079758	0.0
6151025325	2	1.5673099989808295	0.0	0	2	0.7836549994904147	0.0
6151025326	2	1.5975369131220405	0.0	0	2	0.7987684565610202	0.0
6151025327	1	0.765722981445133	0.0	0	1	0.765722981445133	0.0
6151025328	1	0.7658328781519926	0.0	0	1	0.7658328781519926	0.0
6151025329	1	0.7658730119983703	0.0	0	1	0.7658730119983703	0.0
6151025330	2	0.7661381580052697	1.0	1	1	0.7661381580052697	1.0
6151025331	1	0.7662907810972411	0.0	0	1	0.7662907810972411	0.0
6151025332	1	0.7663497697707762	0.0	0	1	0.7663497697707762	0.0
6151025333	1	0.7663989943373903	0.0	0	1	0.7663989943373903	0.0
6151025334	3	2.5314952211262143	0.0	0	3	0.8438317403754048	0.0
6151025335	1	0.7665152208790814	0.0	0	1	0.7665152208790814	0.0
6151025336	2	1.5370638596497843	0.0	0	2	0.7685319298248922	0.0
6151025337	1	0.7666882139182496	0.0	0	1	0.7666882139182496	0.0
6151025338	1	0.7668064942893273	0.0	0	1	0.7668064942893273	0.0
6151025339	1	0.7668603988933967	0.0	0	1	0.7668603988933967	0.0
6151025340	1	0.766924909337742	0.0	0	1	0.766924909337742	0.0
6151025341	2	1.5340402524297727	0.0	0	2	0.7670201262148864	0.0
6151025342	10	6.47561180294672	2.0	2	8	0.80945147536834	0.25
6151025343	1	0.7671716382188289	0.0	0	1	0.7671716382188289	0.0
6151025344	5	3.8381166963635813	0.0	0	5	0.7676233392727163	0.0
6151025345	4	3.489846894426469	0.0	0	4	0.8724617236066172	0.0
6151025346	2	0.7677566429007182	1.0	1	1	0.7677566429007182	1.0
6151025347	1	0.7677678547890099	0.0	0	1	0.7677678547890099	0.0
6151025348	1	0.7678018944858956	0.0	0	1	0.7678018944858956	0.0
6151025349	5	4.020966736145582	0.0	0	5	0.8041933472291165	0.0
6151025350	2	1.5357032818543803	0.0	0	2	0.7678516409271902	0.0
6151025351	15	8.448716705110874	4.0	4	11	0.7680651550100794	0.36363636363636365
6151025352	2	1.5362041805394144	0.0	0	2	0.7681020902697072	0.0
6151025353	6	4.762012082105904	0.0	0	6	0.7936686803509839	0.0
6151025354	1	0.7680691279915162	0.0	0	1	0.7680691279915162	0.0
6151025355	5	3.8405642212752684	0.0	0	5	0.7681128442550537	0.0
6151025356	1	0.7681324263398299	0.0	0	1	0.7681324263398299	0.0
6151025357	19	14.03729198622372	1.0	1	18	0.7798495547902067	0.05555555555555555
6151025358	5	4.022981037733997	0.0	0	5	0.8045962075467994	0.0
6151025359	3	2.3049947076857022	0.0	0	3	0.7683315692285674	0.0
6151025360	1	0.7683551153162912	0.0	0	1	0.7683551153162912	0.0
6151025361	21	16.446859302619874	0.0	0	21	0.7831837763152321	0.0
6151025362	6	4.79249259367238	0.0	0	6	0.7987487656120633	0.0
6151025363	3	2.305582473252997	0.0	0	3	0.7685274910843324	0.0
6151025364	1	0.7685487476573298	0.0	0	1	0.7685487476573298	0.0
6151025365	17	11.634119284457963	2.0	2	15	0.7756079522971976	0.13333333333333333
6151025366	5	4.024790730778421	0.0	0	5	0.8049581461556843	0.0
6151025367	3	2.3062278133817893	0.0	0	3	0.7687426044605964	0.0
6151025368	1	0.7687655781696388	0.0	0	1	0.7687655781696388	0.0
6151025369	17	11.737241485589342	2.0	2	15	0.7824827657059561	0.13333333333333333
6151025370	9	7.12555698758716	0.0	0	9	0.7917285541763511	0.0
6151025371	6	4.794710965095439	0.0	0	6	0.7991184941825732	0.0
6151025372	3	2.3068496523153037	0.0	0	3	0.7689498841051012	0.0
6151025373	1	0.7689782000151714	0.0	0	1	0.7689782000151714	0.0
6151025374	21	16.409215135160327	0.0	0	21	0.7813911969123966	0.0
6151025375	5	3.8458735385867575	0.0	0	5	0.7691747077173515	0.0
6151025376	3	2.307517584567351	0.0	0	3	0.769172528189117	0.0
6151025377	19	14.877001376772744	0.0	0	19	0.7830000724617234	0.0
6151025378	2	1.5386257127250924	0.0	0	2	0.7693128563625462	0.0
6151025379	1	0.7693120651331924	0.0	0	1	0.7693120651331924	0.0
6151025380	2	1.5386861491799986	0.0	0	2	0.7693430745899993	0.0
6151025381	1	0.7693392362858994	0.0	0	1	0.7693392362858994	0.0
6151025382	7	4.067080862326867	0.5	1	6	0.8134161724653733	0.16666666666666666
6151025383	4	3.272625312800741	0.0	0	4	0.8181563282001852	0.0
6151025384	2	1.538896313164134	0.0	0	2	0.769448156582067	0.0
6151025385	14	11.028896234714585	0.0	0	14	0.7877783024796132	0.0
6151025386	1	0.7695798373481602	0.0	0	1	0.7695798373481602	0.0
6151025387	1	0.7695910492364519	0.0	0	1	0.7695910492364519	0.0
6151025388	1	0.7696222607092641	0.0	0	1	0.7696222607092641	0.0
6151025389	11	8.726621773547667	0.0	0	11	0.7933292521406969	0.0
6151025390	9	7.267290878165932	0.0	0	9	0.8074767642406591	0.0
6151025391	2	1.5393838787928211	0.0	0	2	0.7696919393964106	0.0
6151025392	2	1.5497588821134591	0.0	0	2	0.7748794410567296	0.0
6151025393	19	13.959837871381593	1.0	1	18	0.7755465484100885	0.05555555555555555
6151025394	1	0.7698709760810692	0.0	0	1	0.7698709760810692	0.0
6151025395	1	0.7698712454357429	0.0	0	1	0.7698712454357429	0.0
6151025396	2	1.5399047433930413	0.0	0	2	0.7699523716965206	0.0
6151025397	1	0.7699827919399789	0.0	0	1	0.7699827919399789	0.0
6151025398	24	17.247901078957383	2.0	2	22	0.783995503588972	0.09090909090909091
6151025399	5	4.114231734647128	0.0	0	5	0.8228463469294256	0.0
6151025400	8	6.696542230082291	0.0	0	8	0.8370677787602864	0.0
6151025401	2	1.540393857811102	0.0	0	2	0.770196928905551	0.0
6151025402	8	4.830320360011376	0.5	1	7	0.8050533933352293	0.14285714285714285
6151025403	1	0.7701472329682578	0.0	0	1	0.7701472329682578	0.0
6151025404	1	0.7701841345585514	0.0	0	1	0.7701841345585514	0.0
6151025405	17	13.299449435680073	0.0	0	17	0.7823205550400043	0.0
6151025406	1	0.7702627524539305	0.0	0	1	0.7702627524539305	0.0
6151025407	5	4.041944246478112	0.0	0	5	0.8083888492956224	0.0
6151025408	1	0.7703557808243512	0.0	0	1	0.7703557808243512	0.0
6151025409	21	16.490550145810104	0.0	0	21	0.785264292657624	0.0
6151025410	1	0.7704496845974614	0.0	0	1	0.7704496845974614	0.0
6151025411	1	0.7704808960702736	0.0	0	1	0.7704808960702736	0.0
6151025412	3	2.3117541295522583	0.0	0	3	0.7705847098507528	0.0
6151025413	7	4.05853568631251	0.5	1	6	0.811707137262502	0.16666666666666666
6151025414	1	0.7706303542448293	0.0	0	1	0.7706303542448293	0.0
6151025415	19	12.383742970726836	3.0	3	16	0.7739839356704272	0.1875
6151025416	3	2.5045221451123387	0.0	0	3	0.8348407150374463	0.0
6151025417	1	0.7707464797785177	0.0	0	1	0.7707464797785177	0.0
6151025418	6	4.814924046864077	0.0	0	6	0.8024873411440128	0.0
6151025419	2	1.54165056571047	0.0	0	2	0.770825282855235	0.0
6151025420	1	0.7708545246719959	0.0	0	1	0.7708545246719959	0.0
6151025421	18	13.260247522803988	1.0	1	17	0.7800145601649405	0.058823529411764705
6151025422	1	0.770983949592697	0.0	0	1	0.770983949592697	0.0
6151025423	2	1.5419938919114036	0.0	0	2	0.7709969459557018	0.0
6151025424	1	0.7709951614809888	0.0	0	1	0.7709951614809888	0.0
6151025425	2	1.5421560434249564	0.0	0	2	0.7710780217124782	0.0
6151025426	1	0.7711087281452772	0.0	0	1	0.7711087281452772	0.0
6151025427	16	12.390308120535005	0.0	0	16	0.7743942575334378	0.0
6151025428	5	4.045977900055073	0.0	0	5	0.8091955800110145	0.0
6151025429	2	1.5424816932254304	0.0	0	2	0.7712408466127152	0.0
6151025430	2	0.7712734721975641	1.0	1	1	0.7712734721975641	1.0
6151025431	13	10.285905339946307	0.0	0	13	0.7912234876881775	0.0
6151025432	1	0.7714103043717914	0.0	0	1	0.7714103043717914	0.0
6151025433	14	9.462374266500928	2.0	2	12	0.7885311888750773	0.16666666666666666
6151025434	3	2.504103635288115	0.0	0	3	0.8347012117627051	0.0
6151025435	2	1.5429950158947876	0.0	0	2	0.7714975079473938	0.0
6151025436	2	0.7715307059109243	1.0	1	1	0.7715307059109243	1.0
6151025437	22	16.461281494589823	1.0	1	21	0.7838705473614201	0.047619047619047616
6151025438	2	1.543749781359761	0.0	0	2	0.7718748906798805	0.0
6151025439	5	4.048321891764066	0.0	0	5	0.8096643783528131	0.0
6151025440	2	1.5436477296077722	0.0	0	2	0.7718238648038861	0.0
6151025441	21	16.465477501696345	0.0	0	21	0.7840703572236355	0.0
6151025442	2	1.5438815294645227	0.0	0	2	0.7719407647322614	0.0
6151025443	2	1.5441237466548254	0.0	0	2	0.7720618733274127	0.0
6151025444	2	1.544136541001825	0.0	0	2	0.7720682705009125	0.0
6151025445	21	15.701743872862977	1.0	1	20	0.7850871936431488	0.05
6151025446	2	0.9936592899736729	0.0	0	2	0.9936592899736729	0.0
6151025447	4	1.6288604711477879	0.5	1	3	0.8144302355738939	0.3333333333333333
6151025448	3	1.544350172927384	1.0	1	2	0.772175086463692	0.5
6151025449	3	2.316775271032248	0.0	0	3	0.772258423677416	0.0
6151025450	2	1.5445726262185058	0.0	0	2	0.7722863131092529	0.0
6151025451	21	15.705631973908151	1.0	1	20	0.7852815986954076	0.05
6151025452	1	0.7724283303609484	0.0	0	1	0.7724283303609484	0.0
6151025453	1	0.7724402829745928	0.0	0	1	0.7724402829745928	0.0
6151025454	1	0.7724374884198534	0.0	0	1	0.7724374884198534	0.0
6151025455	1	0.7724514948628844	0.0	0	1	0.7724514948628844	0.0
6151025456	1	0.7724819992796783	0.0	0	1	0.7724819992796783	0.0
6151025457	1	0.772496275077383	0.0	0	1	0.772496275077383	0.0
6151025458	1	0.7725111905924379	0.0	0	1	0.7725111905924379	0.0
6151025459	2	1.545151503081569	0.0	0	2	0.7725757515407845	0.0
6151025460	4	3.279294332504944	0.0	0	4	0.819823583126236	0.0
6151025461	2	1.5452248685608114	0.0	0	2	0.7726124342804057	0.0
6151025462	19	14.011702888192524	1.0	1	18	0.778427938232918	0.05555555555555555
6151025463	5	4.053002770952537	0.0	0	5	0.8106005541905074	0.0
6151025464	3	2.3185782302098303	0.0	0	3	0.7728594100699434	0.0
6151025465	2	1.5457681569376152	0.0	0	2	0.7728840784688076	0.0
6151025466	1	0.7729905745729121	0.0	0	1	0.7729905745729121	0.0
6151025467	15	11.849316261679007	0.0	0	15	0.7899544174452672	0.0
6151025468	3	2.319309864842202	0.0	0	3	0.7731032882807339	0.0
6151025469	3	2.4966418374406163	0.0	0	3	0.8322139458135388	0.0
6151025470	21	16.493427156748965	0.0	0	21	0.7854012931785221	0.0
6151025471	2	1.5674496257097958	0.0	0	2	0.7837248128548979	0.0
6151025472	1	0.7732440036515066	0.0	0	1	0.7732440036515066	0.0
6151025473	5	4.0582161980001965	0.0	0	5	0.8116432396000393	0.0
6151025474	3	2.3200113654204557	0.0	0	3	0.7733371218068186	0.0
6151025475	3	2.3205503104531466	0.0	0	3	0.7735167701510489	0.0
6151025476	2	1.5470929105614204	0.0	0	2	0.7735464552807102	0.0
6151025477	4	3.0946871575092194	0.0	0	4	0.7736717893773049	0.0
6151025478	3	2.321052252887541	0.0	0	3	0.773684084295847	0.0
6151025479	2	1.5478046129479397	0.0	0	2	0.7739023064739698	0.0
6151025480	1	0.7737258118240439	0.0	0	1	0.7737258118240439	0.0
6151025481	4	3.095366200641556	0.0	0	4	0.773841550160389	0.0
6151025482	1	0.7738840240254942	0.0	0	1	0.7738840240254942	0.0
6151025483	5	3.869524663410191	0.0	0	5	0.7739049326820382	0.0
6151025484	8	6.192233514879505	0.0	0	8	0.7740291893599381	0.0
6151025485	24	17.8098497751747	1.0	1	23	0.7743412945728131	0.043478260869565216
6151025486	6	4.6470682747095795	0.0	0	6	0.7745113791182633	0.0
6151025487	8	6.204170573291458	0.0	0	8	0.7755213216614323	0.0
6151025488	14	10.872620491352082	0.0	0	14	0.7766157493822916	0.0
6151025489	18	13.195555264053938	1.0	1	17	0.7762091331796435	0.058823529411764705
6151025490	2	1.5544942382846794	0.0	0	2	0.7772471191423397	0.0
6151025491	1	0.7774094053332292	0.0	0	1	0.7774094053332292	0.0
6151025492	2	1.5583263472270628	0.0	0	2	0.7791631736135314	0.0
6151025493	3	2.3375111365531565	0.0	0	3	0.7791703788510521	0.0
6151025494	1	0.7791862371074648	0.0	0	1	0.7791862371074648	0.0
6151025495	1	0.7791974489957566	0.0	0	1	0.7791974489957566	0.0
6151025496	4	3.118130744556586	0.0	0	4	0.7795326861391465	0.0
6151025497	2	1.5591538721232627	0.0	0	2	0.7795769360616314	0.0
6151025498	5	3.8980141388981924	0.0	0	5	0.7796028277796385	0.0
6151025499	7	5.459024437101761	0.0	0	7	0.7798606338716801	0.0
6151025500	4	3.1191378616814593	0.0	0	4	0.7797844654203648	0.0
6151025501	2	1.5596524476242362	0.0	0	2	0.7798262238121181	0.0
6151025502	1	0.779871542735964	0.0	0	1	0.779871542735964	0.0
6151025503	1	0.7799926176617812	0.0	0	1	0.7799926176617812	0.0
6151025504	23	17.946612826258797	0.0	0	23	0.7802875141851651	0.0
6151025505	5	3.901799918836703	0.0	0	5	0.7803599837673406	0.0
6151025506	1	0.7805496767962766	0.0	0	1	0.7805496767962766	0.0
6151025507	1	0.7814189516668963	0.0	0	1	0.7814189516668963	0.0
6151025508	2	1.562869619846618	0.0	0	2	0.781434809923309	0.0
6151025509	1	0.781453462734461	0.0	0	1	0.781453462734461	0.0
6151025510	1	0.7814501294703743	0.0	0	1	0.7814501294703743	0.0
6151025511	1	0.7814618463986792	0.0	0	1	0.7814618463986792	0.0
6151025512	8	6.253836443869162	0.0	0	8	0.7817295554836452	0.0
6151025513	2	1.5646366875139328	0.0	0	2	0.7823183437569664	0.0
6151025514	8	6.266561836072294	0.0	0	8	0.7833202295090368	0.0
6151025515	1	0.7819426444911902	0.0	0	1	0.7819426444911902	0.0
6151025516	1	0.7819571896435686	0.0	0	1	0.7819571896435686	0.0
6151025517	1	0.7819771892280891	0.0	0	1	0.7819771892280891	0.0
6151025518	1	0.7823405823522117	0.0	0	1	0.7823405823522117	0.0
6151025519	1	0.7823517942405035	0.0	0	1	0.7823517942405035	0.0
6151025520	2	0.782615660812703	1.0	1	1	0.782615660812703	1.0
6151025521	1	0.7826268727009947	0.0	0	1	0.7826268727009947	0.0
6151025522	2	0.7826571077631148	1.0	1	1	0.7826571077631148	1.0
6151025523	1	0.7826573771177885	0.0	0	1	0.7826573771177885	0.0
6151025524	1	0.7826588248991595	0.0	0	1	0.7826588248991595	0.0
6151025525	2	1.6343182365538063	0.0	0	2	0.8171591182769031	0.0
6151025526	1	0.7829137690977935	0.0	0	1	0.7829137690977935	0.0
6151025527	1	0.7829216140526642	0.0	0	1	0.7829216140526642	0.0
6151025528	1	0.7832780712939398	0.0	0	1	0.7832780712939398	0.0
6151025529	1	0.7839454311673054	0.0	0	1	0.7839454311673054	0.0
6151025530	2	0.7839676529278836	1.0	1	1	0.7839676529278836	1.0
6151025531	2	1.5681838528809013	0.0	0	2	0.7840919264404507	0.0
6151025532	1	0.7842064695154313	0.0	0	1	0.7842064695154313	0.0
6151025533	1	0.784217681403723	0.0	0	1	0.784217681403723	0.0
6151025534	1	0.7842225634571834	0.0	0	1	0.7842225634571834	0.0
6712626327	6	0.9327881639630584	3.0	3	3	0.31092938798768616	1.0
6712626328	11	0.4836025460346497	2.5	4	7	0.12090063650866242	0.5714285714285714
6712626329	2	0.061777100455522524	0.0	0	2	0.030888550227761262	0.0
6712626330	8	1.5973788019285928	1.0	2	6	0.3993447004821482	0.3333333333333333
6712626331	4	0.11044753716732553	0.5	1	3	0.05522376858366276	0.3333333333333333
6712626332	1	0.030943229226517415	0.0	0	1	0.030943229226517415	0.0
6712626333	25	0.5614276296010954	9.0	9	16	0.03508922685006846	0.5625
6712626334	8	2.303038856061475	0.6666666666666666	2	6	0.5757597140153687	0.3333333333333333
6712626335	5	0.8315218502026406	1.0	1	4	0.4157609251013203	0.25
6712626336	5	2.078203021842947	0.5	1	4	0.6927343406143156	0.25
6712626337	2	0.6430215237616107	0.0	0	2	0.32151076188080535	0.0
6712626338	8	3.0623456745023176	1.0	1	7	0.5103909457503862	0.14285714285714285
6712626339	12	0.24668150833364844	2.5	4	8	0.049336301666729684	0.5
6712626340	2	0.06233001826191018	0.0	0	2	0.03116500913095509	0.0
6712626341	4	0.062420252077591526	2.0	2	2	0.031210126038795763	1.0
6712626342	24	0.628114931080388	8.0	8	16	0.03925718319252425	0.5
6712626343	2	0.8878809150665119	0.0	0	2	0.8878809150665119	0.0
6712626344	6	1.8155426872108413	2.0	2	4	0.45388567180271033	0.5
6712626345	3	0.228347343760569	0.5	1	2	0.228347343760569	0.5
6712626346	5	0.11327485216889602	0.6666666666666666	2	3	0.11327485216889602	0.6666666666666666
6712626347	3	1.6909866889297285	0.0	0	3	0.8454933444648642	0.0
6712626348	3	0.06298734467368136	1.0	1	2	0.03149367233684068	0.5
6712626349	13	0.6301834402968799	3.0	3	10	0.06301834402968799	0.3
6712626350	11	0.5489681241302159	3.0	4	7	0.10979362482604318	0.5714285714285714
6712626351	2	0.06279579983136377	0.0	0	2	0.031397899915681884	0.0
6712626352	1	0.03143456582063598	0.0	0	1	0.03143456582063598	0.0
6712626353	2	0.03144584504759615	1.0	1	1	0.03144584504759615	1.0
6712626354	14	3.2028665263081906	4.0	5	9	0.4575523609011701	0.5555555555555556
6712626355	3	0.23922391915292535	0.5	1	2	0.23922391915292535	0.5
6712626356	3	0.9546851501435138	0.0	0	3	0.9546851501435138	0.0
6712626357	16	5.20352200090658	2.0	3	13	0.5781691112118422	0.23076923076923078
6712626358	5	0.5222727191155658	0.5	1	4	0.1740909063718553	0.25
6712626359	3	0.0631552199740497	1.0	1	2	0.03157760998702485	0.5
6712626360	1	0.03157308146157368	0.0	0	1	0.03157308146157368	0.0
6712626361	1	0.0315792092803998	0.0	0	1	0.0315792092803998	0.0
6712626362	3	0.06338440713201346	1.0	1	2	0.03169220356600673	0.5
6712626363	21	1.4795857607941276	6.0	6	15	0.0986390507196085	0.4
6712626364	13	0.31888017679902075	2.0	4	9	0.06377603535980415	0.4444444444444444
6712626365	3	0.4295064981309984	1.0	1	2	0.2147532490654992	0.5
6712626366	31	0.9821376774765318	10.0	10	21	0.0467684608322158	0.47619047619047616
6712626367	2	0.031752539012910065	1.0	1	1	0.031752539012910065	1.0
6712626368	14	0.5466512025659265	3.0	5	9	0.1093302405131853	0.5555555555555556
6712626369	6	0.17498740851073902	1.0	2	4	0.08749370425536951	0.5
6712626370	31	1.3008139191182457	10.0	10	21	0.0619435199580117	0.47619047619047616
6712626371	13	1.105178454710217	5.0	5	8	0.13814730683877713	0.625
6712626372	9	0.989128946378454	3.0	3	6	0.164854824396409	0.5
6712626373	9	1.1600801424428322	4.0	4	5	0.23201602848856645	0.8
6712626374	7	0.7159440829124862	3.0	3	4	0.17898602072812156	0.75
6712626375	13	1.9805137044796073	5.0	5	8	0.2475642130599509	0.625
6712626376	6	2.303655812941529	1.0	1	5	0.4607311625883058	0.2
6712626377	3	0.09653085658119492	0.5	1	2	0.09653085658119492	0.5
6712626378	3	0.20534469031400931	0.5	1	2	0.20534469031400931	0.5
6712626379	2	0.2665409610850845	0.0	0	2	0.13327048054254226	0.0
6712626380	5	1.3335742486427133	1.0	1	4	0.6667871243213567	0.25
6712626381	2	0.03197613706139506	1.0	1	1	0.03197613706139506	1.0
6712626382	13	0.513918515564845	2.0	4	9	0.102783703112969	0.4444444444444444
6712626383	9	4.283450071087749	0.5	1	8	0.6119214387268214	0.125
6712626384	35	9.794791333796196	12.0	12	23	0.42586049277374766	0.5217391304347826
6712626385	10	5.235742274310328	2.0	2	8	0.654467784288791	0.25
6712626386	5	0.9431586219235781	1.0	1	4	0.47157931096178907	0.25
6712626387	2	0.03217933149334911	1.0	1	1	0.03217933149334911	1.0
6712626388	1	0.03218104862939379	0.0	0	1	0.03218104862939379	0.0
6712626389	2	0.03217990387203067	1.0	1	1	0.03217990387203067	1.0
6712626390	11	0.44786944998482686	3.0	3	8	0.05598368124810336	0.375
6712626391	6	1.2360748936629835	1.5	2	4	0.41202496455432785	0.5
6809724018	16	2.8858135842767174	2.0	2	14	0.20612954173405124	0.14285714285714285
6809724019	4	1.1714688284085142	0.5	1	3	0.5857344142042571	0.3333333333333333
6809724020	3	2.183240334704158	0.0	0	3	0.7277467782347192	0.0
6809724021	5	1.3217597129379501	1.0	1	4	0.33043992823448753	0.25
6809724022	1	0.19023830380358764	0.0	0	1	0.19023830380358764	0.0
6809724023	3	0.5913833035859154	1.0	1	2	0.2956916517929577	0.5
6809724024	25	3.2898324300804926	10.0	10	15	0.21932216200536617	0.6666666666666666
6809724025	9	0.951611341946196	4.0	4	5	0.1903222683892392	0.8
6809724026	3	0.5709675660946707	0.0	0	3	0.1903225220315569	0.0
6809724027	6	2.3610469775762573	1.0	1	5	0.47220939551525143	0.2
6809724028	29	3.933255730007225	9.0	9	20	0.19666278650036123	0.45
6809724029	1	0.19044638028900207	0.0	0	1	0.19044638028900207	0.0
6809724030	3	0.38089737327679085	1.0	1	2	0.19044868663839543	0.5
6809724031	10	1.1049392340906588	5.0	5	5	0.22098784681813174	1.0
6809724032	3	0.5715718296357277	0.0	0	3	0.19052394321190924	0.0
6809724033	3	0.381095921340624	1.0	1	2	0.190547960670312	0.5
6809724034	26	3.506750145964981	8.0	8	18	0.19481945255361005	0.4444444444444444
7323076674	4	2.338929524595398	1.0	1	3	0.7796431748651327	0.3333333333333333
7323076675	6	3.5191755780696408	1.0	1	5	0.7038351156139282	0.2
7323076676	7	3.576881854003235	0.5	1	6	0.715376370800647	0.16666666666666666
7323076677	2	1.3449139120577867	0.0	0	2	0.6724569560288933	0.0
7323076678	2	0.6724863998616595	1.0	1	1	0.6724863998616595	1.0
7323076679	13	6.765108516095811	3.0	3	10	0.6765108516095811	0.3
7323076680	3	1.3453589869867013	1.0	1	2	0.6726794934933507	0.5
7323076681	11	6.843889842423139	1.0	1	10	0.6843889842423139	0.1
7323076682	5	3.5609264278920536	0.0	0	5	0.7121852855784108	0.0
7323076683	2	0.6726600326181776	1.0	1	1	0.6726600326181776	1.0
7323076684	13	7.439442453333545	2.0	2	11	0.6763129503030495	0.18181818181818182
7323076685	4	1.3455549425118003	2.0	2	2	0.6727774712559002	1.0
7323076686	7	4.866061200008068	0.0	0	7	0.6951516000011526	0.0
7323076687	6	4.234521996630575	0.0	0	6	0.7057536661050959	0.0
7323076688	2	0.6728179081262857	1.0	1	1	0.6728179081262857	1.0
7323076689	28	14.367371425314161	7.0	7	21	0.6841605440625791	0.3333333333333333
7323076690	2	1.471425155915111	0.0	0	2	0.7357125779575555	0.0
7323076691	3	1.346138230057645	1.0	1	2	0.6730691150288225	0.5
7323076692	25	13.658398712727077	5.0	5	20	0.6829199356363539	0.25
7323076693	2	1.34670680410444	0.0	0	2	0.67335340205222	0.0
7323076694	1	0.6762945699074198	0.0	0	1	0.6762945699074198	0.0
7323076695	3	2.2865443502402663	0.0	0	3	0.7621814500800888	0.0
7323076696	1	0.6763084416731141	0.0	0	1	0.6763084416731141	0.0
7323076697	4	1.352972128491472	2.0	2	2	0.676486064245736	1.0
7323076698	2	0.6805828983283412	1.0	1	1	0.6805828983283412	1.0
7323076699	5	3.403159166693406	0.0	0	5	0.6806318333386812	0.0
7323076700	2	1.361233741373117	0.0	0	2	0.6806168706865585	0.0
7323076701	3	2.04250692839142	0.0	0	3	0.68083564279714	0.0
7323076702	21	12.967923595661329	2.0	2	19	0.682522294508491	0.10526315789473684
7323076703	2	1.3617279735299777	0.0	0	2	0.6808639867649888	0.0
7323076704	9	5.448506406449402	1.0	1	8	0.6810633008061753	0.125
7323076705	1	0.6809153493343253	0.0	0	1	0.6809153493343253	0.0
7323076706	4	2.7242429340777665	0.0	0	4	0.6810607335194416	0.0
7323076707	2	0.6810926183789381	1.0	1	1	0.6810926183789381	1.0
7323076708	3	2.0433274163967705	0.0	0	3	0.6811091387989235	0.0
7323076709	1	0.6811490481830731	0.0	0	1	0.6811490481830731	0.0
7323076710	15	8.86169475873178	2.0	2	13	0.6816688275947522	0.15384615384615385
7323076711	8	4.76958791798837	1.0	1	7	0.6813697025697671	0.14285714285714285
7323076712	5	3.4972144518075163	0.0	0	5	0.6994428903615033	0.0
7323076713	2	1.3628062339580351	0.0	0	2	0.6814031169790176	0.0
7323076714	6	4.090560677577843	0.0	0	6	0.6817601129296404	0.0
7323076715	8	5.452354979696214	0.0	0	8	0.6815443724620267	0.0
7323076716	5	3.408092094517767	0.0	0	5	0.6816184189035533	0.0
7323076717	4	2.7308623251833457	0.0	0	4	0.6827155812958364	0.0
7323076718	1	0.6827063895675972	0.0	0	1	0.6827063895675972	0.0
7323076719	1	0.6829796498840411	0.0	0	1	0.6829796498840411	0.0
7323076720	2	1.371312151528704	0.0	0	2	0.685656075764352	0.0
7323076721	2	0.6856915464079416	1.0	1	1	0.6856915464079416	1.0
7323076722	9	5.975908042583762	1.0	1	8	0.7469885053229702	0.125
7323076723	2	1.3714563909564572	0.0	0	2	0.6857281954782286	0.0
7323076724	1	0.6857413770225717	0.0	0	1	0.6857413770225717	0.0
7323076725	4	2.7490487150485796	0.0	0	4	0.6872621787621449	0.0
7323076726	27	14.423212790495228	6.0	6	21	0.6868196566902489	0.2857142857142857
7323076727	2	1.3729929920311084	0.0	0	2	0.6864964960155542	0.0
7323076728	1	0.6867051280449831	0.0	0	1	0.6867051280449831	0.0
7323076729	1	0.6872989204231009	0.0	0	1	0.6872989204231009	0.0
7323076730	17	11.005151643819385	1.0	1	16	0.6878219777387116	0.0625
7323076731	8	5.897600645804765	0.0	0	8	0.7372000807255956	0.0
7323076732	2	0.6893755439491375	1.0	1	1	0.6893755439491375	1.0
7323076733	1	0.6893867558374293	0.0	0	1	0.6893867558374293	0.0
7323076734	1	0.6895834857572151	0.0	0	1	0.6895834857572151	0.0
7323076735	1	0.6895837551118887	0.0	0	1	0.6895837551118887	0.0
7323076736	1	0.6902948177810582	0.0	0	1	0.6902948177810582	0.0
7323076737	1	0.69030602966935	0.0	0	1	0.69030602966935	0.0
7323076738	2	1.3807427973634352	0.0	0	2	0.6903713986817176	0.0
7773354233	3	2.4255520684974323	0.0	0	3	0.8085173561658108	0.0
7773354234	3	2.434033912494141	0.0	0	3	0.811344637498047	0.0
7773354235	2	1.6171302434558852	0.0	0	2	0.8085651217279426	0.0
7773354236	5	4.043065670992626	0.0	0	5	0.8086131341985252	0.0
7773354237	2	1.617288421988001	0.0	0	2	0.8086442109940005	0.0
7773354238	31	24.39211586075804	1.0	1	30	0.8130705286919346	0.03333333333333333
7773354239	1	0.8087836020376277	0.0	0	1	0.8087836020376277	0.0
7773354240	1	0.8087948139259195	0.0	0	1	0.8087948139259195	0.0
7773354241	1	0.8088148135104398	0.0	0	1	0.8088148135104398	0.0
8856001701	8	4.008442282529013	0.5	1	7	0.8016884565058027	0.14285714285714285
8856001702	3	0.7748973363078618	0.0	0	3	0.3874486681539309	0.0
8856001703	4	1.2862002496446454	0.5	1	3	0.6431001248223227	0.3333333333333333
8856001704	2	0.6253730688490411	0.0	0	2	0.6253730688490411	0.0
8856001705	2	0.6253846847693434	0.0	0	2	0.6253846847693434	0.0
8856001706	4	1.2508183920892957	0.0	0	4	0.6254091960446478	0.0
8856001707	3	0.2985969954765586	1.0	1	2	0.1492984977382793	0.5
8856001708	3	0.2999497283170919	1.0	1	2	0.14997486415854594	0.5
8856001709	21	3.3615025573374453	3.0	3	18	0.19773544454926148	0.16666666666666666
8856001710	31	5.203334765739042	4.0	4	27	0.20813339062956168	0.14814814814814814
8856001711	2	0.6244886764473614	0.0	0	2	0.6244886764473614	0.0
8856001712	4	1.2490279579040395	0.0	0	4	0.6245139789520198	0.0
8856001713	1	0.15067387320606843	0.0	0	1	0.15067387320606843	0.0
8856001714	2	0.6245189115094815	0.0	0	2	0.6245189115094815	0.0
8856001715	2	0.624541671979407	0.0	0	2	0.624541671979407	0.0
8856001716	4	1.249141187874986	0.0	0	4	0.624570593937493	0.0
8856001717	7	3.751064531757034	0.0	0	7	0.7502129063514068	0.0
8856001718	6	1.1450058764772462	1.0	1	5	0.28625146911931154	0.2
8856001719	6	2.143758259298115	0.0	0	6	0.5359395648245288	0.0
8856001720	2	0.624622848744186	0.0	0	2	0.624622848744186	0.0
8856001721	4	1.2493454933949688	0.0	0	4	0.6246727466974844	0.0
8856001722	6	1.6151550993031558	0.0	0	6	0.40378877482578895	0.0
8856001723	2	0.6246642283559295	0.0	0	2	0.6246642283559295	0.0
8856001724	5	2.015131672180413	0.0	0	5	0.671710557393471	0.0
8856001725	6	3.9774539700639893	0.0	0	6	0.7954907940127979	0.0
8856001726	7	2.502496698974301	0.0	0	7	0.6256241747435752	0.0
8856001727	6	2.656537404593312	0.0	0	6	0.664134351148328	0.0
8856001728	2	0.6247612970464553	0.0	0	2	0.6247612970464553	0.0
8856001729	4	1.2496211442341416	0.0	0	4	0.6248105721170708	0.0
8856001730	2	0.6247845288870598	0.0	0	2	0.6247845288870598	0.0
8856001731	6	2.831027281352438	0.0	0	6	0.7077568203381095	0.0
8856001732	1	0.15101403448958653	0.0	0	1	0.15101403448958653	0.0
8856001733	4	1.1605687181515454	0.0	0	4	0.38685623938384844	0.0
8856001734	4	1.2497829253850181	0.0	0	4	0.6248914626925091	0.0
8856001735	2	0.6248926074498722	0.0	0	2	0.6248926074498722	0.0
8856001736	3	0.9479972756121531	0.0	0	3	0.47399863780607654	0.0
8856001737	4	1.2498595567896789	0.0	0	4	0.6249297783948394	0.0
8856001738	2	0.6249509564060571	0.0	0	2	0.6249509564060571	0.0
8856001739	14	3.464867750053812	5.0	5	9	0.4331084687567265	0.5555555555555556
8856001740	2	0.6249747606253432	0.0	0	2	0.6249747606253432	0.0
8856001741	3	0.7762152213874883	0.0	0	3	0.38810761069374416	0.0
8856001742	4	1.25003497402091	0.0	0	4	0.625017487010455	0.0
8856001743	2	0.6250339849842177	0.0	0	2	0.6250339849842177	0.0
8856001744	1	0.15120850856398033	0.0	0	1	0.15120850856398033	0.0
8856001745	1	0.15121972045227208	0.0	0	1	0.15121972045227208	0.0
8856001746	5	3.4152910358730932	0.0	0	5	0.8538227589682733	0.0
8856001747	2	0.6250798426174109	0.0	0	2	0.6250798426174109	0.0
8856001748	3	1.576229241298253	0.0	0	3	0.7881146206491265	0.0
8856001749	4	2.1547638219098273	0.0	0	4	0.7182546073032757	0.0
8856001750	2	0.6251548915633638	0.0	0	2	0.6251548915633638	0.0
8856001751	5	1.5488752304371318	0.0	0	5	0.5162917434790439	0.0
8856001752	2	0.6251785947746473	0.0	0	2	0.6251785947746473	0.0
8856001753	2	0.625186439729518	0.0	0	2	0.625186439729518	0.0
8856001754	9	4.104521633338459	0.0	0	9	0.6840869388897431	0.0
8856001755	2	0.6252130721728778	0.0	0	2	0.6252130721728778	0.0
8856001756	2	0.62522468809318	0.0	0	2	0.62522468809318	0.0
8856001757	3	1.1229924280697603	0.0	0	3	0.5614962140348801	0.0
8856001758	4	2.396789736724998	0.0	0	4	0.798929912241666	0.0
8856001759	6	1.7097222593052528	1.0	1	5	0.5699074197684176	0.2
8856001760	4	1.2506170494707232	0.0	0	4	0.6253085247353616	0.0
8856001761	2	0.6253245850077794	0.0	0	2	0.6253245850077794	0.0
8856001762	4	1.6627623931179611	0.0	0	4	0.5542541310393204	0.0
8856001763	2	0.6253464700750156	0.0	0	2	0.6253464700750156	0.0
8856001764	2	0.6254450202162467	0.0	0	2	0.6254450202162467	0.0
8856001765	6	1.4729534743335466	1.0	1	5	0.49098449144451556	0.2
8856001766	2	0.6254821574918797	0.0	0	2	0.6254821574918797	0.0
8856001767	16	3.805333134998509	4.0	4	12	0.38053331349985087	0.3333333333333333
8856001768	6	2.8504613220661374	0.0	0	6	0.7126153305165344	0.0
8856001769	2	0.625528991535765	0.0	0	2	0.625528991535765	0.0
8856001770	8	1.576604890060028	1.0	2	6	0.5255349633533427	0.3333333333333333
8856001771	2	0.6255480483789276	0.0	0	2	0.6255480483789276	0.0
8856001772	2	0.6255875761772896	0.0	0	2	0.6255875761772896	0.0
8856001773	3	1.5358732446534695	0.0	0	3	0.7679366223267348	0.0
8856001774	2	0.625611279388573	0.0	0	2	0.625611279388573	0.0
8856001775	6	1.6873281117358605	0.0	0	6	0.5624427039119535	0.0
8856001776	17	3.5587879537990745	4.5	6	11	0.5083982791141535	0.5454545454545454
8856001777	2	0.6256592918591557	0.0	0	2	0.6256592918591557	0.0
8856001778	8	4.2087673464830715	0.0	0	8	0.7014612244138453	0.0
8856001779	2	0.6231299504653388	0.0	0	2	0.6231299504653388	0.0
8856001780	4	1.2514732606396695	0.0	0	4	0.6257366303198347	0.0
8856001781	2	0.6257493236588317	0.0	0	2	0.6257493236588317	0.0
8856001782	4	0.6080614082865686	0.0	0	4	0.15201535207164216	0.0
8856001783	2	0.30402678166584884	0.0	0	2	0.15201339083292442	0.0
8856001784	3	0.6920798985421751	0.5	1	2	0.6920798985421751	0.5
8856001785	9	2.4673832196819343	2.0	2	7	0.3524833170974192	0.2857142857142857
8856001786	2	0.3041628731147235	0.0	0	2	0.15208143655736175	0.0
8856001787	25	9.883577940485209	5.0	5	20	0.49417889702426043	0.25
8856001788	19	2.464263217158081	3.0	3	16	0.15401645107238007	0.1875
8856001789	3	0.4625025803336005	0.0	0	3	0.15416752677786683	0.0
8856001790	24	3.0970573439602296	4.0	4	20	0.15485286719801147	0.2
8856001791	1	0.1544526835923981	0.0	0	1	0.1544526835923981	0.0
8856001792	1	0.1548604528990088	0.0	0	1	0.1548604528990088	0.0
8856001793	3	0.6716364175195417	0.5	1	2	0.6716364175195417	0.5
8856001794	4	0.5272252088231029	0.3333333333333333	1	3	0.5272252088231029	0.3333333333333333
8856001795	2	0.9737620265599196	0.0	0	2	0.9737620265599196	0.0
8856001796	2	0.973761454181238	0.0	0	2	0.973761454181238	0.0
8856001797	1	0.15755433632910723	0.0	0	1	0.15755433632910723	0.0
8856001798	3	0.5635196063435315	0.5	1	2	0.5635196063435315	0.5
8856001799	1	0.15783355611770625	0.0	0	1	0.15783355611770625	0.0
8856001800	3	0.5026443726741434	1.0	1	2	0.2513221863370717	0.5
8856001801	2	0.3161190893778402	0.0	0	2	0.1580595446889201	0.0
8856001802	3	0.3184959086876882	1.0	1	2	0.1592479543438441	0.5
8856001803	2	0.9288614441915466	0.0	0	2	0.4644307220957733	0.0
8856001804	5	0.7966409923403275	0.0	0	5	0.1593281984680655	0.0
8856001805	4	1.7262337344709033	0.0	0	4	0.43155843361772583	0.0
8856001806	4	1.1627719720435437	0.5	1	3	0.5813859860217718	0.3333333333333333
8856001807	31	8.87554649117222	2.0	2	29	0.3060533272818007	0.06896551724137931
8856001808	10	1.2764319340571275	2.0	2	8	0.15955399175714094	0.25
8856001809	28	4.538026398576164	4.0	4	24	0.18908443327400684	0.16666666666666666
8856001810	19	2.7308428643081726	2.0	2	17	0.16063781554753956	0.11764705882352941
8856001811	4	0.3217790391357863	2.0	2	2	0.16088951956789316	1.0
8856001812	1	0.16088127058101184	0.0	0	1	0.16088127058101184	0.0
8856001813	5	0.8068520933420339	0.0	0	5	0.1613704186684068	0.0
8856001814	3	0.49418599620337855	0.0	0	3	0.16472866540112618	0.0
8856001815	3	0.3249484009035907	1.0	1	2	0.16247420045179534	0.5
8856001816	2	0.16250726373798902	1.0	1	1	0.16250726373798902	1.0
8856001817	9	0.8143319042833352	4.0	4	5	0.16286638085666705	0.8
8856001818	42	5.7288671814460965	7.0	7	35	0.16368191946988847	0.2
8856001819	3	0.4878475420224435	0.0	0	3	0.1626158473408145	0.0
8856001820	2	0.6600273657614587	0.0	0	2	0.33001368288072935	0.0
8856001821	1	0.16255786874730582	0.0	0	1	0.16255786874730582	0.0
8856001822	2	1.0531901407974118	0.0	0	2	0.5265950703987059	0.0
8856001823	3	0.327728107466589	1.0	1	2	0.1638640537332945	0.5
8856001824	2	0.3277185790450077	0.0	0	2	0.16385928952250384	0.0
8856001825	3	1.1422469775627895	0.0	0	3	0.3807489925209298	0.0
8856001826	1	0.16263955055209794	0.0	0	1	0.16263955055209794	0.0
8856001827	1	0.1626507624403897	0.0	0	1	0.1626507624403897	0.0
8856001828	2	0.32679603928766865	0.0	0	2	0.16339801964383432	0.0
8856001829	2	0.3253468101352911	0.0	0	2	0.16267340506764555	0.0
8856001830	1	0.16268729366800697	0.0	0	1	0.16268729366800697	0.0
8856001831	3	0.32545374394074034	1.0	1	2	0.16272687197037017	0.5
8856001832	25	3.119057425642033	6.0	6	19	0.16416091713905437	0.3157894736842105
8856001833	26	3.606618374291686	4.0	4	22	0.16393719883144028	0.18181818181818182
8856001834	21	2.6361128794058386	5.0	5	16	0.1647570549628649	0.3125
8856001835	28	3.457158549938542	7.0	7	21	0.16462659761612106	0.3333333333333333
8856001836	21	2.799842373644965	4.0	4	17	0.1646966102144097	0.23529411764705882
8856001837	23	2.8132821281120193	6.0	6	17	0.16548718400658938	0.35294117647058826
8856001838	15	1.8162775540992973	4.0	4	11	0.1651161412817543	0.36363636363636365
8856001839	14	1.6535723146761563	4.0	4	10	0.16535723146761563	0.4
8856001840	4	1.9941215362630345	0.0	0	4	0.4985303840657586	0.0
8856001841	1	0.16407221439204445	0.0	0	1	0.16407221439204445	0.0
8856001842	1	0.16408510974704668	0.0	0	1	0.16408510974704668	0.0
8856001843	1	0.1641144020678089	0.0	0	1	0.1641144020678089	0.0
8856001844	1	0.16414995688473408	0.0	0	1	0.16414995688473408	0.0
8856001845	1	0.16416157280503635	0.0	0	1	0.16416157280503635	0.0
8856001846	3	0.6411178596054082	0.0	0	3	0.21370595320180275	0.0
8856001847	2	0.32839452459859675	0.0	0	2	0.16419726229929837	0.0
8856001848	2	0.8676532544761613	0.0	0	2	0.43382662723808063	0.0
8856001849	5	0.8995382149805171	2.0	2	3	0.29984607166017235	0.6666666666666666
8856001850	1	0.1642348036069419	0.0	0	1	0.1642348036069419	0.0
8856001851	2	0.3285215926659032	0.0	0	2	0.1642607963329516	0.0
8856001852	4	1.8571231702021542	0.0	0	4	0.46428079255053856	0.0
8856001853	1	0.1642690453198329	0.0	0	1	0.1642690453198329	0.0
8856001854	3	0.9115258784017853	0.0	0	3	0.3038419594672618	0.0
8856001855	1	0.16430645195013963	0.0	0	1	0.16430645195013963	0.0
8856001856	2	0.3894991137726196	0.0	0	2	0.1947495568863098	0.0
8856001857	2	0.48753886156641124	0.0	0	2	0.24376943078320562	0.0
8856001858	6	1.5331151538030339	2.0	2	4	0.38327878845075847	0.5
8856001859	1	0.16438281400012666	0.0	0	1	0.16438281400012666	0.0
8856001860	4	2.2924755401546033	0.0	0	4	0.5731188850386508	0.0
8856001861	2	0.39899531380105674	0.0	0	2	0.19949765690052837	0.0
8856001862	1	0.1644540919806481	0.0	0	1	0.1644540919806481	0.0
8856001863	1	0.1644680310850108	0.0	0	1	0.1644680310850108	0.0
8856001864	1	0.1644762800718921	0.0	0	1	0.1644762800718921	0.0
8856001865	4	0.7242239109039385	0.0	0	4	0.1810559777259846	0.0
8856001866	2	0.3290163972014454	0.0	0	2	0.1645081986007227	0.0
8856001867	5	1.9175023199013006	0.0	0	5	0.3835004639802601	0.0
8856001868	1	0.1645403191455585	0.0	0	1	0.1645403191455585	0.0
8856001869	2	0.4426942039621601	0.0	0	2	0.22134710198108004	0.0
8856001870	2	0.32914925639423587	0.0	0	2	0.16457462819711793	0.0
8856001871	2	0.38902868583504513	0.0	0	2	0.19451434291752256	0.0
8856001872	2	0.3292417797246434	0.0	0	2	0.1646208898623217	0.0
8856001873	1	0.1646525053671444	0.0	0	1	0.1646525053671444	0.0
8856001874	3	1.2532207327544744	0.0	0	3	0.4177402442514915	0.0
8856001875	2	0.32936474013317635	0.0	0	2	0.16468237006658817	0.0
8856001876	9	4.774111359370076	1.0	1	8	0.5967639199212595	0.125
8856001877	5	2.984758969822075	0.0	0	5	0.596951793964415	0.0
8856001878	7	4.578248492278798	0.0	0	7	0.6540354988969711	0.0
8856001879	1	0.1647650282820724	0.0	0	1	0.1647650282820724	0.0
8856001880	2	0.7011119331292006	0.0	0	2	0.3505559665646003	0.0
8856001881	2	0.37040089099832507	0.0	0	2	0.18520044549916254	0.0
8856001882	4	1.261425074098629	0.0	0	4	0.31535626852465726	0.0
8856001883	9	5.666813588418045	0.0	0	9	0.6296459542686716	0.0
8856001884	2	0.3297463483671063	0.0	0	2	0.16487317418355316	0.0
8856001885	2	0.3298111618354595	0.0	0	2	0.16490558091772975	0.0
8856001886	2	0.3298132830035147	0.0	0	2	0.16490664150175735	0.0
8856001887	3	1.9345876215298827	0.0	0	3	0.644862540509961	0.0
8856001888	1	0.16497714508759195	0.0	0	1	0.16497714508759195	0.0
8856001889	1	0.16503990472655838	0.0	0	1	0.16503990472655838	0.0
8856001890	1	0.16505290108956322	0.0	0	1	0.16505290108956322	0.0
8856001891	1	0.1650645170098655	0.0	0	1	0.1650645170098655	0.0
8856001892	3	0.8373610218265837	1.0	1	2	0.41868051091329184	0.5
8856001893	2	0.33017603641028737	0.0	0	2	0.16508801820514368	0.0
8856001894	1	0.16510256335752216	0.0	0	1	0.16510256335752216	0.0
8856001895	10	2.2777328834616464	4.0	4	6	0.3796221472436077	0.6666666666666666
8856001896	4	1.5310671492110752	0.0	0	4	0.3827667873027688	0.0
8856001897	2	0.3304603065990178	0.0	0	2	0.1652301532995089	0.0
8856001898	2	1.0303303126665686	0.0	0	2	0.5151651563332843	0.0
8856001899	1	0.1652063659148899	0.0	0	1	0.1652063659148899	0.0
8856001900	1	0.1652205407045921	0.0	0	1	0.1652205407045921	0.0
8856001901	4	1.8608694896809719	0.0	0	4	0.46521737242024297	0.0
8856001902	5	0.8186403332967797	0.5	1	4	0.27288011109892657	0.25
8856001903	1	0.1652639404763881	0.0	0	1	0.1652639404763881	0.0
8856001904	2	0.1653448142171592	1.0	1	1	0.1653448142171592	1.0
8856001905	2	0.16541272526425965	1.0	1	1	0.16541272526425965	1.0
8856001906	2	0.16547073752710256	1.0	1	1	0.16547073752710256	1.0
8856001907	2	0.16553272277138215	1.0	1	1	0.16553272277138215	1.0
8856001908	2	0.1655778060098886	1.0	1	1	0.1655778060098886	1.0
8856001909	2	0.16563908419814982	1.0	1	1	0.16563908419814982	1.0
8856001910	3	0.9636942559139428	1.0	1	2	0.4818471279569714	0.5
8856001911	3	0.68491839748649	1.0	1	2	0.342459198743245	0.5
8856001912	4	1.9777553106051635	1.0	1	3	0.6592517702017212	0.3333333333333333
8856001913	2	0.16586170583594273	1.0	1	1	0.16586170583594273	1.0
8856001914	2	0.16590880923450177	1.0	1	1	0.16590880923450177	1.0
8856001915	8	1.9470869241537976	2.0	2	6	0.32451448735896626	0.3333333333333333
8856001916	4	0.6842718452616657	2.0	2	2	0.34213592263083287	1.0
8856001917	2	0.16601348719455897	1.0	1	1	0.16601348719455897	1.0
8856001918	4	0.33223737405859277	2.0	2	2	0.16611868702929639	1.0
8856001919	2	0.16607513574549645	1.0	1	1	0.16607513574549645	1.0
8856001920	4	0.4399160798578696	2.0	2	2	0.2199580399289348	1.0
8856001921	2	0.16617560503877749	1.0	1	1	0.16617560503877749	1.0
8856001922	3	0.5576454186120107	1.0	1	2	0.27882270930600533	0.5
8856001923	3	0.5148588327306467	1.0	1	2	0.25742941636532335	0.5
8856001924	4	0.332699553009286	2.0	2	2	0.166349776504643	1.0
8856001925	2	0.16630014790601824	1.0	1	1	0.16630014790601824	1.0
8856001926	2	0.16640920287952268	1.0	1	1	0.16640920287952268	1.0
8856001927	2	0.16641876497043814	1.0	1	1	0.16641876497043814	1.0
8856001928	2	0.16647159215581278	1.0	1	1	0.16647159215581278	1.0
8856001929	3	0.33315223720773207	1.0	1	2	0.16657611860386604	0.5
8856001930	2	0.1665738795931411	1.0	1	1	0.1665738795931411	1.0
8856001931	14	4.240511771186437	5.0	5	9	0.4711679745762708	0.5555555555555556
8856001932	2	0.16663872673082852	1.0	1	1	0.16663872673082852	1.0
8856001933	2	0.16668394464667183	1.0	1	1	0.16668394464667183	1.0
8856001934	3	0.3335977161686574	1.0	1	2	0.1667988580843287	0.5
8856001935	4	0.8213171127050997	1.0	1	3	0.27377237090169987	0.3333333333333333
8856001936	4	0.6674250908659574	0.0	0	4	0.16685627271648934	0.0
8856001937	1	0.16684316692814832	0.0	0	1	0.16684316692814832	0.0
8856001938	6	1.6738778187671994	2.0	2	4	0.41846945469179986	0.5
8856001939	1	0.16690128019899383	0.0	0	1	0.16690128019899383	0.0
8856001940	33	4.857774840165778	4.0	4	29	0.16750947724709578	0.13793103448275862
8856001941	15	2.175354101229614	2.0	2	13	0.16733493086381646	0.15384615384615385
8856001942	2	0.16703235491707125	1.0	1	1	0.16703235491707125	1.0
8856001943	2	0.33415326018311337	0.0	0	2	0.16707663009155668	0.0
8856001944	4	0.33429170848538264	2.0	2	2	0.16714585424269132	1.0
8856001945	13	1.8391156991789088	2.0	2	11	0.16719233628899172	0.18181818181818182
8856001946	5	1.0557993121826392	2.0	2	3	0.35193310406087974	0.6666666666666666
8856001947	3	0.33479950938392966	1.0	1	2	0.16739975469196483	0.5
8856001948	4	0.33504694532103496	2.0	2	2	0.16752347266051748	1.0
8856001949	20	3.033027596699422	2.0	2	18	0.16850153314996788	0.1111111111111111
8856001950	2	0.16758867332621408	1.0	1	1	0.16758867332621408	1.0
8856001951	4	0.6746844013375211	0.0	0	4	0.16867110033438026	0.0
8856001952	2	0.16836074482897107	1.0	1	1	0.16836074482897107	1.0
8856001953	1	0.16837020591188392	0.0	0	1	0.16837020591188392	0.0
8856001954	2	0.1684056933901407	1.0	1	1	0.1684056933901407	1.0
8856001955	2	0.16853117899873932	1.0	1	1	0.16853117899873932	1.0
8856001956	2	0.16864235514029893	1.0	1	1	0.16864235514029893	1.0
8856001957	4	1.2517521100655924	0.5	1	3	0.6258760550327962	0.3333333333333333
8856001958	2	0.16886780500216544	1.0	1	1	0.16886780500216544	1.0
8856001959	4	0.3390157517603085	2.0	2	2	0.16950787588015426	1.0
8856001960	2	0.17002448130959705	1.0	1	1	0.17002448130959705	1.0
8856001961	4	0.6833995738203015	0.0	0	4	0.17084989345507537	0.0
8856001962	3	0.34068346122237125	1.0	1	2	0.17034173061118563	0.5
8856001963	1	0.1702917148152175	0.0	0	1	0.1702917148152175	0.0
8856001964	2	0.17044979233933086	1.0	1	1	0.17044979233933086	1.0
8856001965	2	0.34098766365695365	0.0	0	2	0.17049383182847683	0.0
8856001966	32	4.619046466273748	5.0	5	27	0.17107579504717585	0.18518518518518517
8856001967	1	0.17071992140769332	0.0	0	1	0.17071992140769332	0.0
8856001968	3	0.34192623001737643	1.0	1	2	0.17096311500868822	0.5
8856001969	2	0.1710610927712377	1.0	1	1	0.1710610927712377	1.0
8856001970	2	0.1712487993094554	1.0	1	1	0.1712487993094554	1.0
8856001971	4	0.6872328948587162	0.0	0	4	0.17180822371467905	0.0
8856001972	6	2.0774300749375003	2.0	2	4	0.5193575187343751	0.5
8856001973	16	2.417364427143045	2.0	2	14	0.17266888765307464	0.14285714285714285
8856001974	3	0.3434804738231533	1.0	1	2	0.17174023691157664	0.5
8856001975	5	1.236469767614592	2.0	2	3	0.412156589204864	0.6666666666666666
8856001976	15	2.5290944965890776	7.0	7	8	0.3161368120736347	0.875
8856001977	3	0.3467008109629507	1.0	1	2	0.17335040548147534	0.5
8856001978	2	0.1724279330628047	1.0	1	1	0.1724279330628047	1.0
8856001979	2	0.6502582084405856	0.0	0	2	0.6502582084405856	0.0
8856001980	7	5.779547643740869	0.0	0	7	0.8256496633915527	0.0
8856001981	7	1.605223824138064	1.0	2	5	0.5350746080460214	0.4
8856001982	5	1.4335398823532857	0.5	1	4	0.47784662745109524	0.25
8856001983	1	0.17345191852411684	0.0	0	1	0.17345191852411684	0.0
8856001984	2	0.34694174871855354	0.0	0	2	0.17347087435927677	0.0
8856001985	3	0.7370139145594181	0.5	1	2	0.7370139145594181	0.5
8856001986	7	1.5506536446700754	3.0	3	4	0.38766341116751885	0.75
8856001987	7	2.273945554733762	2.0	2	5	0.4547891109467524	0.4
8856001988	2	0.3483058281247154	0.0	0	2	0.1741529140623577	0.0
8856001989	2	0.3538631874213253	0.0	0	2	0.17693159371066264	0.0
8856001990	4	0.5224823443903539	1.0	1	3	0.1741607814634513	0.3333333333333333
8856001991	3	0.5225629824457856	0.0	0	3	0.17418766081526185	0.0
8856001992	3	0.34837781316125516	1.0	1	2	0.17418890658062758	0.5
8856001993	7	1.3999050928807302	1.0	1	6	0.34997627322018254	0.16666666666666666
8856001994	10	2.1545537252643605	4.0	4	6	0.3590922875440601	0.6666666666666666
8856001995	11	2.4284644322372158	5.0	5	6	0.40474407203953594	0.8333333333333334
8856001996	3	1.918212608175783	0.0	0	3	0.9591063040878915	0.0
8856001997	3	0.23452691235336962	0.5	1	2	0.23452691235336962	0.5
8856001998	1	0.17437607440949796	0.0	0	1	0.17437607440949796	0.0
8856001999	4	1.1335008292925364	1.0	1	3	0.5667504146462682	0.3333333333333333
8856002000	9	2.2642630286098098	4.0	4	5	0.45285260572196195	0.8
8856002001	4	0.3488891830092284	2.0	2	2	0.1744445915046142	1.0
8856002002	2	0.17447566830008954	1.0	1	1	0.17447566830008954	1.0
8856002003	3	0.41955795059745726	0.5	1	2	0.41955795059745726	0.5
8856002004	4	0.34961334304940533	2.0	2	2	0.17480667152470267	1.0
8856002005	2	0.17486579487557447	1.0	1	1	0.17486579487557447	1.0
8856002006	3	0.20695088590247132	0.5	1	2	0.20695088590247132	0.5
8856002007	2	0.5638878478517804	0.0	0	2	0.2819439239258902	0.0
8856002008	23	5.8563183721065455	0.0	0	23	0.2546225379176759	0.0
8856002009	45	5.353905476105091	15.0	15	30	0.17846351587016968	0.5
8856002010	2	0.17572678708997863	1.0	1	1	0.17572678708997863	1.0
8856002011	1	0.1757270564446523	0.0	0	1	0.1757270564446523	0.0
8856002012	2	0.1757273594686602	1.0	1	1	0.1757273594686602	1.0
8856002013	5	2.6260012039480527	0.0	0	5	0.5252002407896106	0.0
8856002014	1	0.17575958102149863	0.0	0	1	0.17575958102149863	0.0
8856002015	2	0.5397534670744382	0.0	0	2	0.2698767335372191	0.0
8856002016	2	0.1758876591688314	1.0	1	1	0.1758876591688314	1.0
8856002017	12	3.337898670589907	4.0	4	8	0.4172373338237384	0.5
8856002018	5	2.409451527555808	1.0	1	4	0.602362881888952	0.25
8856002019	7	2.1205714682627637	2.0	2	5	0.4241142936525527	0.4
8856002020	5	1.650126797029166	0.5	1	4	0.5500422656763887	0.25
8856002021	2	0.1759937849102596	1.0	1	1	0.1759937849102596	1.0
8856002022	1	0.17599708450501214	0.0	0	1	0.17599708450501214	0.0
8856002023	2	0.1759976568836937	1.0	1	1	0.1759976568836937	1.0
8856002024	3	0.3520838977856925	1.0	1	2	0.17604194889284625	0.5
8856002025	9	0.880432349267357	4.0	4	5	0.1760864698534714	0.8
8856002026	2	0.17610671185719812	1.0	1	1	0.17610671185719812	1.0
8856002027	47	5.960841655242381	14.0	14	33	0.18063156531037516	0.42424242424242425
8856002028	6	0.7140256715879	2.0	2	4	0.178506417896975	0.5
8856002029	5	0.4613401802393533	1.0	2	3	0.23067009011967665	0.6666666666666666
8856002030	20	2.561797419898718	9.0	9	11	0.2328906745362471	0.8181818181818182
8856002031	5	0.38080111265028604	1.0	2	3	0.19040055632514302	0.6666666666666666
8856002032	1	0.1764363683084429	0.0	0	1	0.1764363683084429	0.0
8856002033	3	0.25153346140923605	0.5	1	2	0.25153346140923605	0.5
8856002034	1	0.17644027395121117	0.0	0	1	0.17644027395121117	0.0
8856002035	6	0.7148054196988568	2.0	2	4	0.1787013549247142	0.5
8856002036	46	5.983415563387119	13.0	13	33	0.181315623132943	0.3939393939393939
8856002037	5	0.5389889375025442	1.0	2	3	0.2694944687512721	0.6666666666666666
8856002038	10	1.0309246100846996	5.0	5	5	0.20618492201693991	1.0
8856002039	4	0.21103699630213069	1.0	2	2	0.21103699630213069	1.0
8856002040	6	3.9374041286751726	0.0	0	6	0.6562340214458621	0.0
8856002041	7	3.733977715008412	0.5	1	6	0.7467955430016824	0.16666666666666666
8856002042	5	3.895818325929054	0.0	0	5	0.7791636651858108	0.0
8856002043	2	0.49047274001075464	0.0	0	2	0.49047274001075464	0.0
8856002044	2	0.759721153267624	0.0	0	2	0.759721153267624	0.0
8856002045	11	1.209050067882428	5.0	5	6	0.20150834464707135	0.8333333333333334
8856002046	4	0.2689946138155985	1.0	2	2	0.2689946138155985	1.0
8856002047	10	2.5654143481261684	5.0	5	5	0.5130828696252336	1.0
8856002048	7	0.7003285823994835	2.5	3	4	0.23344286079982782	0.75
8856002049	4	1.0753026107168075	1.0	1	3	0.5376513053584038	0.3333333333333333
8856002050	36	4.529244594480984	11.0	11	25	0.18116978377923934	0.44
8856002051	4	0.6064553137061093	2.0	2	2	0.30322765685305464	1.0
8856002052	11	1.2104421938439864	5.0	5	6	0.20174036564066442	0.8333333333333334
8856002053	2	0.35398874036859235	0.0	0	2	0.17699437018429617	0.0
8856002054	2	0.1770248072624215	1.0	1	1	0.1770248072624215	1.0
8856002055	2	0.17710497394717423	1.0	1	1	0.17710497394717423	1.0
8856002056	4	1.104744120298915	0.0	0	4	0.36824804009963835	0.0
8856002057	8	1.3252713571573278	1.0	2	6	0.4417571190524426	0.3333333333333333
8856002058	4	0.7462056091292648	1.0	1	3	0.3731028045646324	0.3333333333333333
8856002059	6	0.5474030724681578	3.0	3	3	0.18246769082271927	1.0
8856002060	2	0.17718301946387174	1.0	1	1	0.17718301946387174	1.0
8856002061	9	0.8861283588822415	4.0	4	5	0.1772256717764483	0.8
8856002062	4	0.35450253440862867	2.0	2	2	0.17725126720431433	1.0
8856002063	45	5.4162474133113125	15.0	15	30	0.1805415804437104	0.5
8856002064	7	4.2870714099979805	0.5	1	6	0.8574142819995961	0.16666666666666666
8856002065	2	0.760929006963054	0.0	0	2	0.760929006963054	0.0
8856002066	6	1.4194352932129322	0.6666666666666666	2	4	0.7097176466064661	0.5
8856002067	2	0.7609372559499353	0.0	0	2	0.7609372559499353	0.0
8856002068	5	1.2666017005639985	0.5	1	4	0.6333008502819992	0.25
8856002069	3	0.33635304613368805	0.5	1	2	0.33635304613368805	0.5
8856002070	3	1.3513999389305615	0.0	0	3	0.6756999694652808	0.0
8856002071	3	1.2867368378239414	0.0	0	3	0.6433684189119707	0.0
8856002072	6	0.7181582793381026	2.0	2	4	0.17953956983452565	0.5
8856002073	9	1.0359430916872872	4.0	4	5	0.20718861833745744	0.8
8856002074	2	0.17751964546729787	1.0	1	1	0.17751964546729787	1.0
8856002075	17	2.427465463091221	8.0	8	9	0.26971838478791343	0.8888888888888888
8856002076	14	2.8791775605200396	6.0	6	8	0.35989719506500495	0.75
8856002077	13	2.8650423659548894	5.0	6	7	0.4775070609924816	0.8571428571428571
8856002078	8	1.059151363757864	4.0	4	4	0.264787840939466	1.0
8856002079	11	1.839331553280526	6.0	6	5	0.3678663106561052	1.2
8856002080	1	0.17760115892541894	0.0	0	1	0.17760115892541894	0.0
8856002081	2	0.17763274076090743	1.0	1	1	0.17763274076090743	1.0
8856002082	2	0.17765610727884878	1.0	1	1	0.17765610727884878	1.0
8856002083	3	1.4755371243634434	0.0	0	3	0.4918457081211478	0.0
8856002084	2	0.6722134088998892	0.0	0	2	0.3361067044499446	0.0
8856002085	3	1.1559341342976142	0.0	0	3	0.38531137809920474	0.0
8856002086	4	0.5337253094775776	1.0	1	3	0.17790843649252586	0.3333333333333333
8856002087	3	1.1515578952450718	1.0	1	2	0.5757789476225359	0.5
8856002088	9	0.8887967209570091	4.0	4	5	0.17775934419140182	0.8
8856002089	7	2.623116314384984	2.0	2	5	0.5246232628769968	0.4
8856002090	49	6.396415468405926	14.0	14	35	0.18275472766874074	0.4
8856002091	8	2.2694860177483855	3.0	3	5	0.4538972035496771	0.6
8856002092	7	1.8942288976690282	3.0	3	4	0.47355722441725706	0.75
8856002093	7	2.1501577223126374	3.0	3	4	0.5375394305781593	0.75
8856002094	8	4.301988204487469	1.0	1	7	0.7169980340812449	0.14285714285714285
8856002095	3	0.3039142924202551	0.5	1	2	0.3039142924202551	0.5
8856002096	3	0.839214181981472	0.0	0	3	0.419607090990736	0.0
8856002097	2	0.6471454784929216	0.0	0	2	0.6471454784929216	0.0
8856002098	3	1.285507368415949	0.0	0	3	0.4285024561386497	0.0
8856002099	2	0.17798226211933577	1.0	1	1	0.17798226211933577	1.0
8856002100	9	1.0385916561935398	4.0	4	5	0.20771833123870795	0.8
8856002101	5	0.4463421753157519	0.6666666666666666	2	3	0.4463421753157519	0.6666666666666666
8856002102	5	0.48293006842248426	0.6666666666666666	2	3	0.48293006842248426	0.6666666666666666
8856002103	2	0.6096587151707993	0.0	0	2	0.6096587151707993	0.0
8856002104	3	0.6096637992402649	0.5	1	2	0.6096637992402649	0.5
8856002105	32	4.409632769581857	8.0	8	24	0.1837346987325774	0.3333333333333333
8856002106	6	0.6833227067303013	3.0	3	3	0.2277742355767671	1.0
8856002107	7	1.0386204771436232	3.0	3	4	0.2596551192859058	0.75
8856002108	2	0.35653757630691646	0.0	0	2	0.17826878815345823	0.0
8856002109	3	0.3566032315086249	1.0	1	2	0.17830161575431244	0.5
8856002110	3	0.5352553450320577	0.0	0	3	0.17841844834401924	0.0
8856002111	5	0.8392080541626459	0.3333333333333333	1	4	0.41960402708132294	0.25
8856002112	1	0.17843908764588964	0.0	0	1	0.17843908764588964	0.0
8856002113	2	0.1784502995341814	1.0	1	1	0.1784502995341814	1.0
8856002114	4	0.364132199677872	2.0	2	2	0.182066099838936	1.0
8856002115	2	0.17848683076179866	1.0	1	1	0.17848683076179866	1.0
8856002116	10	1.0411912654878517	5.0	5	5	0.20823825309757032	1.0
8856002117	6	0.5633527411231894	3.0	3	3	0.18778424704106314	1.0
8856002118	9	1.2758942684591368	2.0	2	7	0.1822706097798767	0.2857142857142857
8856002119	3	0.8427486203401094	0.5	1	2	0.8427486203401094	0.5
8856002120	3	0.6815418683052948	0.5	1	2	0.6815418683052948	0.5
8856002121	3	0.6548601667096681	0.5	1	2	0.6548601667096681	0.5
8856002122	2	0.996041900409005	0.0	0	2	0.996041900409005	0.0
8856002123	3	1.4528223437243746	0.0	0	3	0.7264111718621873	0.0
8856002124	23	2.765974356694341	8.0	8	15	0.18439829044628941	0.5333333333333333
8856002125	9	1.0423823855241796	4.0	4	5	0.2084764771048359	0.8
8856002126	3	0.536337376425547	0.0	0	3	0.17877912547518235	0.0
8856002127	3	0.38025021500395095	1.0	1	2	0.19012510750197548	0.5
8856002128	31	3.862780325405361	10.0	10	21	0.18394192025739814	0.47619047619047616
8856002129	10	3.6208661591104327	4.0	4	6	0.6034776931850722	0.6666666666666666
8856002130	10	1.0495602498762906	5.0	5	5	0.2099120499752581	1.0
8856002131	3	0.5368519785296042	0.0	0	3	0.17895065950986808	0.0
8856002132	3	0.35796098107995533	1.0	1	2	0.17898049053997767	0.5
8856002133	30	3.6671974861667023	10.0	10	20	0.1833598743083351	0.5
8856002134	9	0.8958118614168857	4.0	4	5	0.17916237228337714	0.8
8856002135	3	0.5374862751167762	0.0	0	3	0.17916209170559205	0.0
8856002136	4	0.8568842526066041	1.0	1	3	0.28562808420220137	0.3333333333333333
8856002137	17	2.173086437901273	5.0	5	12	0.18109053649177276	0.4166666666666667
8856002138	3	0.402556889643067	0.5	1	2	0.402556889643067	0.5
8856002139	2	0.570517676450964	0.0	0	2	0.285258838225482	0.0
8856002140	1	0.17933159435711385	0.0	0	1	0.17933159435711385	0.0
8856002141	12	1.7195578462225214	3.0	3	9	0.19106198291361348	0.3333333333333333
8856002142	24	2.7983278596535555	10.0	11	13	0.23319398830446295	0.8461538461538461
8856002143	3	0.5382069672155296	0.0	0	3	0.17940232240517653	0.0
8856002144	4	0.3588621071407372	2.0	2	2	0.1794310535703686	1.0
8856002145	29	3.4758586328358096	10.0	10	19	0.18293992804398998	0.5263157894736842
8856002146	16	3.2061283103984004	6.0	7	9	0.40076603879980005	0.7777777777777778
8856002147	2	0.5273688758721746	0.0	0	2	0.5273688758721746	0.0
8856002148	9	2.3352790617110752	2.5	3	6	0.46705581234221505	0.5
8856002149	10	3.9223465963686883	1.0	2	8	0.5603352280526698	0.25
8856002150	2	0.3590791059997171	0.0	0	2	0.17953955299985855	0.0
8856002151	2	0.4697479517008013	0.0	0	2	0.23487397585040065	0.0
8856002152	2	0.5273964173875579	0.0	0	2	0.5273964173875579	0.0
8856002153	5	0.2798752968667284	0.6666666666666666	2	3	0.2798752968667284	0.6666666666666666
8856002154	9	0.8981137327887836	4.0	4	5	0.17962274655775673	0.8
8856002155	3	0.5388657750780059	0.0	0	3	0.17962192502600197	0.0
8856002156	3	0.3803351627341614	1.0	1	2	0.1901675813670807	0.5
8856002157	31	3.880436557934133	10.0	10	21	0.18478269323495872	0.47619047619047616
8856002158	3	0.359441253358474	1.0	1	2	0.179720626679237	0.5
8856002159	2	0.35945273460143945	0.0	0	2	0.17972636730071972	0.0
8856002160	2	0.17974313462915603	1.0	1	1	0.17974313462915603	1.0
8856002161	1	0.17975434651744776	0.0	0	1	0.17975434651744776	0.0
8856002162	11	1.2337246057884925	5.0	5	6	0.20562076763141543	0.8333333333333334
8856002163	3	0.5395146504868906	0.0	0	3	0.17983821682896353	0.0
8856002164	3	0.3803349943874903	1.0	1	2	0.19016749719374515	0.5
8856002165	29	3.483717358464304	10.0	10	19	0.1833535451823318	0.5263157894736842
8856002166	4	0.5548372277922712	1.0	1	3	0.18494574259742372	0.3333333333333333
8856002167	10	1.0549045159566888	5.0	5	5	0.21098090319133775	1.0
8856002168	3	0.5401377351857707	0.0	0	3	0.18004591172859022	0.0
8856002169	4	0.8275196437838312	1.0	1	3	0.27583988126127706	0.3333333333333333
8856002170	30	3.909747497838176	9.0	9	21	0.1861784522780084	0.42857142857142855
8856002171	9	3.625824473612787	0.6666666666666666	2	7	0.7251648947225574	0.2857142857142857
8856002172	1	0.1801661898134978	0.0	0	1	0.1801661898134978	0.0
8856002173	3	0.35231567748239034	0.5	1	2	0.35231567748239034	0.5
8856002174	1	0.18019406802222324	0.0	0	1	0.18019406802222324	0.0
8856002175	9	1.0560237182951453	4.0	4	5	0.21120474365902905	0.8
8856002176	2	0.3605145307250688	0.0	0	2	0.1802572653625344	0.0
8856002177	4	0.36058489963356655	2.0	2	2	0.18029244981678327	1.0
8856002178	28	3.513036951387239	9.0	9	19	0.18489668165195994	0.47368421052631576
8856002179	2	0.5743611992976442	0.0	0	2	0.5743611992976442	0.0
8856002180	9	4.1699551561504595	2.0	2	7	0.5957078794500656	0.2857142857142857
8856002181	2	0.5743886734743592	0.0	0	2	0.5743886734743592	0.0
8856002182	10	5.757628570477173	0.5	1	9	0.7197035713096466	0.1111111111111111
8856002183	5	1.776719554344612	1.0	1	4	0.592239851448204	0.25
8856002184	4	1.1986481290944226	1.0	1	3	0.5993240645472113	0.3333333333333333
8856002185	3	0.18585331072415096	0.5	1	2	0.18585331072415096	0.5
8856002186	3	1.219131811302102	0.0	0	3	0.406377270434034	0.0
8856002187	10	1.0572739280130108	5.0	5	5	0.21145478560260217	1.0
8856002188	2	0.3610662701047591	0.0	0	2	0.18053313505237956	0.0
8856002189	3	0.361123002932902	1.0	1	2	0.180561501466451	0.5
8856002190	4	0.5622566696173349	1.0	1	3	0.18741888987244495	0.3333333333333333
8856002191	6	1.887444964527168	2.0	2	4	0.471861241131792	0.5
8856002192	5	3.0523250745935684	0.0	0	5	0.6104650149187136	0.0
8856002193	1	0.1806889062270996	0.0	0	1	0.1806889062270996	0.0
8856002194	2	0.6612761950366216	0.0	0	2	0.6612761950366216	0.0
8856002195	3	0.4122205946091962	0.5	1	2	0.4122205946091962	0.5
8856002196	3	0.36169198101170763	1.0	1	2	0.18084599050585382	0.5
8856002197	27	3.336813507948337	9.0	9	18	0.18537852821935205	0.5
8856002198	9	0.9039234774146274	4.0	4	5	0.18078469548292547	0.8
8856002199	2	0.36155245529074365	0.0	0	2	0.18077622764537182	0.0
8856002200	3	0.3616300294367622	1.0	1	2	0.1808150147183811	0.5
8856002201	30	3.923941243375516	9.0	9	21	0.1868543449226436	0.42857142857142855
8856002202	4	0.6637344941352565	0.3333333333333333	1	3	0.6637344941352565	0.3333333333333333
8856002203	2	0.9479022944203482	0.0	0	2	0.9479022944203482	0.0
8856002204	4	0.361944096986268	2.0	2	2	0.180972048493134	1.0
8856002205	13	4.150023145983803	4.0	4	9	0.4611136828870892	0.4444444444444444
8856002206	3	0.3805020616238376	1.0	1	2	0.1902510308119188	0.5
8856002207	1	0.18102024614505483	0.0	0	1	0.18102024614505483	0.0
8856002208	26	3.324502551579989	8.0	8	18	0.1846945861988883	0.4444444444444444
8856002209	15	2.115056768012597	7.0	7	8	0.26438209600157464	0.875
8856002210	1	0.18109724791239185	0.0	0	1	0.18109724791239185	0.0
8856002211	7	1.3225960928690472	2.0	2	5	0.26451921857380944	0.4
8856002212	9	2.5877624360463622	4.0	4	5	0.5175524872092725	0.8
8856002213	6	4.69443725697685	0.0	0	6	0.7824062094961417	0.0
9155616785	4	0.44250639641593975	0.3333333333333333	1	3	0.44250639641593975	0.3333333333333333
9155616786	7	2.529273651116406	0.5	1	6	0.843091217038802	0.16666666666666666
9155616787	3	1.8903336250556682	0.0	0	3	0.9451668125278341	0.0
9155616788	3	1.0155211927078822	0.0	0	3	0.5077605963539411	0.0
9155616789	3	1.0212935307034194	1.0	1	2	0.5106467653517097	0.5
9155616790	20	0.6949511856942231	5.0	10	10	0.13899023713884462	1.0
9155616791	26	3.0277324205083014	4.0	4	22	0.13762420093219552	0.18181818181818182
9155616792	1	0.07039045687165355	0.0	0	1	0.07039045687165355	0.0
9155616793	1	0.0704017024292795	0.0	0	1	0.0704017024292795	0.0
9155616794	3	0.14310180828903318	1.0	1	2	0.07155090414451659	0.5
9155616795	4	0.32469527484900396	0.0	0	4	0.08117381871225099	0.0
9155616796	4	2.288494377069675	0.0	0	4	0.5721235942674188	0.0
9155616797	2	0.9532423181646361	0.0	0	2	0.47662115908231806	0.0
9155616798	4	1.3844720464898086	0.0	0	4	0.34611801162245215	0.0
9155616799	4	1.4121216067666205	1.0	1	3	0.47070720225554014	0.3333333333333333
9155616800	5	1.9140317522696582	0.0	0	5	0.38280635045393163	0.0
9155616801	5	1.1539890231909997	0.0	0	5	0.23079780463819993	0.0
9182044753	1	0.06845356108258627	0.0	0	1	0.06845356108258627	0.0
9182044754	6	0.8012547685457174	1.0	2	4	0.4006273842728587	0.5
9182044755	2	0.5470408914400667	0.0	0	2	0.5470408914400667	0.0
9182044756	4	0.13709795995147173	2.0	2	2	0.06854897997573586	1.0
9182044757	9	0.5230145892255369	4.0	4	5	0.10460291784510738	0.8
9182044758	4	0.1371890691698425	2.0	2	2	0.06859453458492125	1.0
9182044759	29	1.4347767253454704	10.0	10	19	0.07551456449186686	0.5263157894736842
9182044760	4	0.13753444920016308	2.0	2	2	0.06876722460008154	1.0
9182044761	9	0.5242338568252639	4.0	4	5	0.10484677136505278	0.8
9182044762	5	0.6294970235803519	1.0	1	4	0.15737425589508797	0.25
9182044763	12	0.9018592105342458	2.0	2	10	0.09018592105342457	0.2
9182044764	3	0.23364837841584235	0.5	1	2	0.23364837841584235	0.5
9182044765	1	0.06890072351022203	0.0	0	1	0.06890072351022203	0.0
9182044766	2	0.06890126221956938	1.0	1	1	0.06890126221956938	1.0
9182044767	2	0.7022070282243632	0.0	0	2	0.3511035141121816	0.0
9182044768	2	0.06892132914275821	1.0	1	1	0.06892132914275821	1.0
9182044769	1	0.06893254103104995	0.0	0	1	0.06893254103104995	0.0
9182044770	4	0.13799198178273536	2.0	2	2	0.06899599089136768	1.0
9182044771	23	1.2037405822242682	8.0	8	15	0.08024937214828455	0.5333333333333333
9182044772	10	0.5254194887601157	5.0	5	5	0.10508389775202313	1.0
9182044773	4	0.1380822492677509	2.0	2	2	0.06904112463387545	1.0
9182044774	30	1.5548655773716755	10.0	10	20	0.07774327886858377	0.5
9182044775	6	3.5583903189620605	0.0	0	6	0.711678063792412	0.0
9182044776	5	2.977309158257554	0.0	0	5	0.5954618316515108	0.0
9182044777	2	0.7415235515140982	0.0	0	2	0.7415235515140982	0.0
9182044778	3	0.15297557623129512	0.5	1	2	0.15297557623129512	0.5
9182044779	4	1.1521827980879995	0.5	1	3	0.5760913990439998	0.3333333333333333
9182044780	2	0.7415490055307605	0.0	0	2	0.7415490055307605	0.0
9182044781	3	0.4516184630103812	0.5	1	2	0.4516184630103812	0.5
9182044782	1	0.06918283886156304	0.0	0	1	0.06918283886156304	0.0
9182044783	9	0.34627812614128517	4.0	4	5	0.06925562522825704	0.8
9182044784	3	0.207772417657182	0.0	0	3	0.06925747255239399	0.0
9182044785	3	0.13856021913618832	1.0	1	2	0.06928010956809416	0.5
9817168307	6	1.5170161616507831	3.0	3	3	0.5056720538835944	1.0
9817168308	4	0.8521687613425675	2.0	2	2	0.42608438067128374	1.0
9817168309	3	0.8918990134110683	1.0	1	2	0.4459495067055341	0.5
9817168310	3	0.8520739484974336	1.0	1	2	0.4260369742487168	0.5
9817168311	2	0.42604835448367956	1.0	1	1	0.42604835448367956	1.0
9817168312	2	0.4261171409334695	1.0	1	1	0.4261171409334695	1.0
9817168313	4	1.5350117473990523	1.0	1	3	0.5116705824663508	0.3333333333333333
9817168314	12	7.7451183926583065	0.0	0	12	0.7745118392658307	0.0
9817168315	32	20.783827218134896	3.0	3	29	0.7422795435048177	0.10344827586206896
9817168316	2	0.4262878444579114	1.0	1	1	0.4262878444579114	1.0
9817168317	2	1.1416859117775229	0.0	0	2	0.5708429558887614	0.0
9817168318	4	0.8527746746810008	2.0	2	2	0.4263873373405004	1.0
9817168319	34	15.337838099457665	8.0	8	26	0.589916849979141	0.3076923076923077
9817168320	11	3.2252656906083805	1.5	3	8	0.6450531381216761	0.375
9817168321	39	29.375324593425105	2.0	2	37	0.7939276917141921	0.05405405405405406
9817168322	27	13.924902267181857	1.0	2	25	0.663090584151517	0.08
9817168323	17	13.331603582511436	0.0	0	17	0.8332252239069647	0.0
9817168324	4	1.7063163031259585	0.0	0	4	0.4265790757814896	0.0
9817168325	1	0.42657248500931816	0.0	0	1	0.42657248500931816	0.0
9817168326	2	0.4266075347862302	1.0	1	1	0.4266075347862302	1.0
9817168327	2	0.8532698495792191	0.0	0	2	0.42663492478960957	0.0
9817168328	4	1.279941793801792	1.0	1	3	0.4266472646005974	0.3333333333333333
9817168329	1	0.42666009261693116	0.0	0	1	0.42666009261693116	0.0
9817168330	12	2.7139276938253505	2.0	4	8	0.5427855387650701	0.5
9817168331	8	4.948438646914306	0.0	0	8	0.7069198067020437	0.0
9817168332	3	0.9741688867945066	1.0	1	2	0.4870844433972533	0.5
9817168333	1	0.42689759610044464	0.0	0	1	0.42689759610044464	0.0
9817168334	2	0.4269082356100548	1.0	1	1	0.4269082356100548	1.0
9817168335	25	8.868358492350513	7.0	7	18	0.5216681466088537	0.3888888888888889
9817168336	3	0.854316124139778	1.0	1	2	0.427158062069889	0.5
9817168337	2	0.42716355017136515	1.0	1	1	0.42716355017136515	1.0
9817168338	8	2.1360644797379122	3.0	3	5	0.42721289594758244	0.6
9817168339	4	2.6504324809144535	0.0	0	4	0.6626081202286134	0.0
9817168340	3	0.8545004300752406	1.0	1	2	0.4272502150376203	0.5
9817168341	17	12.988602425330088	0.0	0	17	0.8659068283553392	0.0
9817168342	46	21.208355031816343	10.0	10	36	0.5891209731060095	0.2777777777777778
9817168343	5	1.1856580959244045	0.5	1	4	0.5928290479622023	0.25
9817168344	1	0.4274089322790836	0.0	0	1	0.4274089322790836	0.0
9817168345	2	0.7137475292179957	0.0	0	2	0.7137475292179957	0.0
9817168346	1	0.42742135626340694	0.0	0	1	0.42742135626340694	0.0
9817168347	4	2.4821153715426183	0.0	0	4	0.6205288428856546	0.0
9817168348	32	25.182142041022246	0.0	0	32	0.8123271626136208	0.0
9817168349	30	23.497835044975663	0.0	0	30	0.8392083944634166	0.0
9817168350	32	16.440420547492327	2.0	4	28	0.782877168928206	0.14285714285714285
9817168351	1	0.42769242807312724	0.0	0	1	0.42769242807312724	0.0
9817168352	6	2.989638834775722	0.0	0	6	0.5979277669551444	0.0
9817168353	9	2.1755098892390015	4.0	4	5	0.4351019778478003	0.8
9817168354	8	2.1394747455919854	3.0	3	5	0.4278949491183971	0.6
9817168355	2	0.42791430898556754	1.0	1	1	0.42791430898556754	1.0
9817168356	44	13.02572020641861	14.0	14	30	0.434190673547287	0.4666666666666667
9817168357	3	0.578877704796503	0.5	1	2	0.578877704796503	0.5
9817168358	1	0.42801299380413543	0.0	0	1	0.42801299380413543	0.0
9817168359	6	1.7216336280152027	2.0	2	4	0.4304084070038007	0.5
9817168360	2	0.42805282462650524	1.0	1	1	0.42805282462650524	1.0
9817168361	7	2.1405125691496574	2.0	2	5	0.4281025138299315	0.4
9817168362	8	1.9607550577147943	4.0	4	4	0.4901887644286986	1.0
9817168363	1	0.4281943368381876	0.0	0	1	0.4281943368381876	0.0
9817168364	6	1.7224750246770968	2.0	2	4	0.4306187561692742	0.5
9817168365	9	5.660238034785608	1.0	1	8	0.707529754348201	0.125
9817168366	14	5.9691586541788	3.0	3	11	0.5426507867435273	0.2727272727272727
9817168367	54	16.500710540794493	16.0	16	38	0.43422922475774983	0.42105263157894735
9817168368	3	1.2288682756994578	0.0	0	3	0.6144341378497289	0.0
9817168369	1	0.4284253084708644	0.0	0	1	0.4284253084708644	0.0
9817168370	5	1.3711325256306965	0.5	1	4	0.6855662628153483	0.25
9817168371	4	0.8570203777248129	2.0	2	2	0.42851018886240644	1.0
9817168372	5	1.8394817521804345	2.0	2	3	0.6131605840601448	0.6666666666666666
9817168373	33	10.48200342100637	9.0	9	24	0.43675014254193206	0.375
9817168374	4	0.857403938780127	2.0	2	2	0.4287019693900635	1.0
9817168375	2	0.42871749095313405	1.0	1	1	0.42871749095313405	1.0
9817168376	9	2.0731069997636746	3.5	4	5	0.5182767499409187	0.8
9817168377	2	0.857496058078524	0.0	0	2	0.428748029039262	0.0
9817168378	6	1.483055251007075	3.0	3	3	0.4943517503356916	1.0
9817168379	6	1.724896893556117	2.0	2	4	0.43122422338902927	0.5
9817168380	4	0.8578865213473511	2.0	2	2	0.42894326067367555	1.0
9817168381	16	5.771750701340649	5.0	5	11	0.5247046092127863	0.45454545454545453
9817168382	45	12.549374209970118	16.0	16	29	0.4327370417231075	0.5517241379310345
9817168383	4	0.8584383617350441	2.0	2	2	0.42921918086752203	1.0
9817168384	10	2.3333646570372597	5.0	5	5	0.4666729314074519	1.0
9817168385	4	0.858587685232263	2.0	2	2	0.4292938426161315	1.0
9817168386	2	0.8383764552770065	0.0	0	2	0.8383764552770065	0.0
9817168387	10	6.000048887873271	1.0	1	9	0.6666720986525857	0.1111111111111111
9817168388	3	1.6768179260383715	0.0	0	3	0.8384089630191858	0.0
9817168389	1	0.4294519201402449	0.0	0	1	0.4294519201402449	0.0
9817168390	1	0.42946313202853664	0.0	0	1	0.42946313202853664	0.0
9817168391	11	2.7643378923744244	5.0	5	6	0.4607229820624041	0.8333333333333334
9817168392	2	0.8590810419864341	0.0	0	2	0.42954052099321705	0.0
9817168393	3	0.8591463268254662	1.0	1	2	0.4295731634127331	0.5
9817168394	47	14.845431695913929	13.0	13	34	0.4366303439974685	0.38235294117647056
9817168395	2	0.4297329580728912	1.0	1	1	0.4297329580728912	1.0
9817168396	7	2.335733799738908	2.0	2	5	0.46714675994778154	0.4
9817168397	2	0.42980123948266796	1.0	1	1	0.42980123948266796	1.0
9817168398	5	1.2023647522204675	0.5	1	4	0.6011823761102337	0.25
9817168399	2	0.758137785487756	0.0	0	2	0.758137785487756	0.0
9817168400	4	1.7024163841444775	0.0	0	4	0.8512081920722387	0.0
9817168401	5	0.8763892009381489	1.0	2	3	0.43819460046907444	0.6666666666666666
9817168402	6	1.7283585388141938	2.0	2	4	0.43208963470354844	0.5
9817168403	36	11.401481491108418	10.0	10	26	0.43851851888878535	0.38461538461538464
9817168404	5	1.7080703744302685	2.0	2	3	0.5693567914767562	0.6666666666666666
9817168405	4	0.8601051621250831	2.0	2	2	0.4300525810625416	1.0
9817168406	2	0.43018150094322954	1.0	1	1	0.43018150094322954	1.0
9817168407	1	0.4301960124262738	0.0	0	1	0.4301960124262738	0.0
9817168408	2	0.4301965848049554	1.0	1	1	0.4301965848049554	1.0
9817168409	6	1.729078759542268	2.0	2	4	0.432269689885567	0.5
9817168410	4	0.8604816526202133	2.0	2	2	0.4302408263101066	1.0
9817168411	9	2.3380181630570167	4.0	4	5	0.46760363261140336	0.8
9817168412	6	1.5474235770926914	3.0	3	3	0.5158078590308971	1.0
9817168413	12	2.5566741256587364	3.5	5	7	0.5113348251317473	0.7142857142857143
9817168414	3	0.8609525519284666	1.0	1	2	0.4304762759642333	0.5
9817168415	31	9.22901796955935	10.0	10	21	0.4394770461694929	0.47619047619047616
9817168416	4	1.292128072625562	1.0	1	3	0.43070935754185397	0.3333333333333333
9817168417	3	1.2921795867069024	0.0	0	3	0.4307265289023008	0.0
9817168418	3	0.861515065495104	1.0	1	2	0.430757532747552	0.5
9817168419	4	0.8615373209250164	2.0	2	2	0.4307686604625082	1.0
9817168420	23	6.500802794770224	8.0	8	15	0.4333868529846816	0.5333333333333333
9817168421	9	3.1626924787454755	2.0	2	7	0.45181321124935364	0.2857142857142857
9817168422	10	2.7731725573243136	4.0	4	6	0.4621954262207189	0.6666666666666666
9817168423	3	1.2930917226399707	0.0	0	3	0.4310305742133236	0.0
9817168424	4	0.8621078141238615	2.0	2	2	0.43105390706193075	1.0
9817168425	29	8.33918204460197	10.0	10	19	0.43890431813694575	0.5263157894736842
9817168426	8	2.7746454896879755	2.0	2	6	0.46244091494799594	0.3333333333333333
9817168427	28	8.811239779968208	8.0	8	20	0.44056198899841037	0.4
9817168428	1	0.43141672780737184	0.0	0	1	0.43141672780737184	0.0
9817168429	8	5.979027742083606	0.0	0	8	0.7473784677604508	0.0
9817168430	2	0.4314448753707709	1.0	1	1	0.4314448753707709	1.0
9817168431	1	0.4314465925068156	0.0	0	1	0.4314465925068156	0.0
9817168432	2	0.4314483096428603	1.0	1	1	0.4314483096428603	1.0
9817168433	1	0.431459521531152	0.0	0	1	0.431459521531152	0.0
9817168434	2	0.43147713059294357	1.0	1	1	0.43147713059294357	1.0
9817168435	1	0.4314737973288568	0.0	0	1	0.4314737973288568	0.0
9817168436	10	2.344444729885578	5.0	5	5	0.4688889459771156	1.0
9817168437	3	1.294678187998586	0.0	0	3	0.4315593959995287	0.0
9817168438	7	3.195127293146805	1.0	1	6	0.5325212155244675	0.16666666666666666
9817168439	27	7.375949226913366	10.0	10	17	0.4338793662890215	0.5882352941176471
9817168440	1	0.4317061157349021	0.0	0	1	0.4317061157349021	0.0
9817168441	2	0.4317232870953489	1.0	1	1	0.4317232870953489	1.0
9817168442	1	0.4317235564500226	0.0	0	1	0.4317235564500226	0.0
9817168443	4	1.4925735044494193	1.0	1	3	0.7462867522247096	0.3333333333333333
9817168444	1	0.4317378322477274	0.0	0	1	0.4317378322477274	0.0
9817168445	13	2.184786363192387	4.0	6	7	0.43695727263847745	0.8571428571428571
9817168446	3	1.2954584074802216	0.0	0	3	0.43181946916007385	0.0
9817168447	18	6.230095590270061	4.0	4	14	0.4450068278764329	0.2857142857142857
9817168448	1	0.4319925407610219	0.0	0	1	0.4319925407610219	0.0
9817168449	3	0.490988958242854	0.5	1	2	0.490988958242854	0.5
9817168450	4	1.084253603216391	0.5	1	3	0.5421268016081955	0.3333333333333333
9817168451	2	1.230078923949627	0.0	0	2	0.6150394619748135	0.0
9817168452	14	4.465151851895872	4.0	4	10	0.44651518518958716	0.4
9817168453	9	2.1605456209882776	4.0	4	5	0.4321091241976555	0.8
9817168454	2	0.8642097233198893	0.0	0	2	0.43210486165994466	0.0
9817168455	3	0.8999222810758443	1.0	1	2	0.44996114053792213	0.5
9817168456	30	9.763148455804808	8.0	8	22	0.4437794752638549	0.36363636363636365
9817168457	2	0.43220324345450467	1.0	1	1	0.43220324345450467	1.0
9817168458	1	0.43221539808415427	0.0	0	1	0.43221539808415427	0.0
9817168459	1	0.4322441516955692	0.0	0	1	0.4322441516955692	0.0
9817168460	2	0.4322475522983243	1.0	1	1	0.4322475522983243	1.0
9817168461	9	2.781252187454557	3.0	3	6	0.46354203124242616	0.5
9817168462	4	1.5042418479050452	1.0	1	3	0.5014139493016817	0.3333333333333333
9817168463	3	0.8999231901478679	1.0	1	2	0.44996159507393396	0.5
9817168464	31	9.26160001995918	10.0	10	21	0.4410285723790086	0.47619047619047616
9817168465	13	3.215797166772663	6.0	6	7	0.4593995952532376	0.8571428571428571
9817168466	2	0.8649772494625281	0.0	0	2	0.43248862473126404	0.0
9817168467	3	0.8999116078968998	1.0	1	2	0.4499558039484499	0.5
9817168468	22	6.0933169166148975	8.0	8	14	0.4352369226153498	0.5714285714285714
9817168469	11	3.8753258560251456	5.0	5	6	0.6458876426708576	0.8333333333333334
9817168470	3	0.5195350992203294	0.5	1	2	0.5195350992203294	0.5
9817168471	4	1.297877852167179	1.0	1	3	0.432625950722393	0.3333333333333333
9817168472	4	1.1294664686595568	0.5	1	3	0.5647332343297784	0.3333333333333333
9817168473	4	1.5762786005422043	1.0	1	3	0.5254262001807347	0.3333333333333333
9817168474	3	1.2978798386578974	0.0	0	3	0.43262661288596577	0.0
9817168475	1	0.4326342782710541	0.0	0	1	0.4326342782710541	0.0
9817168476	2	0.4326421232259249	1.0	1	1	0.4326421232259249	1.0
9817168477	6	1.7308813483571739	2.0	2	4	0.43272033708929347	0.5
9817168478	9	3.4811478832241094	2.0	2	7	0.49730684046058704	0.2857142857142857
9817168479	9	2.1636438057835634	4.0	4	5	0.43272876115671266	0.8
9817168480	21	6.56554777969764	6.0	6	15	0.43770318531317604	0.4
9817168481	1	0.4328734988906123	0.0	0	1	0.4328734988906123	0.0
9817168482	4	1.8396543748569263	1.0	1	3	0.6132181249523088	0.3333333333333333
9817168483	1	0.43291565289704254	0.0	0	1	0.43291565289704254	0.0
9817168484	14	4.4744766413438475	4.0	4	10	0.44744766413438475	0.4
9817168485	3	1.298989950276117	0.0	0	3	0.432996650092039	0.0
9817168486	3	0.8660502911437833	1.0	1	2	0.43302514557189165	0.5
9817168487	3	0.62788507053574	0.5	1	2	0.62788507053574	0.5
9817168488	2	0.8886298894060012	0.0	0	2	0.8886298894060012	0.0
9817168489	1	0.4331787787438894	0.0	0	1	0.4331787787438894	0.0
9817168490	3	0.4486561003092966	0.5	1	2	0.4486561003092966	0.5
9817168491	4	1.3395860429431483	0.5	1	3	0.6697930214715742	0.3333333333333333
9817168492	21	6.644038404993405	6.0	6	15	0.442935893666227	0.4
9817168493	7	2.3537914717394592	2.0	2	5	0.47075829434789185	0.4
9817168494	3	1.2998677771576261	0.0	0	3	0.43328925905254206	0.0
9817168495	3	0.9001049372139306	1.0	1	2	0.4500524686069653	0.5
9817168496	31	9.281857141216966	10.0	10	21	0.4419931972008079	0.47619047619047616
9817168497	3	0.5279586952688559	0.5	1	2	0.5279586952688559	0.5
9817168498	2	0.8302117764085507	0.0	0	2	0.8302117764085507	0.0
9817168499	9	2.3547992285816823	4.0	4	5	0.4709598457163365	0.8
9817168500	3	1.300563452941062	0.0	0	3	0.433521150980354	0.0
9817168501	3	0.9001246337744431	1.0	1	2	0.45006231688722154	0.5
9817168502	3	2.335639862296463	0.0	0	3	0.7785466207654878	0.0
9817168503	1	0.433715770955196	0.0	0	1	0.433715770955196	0.0
9817168504	2	0.8702570724372494	0.0	0	2	0.4351285362186247	0.0
9817168505	3	0.8675058501309922	1.0	1	2	0.4337529250654961	0.5
9817168506	3	1.761627578309232	0.0	0	3	0.5872091927697439	0.0
9817168507	1	0.43381300799239286	0.0	0	1	0.43381300799239286	0.0
9817168508	5	3.0764874682569725	0.0	0	5	0.6152974936513945	0.0
9817168509	2	0.8694513989389514	0.0	0	2	0.4347256994694757	0.0
9817168510	2	0.8694544291790302	0.0	0	2	0.4347272145895151	0.0
9817168511	8	4.924554462959473	1.0	1	7	0.7035077804227818	0.14285714285714285
9817168512	26	9.749964588277743	5.0	5	21	0.4642840280132259	0.23809523809523808
9817168513	11	4.168133779847065	2.0	2	9	0.46312597553856283	0.2222222222222222
9817168514	1	0.4352322040986556	0.0	0	1	0.4352322040986556	0.0
9817168515	2	1.064215736662979	0.0	0	2	0.5321078683314895	0.0
9817168516	1	0.4352824387452961	0.0	0	1	0.4352824387452961	0.0
9817168517	1	0.43530846514064003	0.0	0	1	0.43530846514064003	0.0
9817168518	2	0.8706824508056517	0.0	0	2	0.4353412254028258	0.0
9817168519	2	1.345920759827986	0.0	0	2	0.672960379913993	0.0
9817168520	2	1.105073945096831	0.0	0	2	0.5525369725484155	0.0
9817168521	1	0.43541903523418385	0.0	0	1	0.43541903523418385	0.0
9817168522	3	1.7021833923517482	0.0	0	3	0.5673944641172494	0.0
9817168523	3	2.06952178804905	0.0	0	3	0.68984059601635	0.0
9817168524	2	0.8710400864736245	0.0	0	2	0.43552004323681226	0.0
9817168525	2	1.4016063033303316	0.0	0	2	0.7008031516651658	0.0
9817168526	1	0.43555970571251096	0.0	0	1	0.43555970571251096	0.0
9817168527	3	1.4305785634015615	0.0	0	3	0.4768595211338538	0.0
9817168528	2	1.386558939162779	0.0	0	2	0.6932794695813895	0.0
9817168529	3	1.972222630930529	0.0	0	3	0.6574075436435097	0.0
9817168530	10	3.382609021219997	3.0	3	7	0.48322986017428526	0.42857142857142855
9817168531	1	0.4356755955608599	0.0	0	1	0.4356755955608599	0.0
9817168532	1	0.43568680744915167	0.0	0	1	0.43568680744915167	0.0
9817168533	1	0.4356980193374434	0.0	0	1	0.4356980193374434	0.0
9817168534	1	0.43572741266620824	0.0	0	1	0.43572741266620824	0.0
9817168535	1	0.43574172213324724	0.0	0	1	0.43574172213324724	0.0
9817168536	2	1.189207146774089	0.0	0	2	0.5946035733870445	0.0
9817168537	1	0.43576337151514394	0.0	0	1	0.43576337151514394	0.0
9817168538	1	0.43580037411344014	0.0	0	1	0.43580037411344014	0.0
9817168539	1	0.4358124277350871	0.0	0	1	0.4358124277350871	0.0
9817168540	3	1.4647872803450515	0.0	0	3	0.4882624267816838	0.0
9817168541	2	0.8717196683153081	0.0	0	2	0.43585983415765406	0.0
9817168542	1	0.43590548977484206	0.0	0	1	0.43590548977484206	0.0
9817168543	2	1.3118300875702347	0.0	0	2	0.6559150437851173	0.0
9817168544	3	1.8794139529155234	0.0	0	3	0.6264713176385078	0.0
9817168545	1	0.43596989921118473	0.0	0	1	0.43596989921118473	0.0
9817168546	2	0.8720570013747526	0.0	0	2	0.4360285006873763	0.0
9817168547	1	0.4359931310517893	0.0	0	1	0.4359931310517893	0.0
9817168548	3	2.353417540113729	0.0	0	3	0.784472513371243	0.0
9817168549	2	0.8721146432749192	0.0	0	2	0.4360573216374596	0.0
9817168550	4	2.361045630802889	0.0	0	4	0.7870152102676297	0.0
9817168551	1	0.4360989200998754	0.0	0	1	0.4360989200998754	0.0
9817168552	1	0.43612349871384826	0.0	0	1	0.43612349871384826	0.0
9817168553	1	0.43616639344563113	0.0	0	1	0.43616639344563113	0.0
9817168554	1	0.43617760533392286	0.0	0	1	0.43617760533392286	0.0
9817168555	1	0.4361888172222146	0.0	0	1	0.4361888172222146	0.0
9817168556	2	1.058265489905479	0.0	0	2	0.5291327449527395	0.0
9817168557	2	1.0001890196422518	0.0	0	2	0.5000945098211259	0.0
9817168558	1	0.4362315436073264	0.0	0	1	0.4362315436073264	0.0
9817168559	2	0.8724900900206888	0.0	0	2	0.4362450450103444	0.0
9817168560	6	4.419715186388215	0.0	0	6	0.7366191977313692	0.0
9817168561	2	0.872570189366773	0.0	0	2	0.4362850946833865	0.0
9817168562	1	0.43628575123540364	0.0	0	1	0.43628575123540364	0.0
9817168563	2	0.8726892441325377	0.0	0	2	0.43634462206626884	0.0
9817168564	4	1.9101492740032975	0.0	0	4	0.6367164246677658	0.0
9817168565	1	0.4363803957338664	0.0	0	1	0.4363803957338664	0.0
9817168566	5	3.1555122575399697	0.0	0	5	0.6311024515079939	0.0
9817168567	1	0.4364063884598761	0.0	0	1	0.4364063884598761	0.0
9817168568	2	0.8729512588913557	0.0	0	2	0.43647562944567786	0.0
9817168569	1	0.4364614714906428	0.0	0	1	0.4364614714906428	0.0
9817168570	4	1.7466476201487666	0.0	0	4	0.43666190503719166	0.0
9817168571	2	0.8733050562552287	0.0	0	2	0.43665252812761435	0.0
9817168572	2	0.43668574292581197	1.0	1	1	0.43668574292581197	1.0
9817168573	2	0.873402865671107	0.0	0	2	0.4367014328355535	0.0
9817168574	11	3.945228848276115	2.0	2	9	0.4383587609195683	0.2222222222222222
9817168575	2	0.8735353881705554	0.0	0	2	0.4367676940852777	0.0
9817168576	43	17.709701451656716	11.0	11	32	0.5534281703642724	0.34375
9817168577	2	0.43812796885667393	1.0	1	1	0.43812796885667393	1.0
9817168578	2	0.4381876982555615	1.0	1	1	0.4381876982555615	1.0
9817168579	1	0.438309311890726	0.0	0	1	0.438309311890726	0.0
9817168580	1	0.4383205237790178	0.0	0	1	0.4383205237790178	0.0
9817168581	2	0.4383640582281506	1.0	1	1	0.4383640582281506	1.0
9817168582	10	3.509268477486512	2.0	2	8	0.438658559685814	0.25
9817168583	6	2.192280146907386	1.0	1	5	0.4384560293814772	0.2
9817168584	9	4.834315866232678	1.0	1	8	0.6042894832790847	0.125
9817168585	16	8.238467705906583	3.0	3	13	0.6337282850697371	0.23076923076923078
9817168586	5	3.0801637555206347	0.0	0	5	0.6160327511041269	0.0
9817168587	3	0.8793725059651119	1.0	1	2	0.4396862529825559	0.5
9817168588	2	0.439682414678456	1.0	1	1	0.439682414678456	1.0
9817168589	17	7.484421013879947	5.0	5	12	0.6237017511566623	0.4166666666666667
9817168590	1	0.4399640923284523	0.0	0	1	0.4399640923284523	0.0
9817168591	3	1.448908990678544	0.0	0	3	0.48296966355951465	0.0
9817168592	3	0.9444420969436427	1.0	1	2	0.47222104847182134	0.5
9817168593	2	0.439971600589981	1.0	1	1	0.439971600589981	1.0
9817168594	2	1.399396719603502	0.0	0	2	0.699698359801751	0.0
9817168595	9	2.3812632242623106	4.0	4	5	0.4762526448524621	0.8
9817168596	13	2.575852279432444	4.5	6	7	0.5151704558864888	0.8571428571428571
9817168597	11	2.823554002261973	5.0	5	6	0.4705923337103288	0.8333333333333334
9817168598	2	0.8809446281873539	0.0	0	2	0.44047231409367693	0.0
9817168599	2	0.4405024986517957	1.0	1	1	0.4405024986517957	1.0
9817168600	7	2.203460184008972	2.0	2	5	0.44069203680179436	0.4
9817168601	2	0.4407136390466232	1.0	1	1	0.4407136390466232	1.0
9817168602	8	2.2043635659151457	3.0	3	5	0.4408727131830291	0.6
9817168603	2	0.44089440970199373	1.0	1	1	0.44089440970199373	1.0
9817168604	7	2.2054073826143075	2.0	2	5	0.4410814765228615	0.4
9817168605	4	1.016356091188274	0.5	1	3	0.508178045594137	0.3333333333333333
9817168606	9	2.2063508310281903	4.0	4	5	0.4412701662056381	0.8
9817168607	3	0.5088585196731772	0.5	1	2	0.5088585196731772	0.5
9817168608	11	2.8317226204425316	3.5	4	7	0.4719537700737553	0.5714285714285714
9817168609	2	0.8829132404892464	0.0	0	2	0.4414566202446232	0.0
9817168610	1	0.44148911115213535	0.0	0	1	0.44148911115213535	0.0
9817168611	10	2.389970989491565	5.0	5	5	0.477994197898313	1.0
9817168612	6	0.9870064652192243	2.0	3	3	0.49350323260961215	1.0
9817168613	9	2.2091787184084426	4.0	4	5	0.44183574368168854	0.8
9817168614	1	0.44185789136973147	0.0	0	1	0.44185789136973147	0.0
9817168615	9	2.2101367793133724	4.0	4	5	0.4420273558626745	0.8
9817168616	3	0.8841134175764767	1.0	1	2	0.44205670878823833	0.5
9817168617	5	1.3268814247192238	2.0	2	3	0.44229380823974124	0.6666666666666666
9817168618	24	7.132607110485281	8.0	8	16	0.44578794440533004	0.5
9817168619	12	2.881233006034858	4.0	5	7	0.48020550100580967	0.7142857142857143
9817168620	1	0.44221394457899643	0.0	0	1	0.44221394457899643	0.0
9817168621	6	0.9916666377671548	1.0	2	4	0.4958333188835774	0.5
9817168622	29	8.995412822568635	9.0	9	20	0.4497706411284318	0.45
9817168623	5	3.7062399074066374	0.0	0	5	0.7412479814813275	0.0
9817168624	10	6.277916280325087	0.5	1	9	0.7847395350406359	0.1111111111111111
9817168625	4	1.0190013897691081	0.5	1	3	0.5095006948845541	0.3333333333333333
9817168626	3	1.8814989264364441	0.0	0	3	0.9407494632182221	0.0
9817168627	3	0.6840833643287613	0.5	1	2	0.6840833643287613	0.5
9817168628	1	0.44239791382111693	0.0	0	1	0.44239791382111693	0.0
9817168629	4	0.8849233670802192	2.0	2	2	0.4424616835401096	1.0
9817168630	9	2.2123771704810036	4.0	4	5	0.4424754340962007	0.8
9817168631	26	8.057117971656952	8.0	8	18	0.4476176650920529	0.4444444444444444
9817168632	4	1.4824652295943888	1.0	1	3	0.7412326147971944	0.3333333333333333
9817168633	6	5.387917025427451	0.0	0	6	0.8979861709045752	0.0
9817168634	2	0.4426150810267679	1.0	1	1	0.4426150810267679	1.0
9817168635	1	0.44261700017881783	0.0	0	1	0.44261700017881783	0.0
9817168636	4	0.8853448734751874	2.0	2	2	0.4426724367375937	1.0
9817168637	7	2.394643013645137	2.0	2	5	0.4789286027290274	0.4
9817168638	4	1.3479105164717622	0.5	1	3	0.6739552582358811	0.3333333333333333
9817168639	19	5.843168005567022	6.0	6	13	0.449474461966694	0.46153846153846156
9817168640	13	4.0751843303457305	4.0	4	9	0.4527982589273034	0.4444444444444444
9817168641	7	1.9526588286027862	3.0	3	4	0.48816470715069654	0.75
9817168642	4	0.9503454086492547	0.5	1	3	0.4751727043246273	0.3333333333333333
9817168643	9	3.8642902603673184	2.0	2	7	0.5520414657667597	0.2857142857142857
9817168644	29	9.008745104520894	9.0	9	20	0.4504372552260447	0.45
9817168645	3	1.3292281099749546	0.0	0	3	0.4430760366583182	0.0
9817168646	11	3.660053560503474	4.0	4	7	0.5228647943576391	0.5714285714285714
9817168647	31	9.961122996199034	9.0	9	22	0.452778318009047	0.4090909090909091
9817168648	2	0.4431909613190864	1.0	1	1	0.4431909613190864	1.0
9817168649	1	0.4431988062739572	0.0	0	1	0.4431988062739572	0.0
9817168650	4	1.3296804238107243	1.0	1	3	0.4432268079369081	0.3333333333333333
9817168651	3	1.3296843631228268	0.0	0	3	0.4432281210409423	0.0
9817168652	5	2.3975317751816405	0.0	0	5	0.4795063550363281	0.0
9817168653	3	1.329997083898964	0.0	0	3	0.4433323612996547	0.0
9817168654	2	0.8867239694044067	0.0	0	2	0.44336198470220334	0.0
9817168655	17	5.3519198271200885	5.0	5	12	0.44599331892667404	0.4166666666666667
9817168656	3	0.6389606653626084	0.5	1	2	0.6389606653626084	0.5
9817168657	2	0.976023663077437	0.0	0	2	0.976023663077437	0.0
9817168658	3	0.7725013591468487	0.5	1	2	0.7725013591468487	0.5
9817168659	2	0.9760548745502492	0.0	0	2	0.9760548745502492	0.0
9817168660	3	0.8196044210125332	0.5	1	2	0.8196044210125332	0.5
9817168661	10	3.194584779164688	3.0	3	7	0.456369254166384	0.42857142857142855
9817168662	9	2.2179734178586257	4.0	4	5	0.44359468357172516	0.8
9817168663	3	1.3307817477327153	0.0	0	3	0.4435939159109051	0.0
9817168664	31	9.467901256058084	10.0	10	21	0.4508524407646707	0.47619047619047616
9817168665	2	0.4437446535201609	1.0	1	1	0.4437446535201609	1.0
9817168666	1	0.44375068033098436	0.0	0	1	0.44375068033098436	0.0
9817168667	1	0.44375586540845263	0.0	0	1	0.44375586540845263	0.0
9817168668	3	0.8875326394734493	1.0	1	2	0.44376631973672465	0.5
9817168669	11	2.871436475545272	3.0	4	7	0.478572745924212	0.5714285714285714
9817168670	3	1.3315178267172025	0.0	0	3	0.4438392755724008	0.0
9817168671	31	9.474531859051952	10.0	10	21	0.45116818376437867	0.47619047619047616
9817168672	1	0.44396182072581186	0.0	0	1	0.44396182072581186	0.0
9817168673	7	3.8561964554473738	1.0	1	6	0.6426994092412289	0.16666666666666666
9817168674	8	2.4066197682021215	3.0	3	5	0.4813239536404243	0.6
9817168675	3	1.3321788230864025	0.0	0	3	0.4440596076954675	0.0
9817168676	2	0.8881782489569157	0.0	0	2	0.44408912447845783	0.0
9817168677	26	8.086181172599881	8.0	8	18	0.44923228736666004	0.4444444444444444
9817168678	1	0.44421471109505906	0.0	0	1	0.44421471109505906	0.0
9817168679	1	0.44421642823110374	0.0	0	1	0.44421642823110374	0.0
9817168680	8	2.4077427078366753	3.0	3	5	0.48154854156733506	0.6
9817168681	3	1.3328570918240519	0.0	0	3	0.444285697274684	0.0
9817168682	4	1.3063376427499807	0.5	1	3	0.6531688213749903	0.3333333333333333
9817168683	10	3.674268686068037	2.0	2	8	0.45928358575850464	0.25
9817168684	22	6.281532939197863	8.0	8	14	0.44868092422841876	0.5714285714285714
9817168685	9	2.2225003945204236	4.0	4	5	0.4445000789040847	0.8
9817168686	3	1.3335039807422182	0.0	0	3	0.44450132691407274	0.0
9817168687	6	1.1812159323154803	1.0	2	4	0.5906079661577401	0.5
9817168688	27	8.567663324974024	8.0	8	19	0.45092964868284335	0.42105263157894735
9817168689	8	2.4099582173663263	3.0	3	5	0.4819916434732653	0.6
9817168690	3	1.3340653158821583	0.0	0	3	0.4446884386273861	0.0
9817168691	4	1.4044131137073683	0.5	1	3	0.7022065568536842	0.3333333333333333
9817168692	2	0.8924960380452702	0.0	0	2	0.4462480190226351	0.0
9817168693	6	1.469780206922974	3.0	3	3	0.4899267356409913	1.0
9817168694	2	0.892283651885077	0.0	0	2	0.4461418259425385	0.0
9817168695	1	0.4448945622914164	0.0	0	1	0.4448945622914164	0.0
9817168696	4	1.9344734488175783	0.0	0	4	0.6448244829391928	0.0
9817168697	2	1.3128168684172454	0.0	0	2	0.6564084342086227	0.0
9817168698	3	0.8912944805153374	1.0	1	2	0.4456472402576687	0.5
9817168699	54	23.604531952989397	8.0	9	45	0.6379603230537675	0.2
9817168700	49	19.351779931036454	5.5	8	41	0.624250965517305	0.1951219512195122
9817168701	34	16.014679493021983	2.0	3	31	0.6405871797208793	0.0967741935483871
9817168702	55	22.255087528989712	6.0	9	46	0.6954714852809285	0.1956521739130435
9817168703	52	19.436220197041695	5.0	9	43	0.6478740065680565	0.20930232558139536
9817168704	37	15.747768539623266	2.0	4	33	0.6561570224843027	0.12121212121212122
9817168705	1	0.446403924874692	0.0	0	1	0.446403924874692	0.0
9817168706	2	1.1159747960791522	0.0	0	2	0.5579873980395761	0.0
9817168707	1	0.4464527454092957	0.0	0	1	0.4464527454092957	0.0
9817168708	1	0.4464673579003426	0.0	0	1	0.4464673579003426	0.0
9817168709	2	0.8930490568596605	0.0	0	2	0.44652452842983026	0.0
9817168710	1	0.4464858086954894	0.0	0	1	0.4464858086954894	0.0
9817168711	1	0.44649742461579167	0.0	0	1	0.44649742461579167	0.0
9817168712	5	3.148072344759707	0.0	0	5	0.7870180861899267	0.0
9817168713	1	0.44656149735879225	0.0	0	1	0.44656149735879225	0.0
9817168714	2	0.8934062211569544	0.0	0	2	0.4467031105784772	0.0
9817168715	2	0.8933359532564593	0.0	0	2	0.44666797662822966	0.0
9817168716	1	0.4466209910723403	0.0	0	1	0.4466209910723403	0.0
9817168717	1	0.4466534819798525	0.0	0	1	0.4466534819798525	0.0
9817168718	1	0.4466809561565674	0.0	0	1	0.4466809561565674	0.0
9817168719	1	0.44669257207686963	0.0	0	1	0.44669257207686963	0.0
9817168720	2	1.4132530310733948	0.0	0	2	0.7066265155366974	0.0
9817168721	4	2.50067791520964	0.0	0	4	0.62516947880241	0.0
9817168722	3	1.6991558794889683	0.0	0	3	0.5663852931629895	0.0
9817168723	3	1.7972569391403552	0.0	0	3	0.5990856463801184	0.0
9817168724	2	0.8938148995355888	0.0	0	2	0.4469074497677944	0.0
9817168725	2	0.893782778990753	0.0	0	2	0.4468913894953765	0.0
9817168726	1	0.44690024453027355	0.0	0	1	0.44690024453027355	0.0
9817168727	1	0.4469352269685172	0.0	0	1	0.4469352269685172	0.0
9817168728	2	0.8939742901637364	0.0	0	2	0.4469871450818682	0.0
9817168729	1	0.446990815039297	0.0	0	1	0.446990815039297	0.0
9817168730	1	0.4470172117973172	0.0	0	1	0.4470172117973172	0.0
9817168731	2	0.8941041527857823	0.0	0	2	0.44705207639289113	0.0
9817168732	3	1.7874511159145279	0.0	0	3	0.5958170386381759	0.0
9817168733	1	0.44707828796957316	0.0	0	1	0.44707828796957316	0.0
9817168734	1	0.4471132704078168	0.0	0	1	0.4471132704078168	0.0
9817168735	6	3.57025633507883	0.0	0	6	0.714051267015766	0.0
9817168736	1	0.4471499699821051	0.0	0	1	0.4471499699821051	0.0
9817168737	2	1.3545192007290623	0.0	0	2	0.6772596003645311	0.0
9817168738	2	1.2522948597330485	0.0	0	2	0.6261474298665243	0.0
9817168739	1	0.4472757922840458	0.0	0	1	0.4472757922840458	0.0
9817168740	2	1.2531307346241327	0.0	0	2	0.6265653673120664	0.0
9817168741	1	0.4473432992991358	0.0	0	1	0.4473432992991358	0.0
9817168742	1	0.44737100916119016	0.0	0	1	0.44737100916119016	0.0
9817168743	4	2.988073783113664	0.0	0	4	0.747018445778416	0.0
9817168744	2	1.2531279737387273	0.0	0	2	0.6265639868693637	0.0
9817168745	1	0.44744976173390605	0.0	0	1	0.44744976173390605	0.0
9817168746	2	1.2533407976002653	0.0	0	2	0.6266703988001326	0.0
9817168747	3	2.110086568235266	0.0	0	3	0.7033621894117553	0.0
9817168748	3	2.145297015210155	0.0	0	3	0.7150990050700518	0.0
9817168749	2	1.2533683054463145	0.0	0	2	0.6266841527231573	0.0
9817168750	6	2.858229712870948	0.5	1	5	0.714557428217737	0.2
9817168751	7	1.4617122263823679	1.6666666666666665	3	4	0.7308561131911839	0.75
9817168752	6	1.4321072185133392	1.0	2	4	0.7160536092566696	0.5
9817168753	4	2.709078366957831	0.0	0	4	0.6772695917394578	0.0
9817168754	6	1.7760030709126347	1.5	2	4	0.5920010236375449	0.5
9817168755	3	1.6332974160099099	0.0	0	3	0.5444324720033032	0.0
9817168756	2	1.2021529384389555	0.0	0	2	0.6010764692194778	0.0
9817168757	6	2.7225677163541753	0.5	1	5	0.6806419290885438	0.2
9817168758	5	1.2801196688944207	1.5	2	3	0.6400598344472104	0.6666666666666666
9817168759	5	2.712459542507147	1.0	1	4	0.6781148856267868	0.25
9817168760	4	0.4495873267548617	1.0	2	2	0.4495873267548617	1.0
9817168761	3	0.46859369958543284	0.5	1	2	0.46859369958543284	0.5
9817168762	3	1.9591068091279047	0.0	0	3	0.6530356030426349	0.0
9817168763	1	0.4489293606257405	0.0	0	1	0.4489293606257405	0.0
9817168764	4	1.2042401004666	2.0	2	2	0.6021200502333	1.0
9817168765	2	0.4491602985890832	1.0	1	1	0.4491602985890832	1.0
9817168766	13	7.83918233079131	0.0	0	13	0.6532651942326092	0.0
9817168767	40	11.263928961475784	15.0	15	25	0.4505571584590314	0.6
9817168768	1	0.4493131236970599	0.0	0	1	0.4493131236970599	0.0
9817168769	2	0.4493243355853516	1.0	1	1	0.4493243355853516	1.0
9817168770	5	1.3484459935630293	2.0	2	3	0.4494819978543431	0.6666666666666666
9817168771	3	0.8987322384582112	1.0	1	2	0.4493661192291056	0.5
9817168772	2	0.4493738631759738	1.0	1	1	0.4493738631759738	1.0
9817168773	10	2.8788288135562974	4.0	4	6	0.4798048022593829	0.6666666666666666
9817168774	6	1.798864077470175	2.0	2	4	0.44971601936754374	0.5
9817168775	3	0.899159636986666	1.0	1	2	0.449579818493333	0.5
9817168776	2	0.4495909293736221	1.0	1	1	0.4495909293736221	1.0
9817168777	4	0.8993214518068766	2.0	2	2	0.4496607259034383	1.0
9817168778	40	12.28146627391613	13.0	13	27	0.454869121256153	0.48148148148148145
9817168779	3	0.8995277774869122	1.0	1	2	0.4497638887434561	0.5
9817168780	4	2.374306399089285	1.0	1	3	0.791435466363095	0.3333333333333333
9817168781	27	8.66455949383139	8.0	8	19	0.4560294470437574	0.42105263157894735
9817168782	2	0.4499670158367417	1.0	1	1	0.4499670158367417	1.0
9817168783	8	2.250091740518387	3.0	3	5	0.45001834810367736	0.6
9817168784	2	0.9000265886732253	0.0	0	2	0.45001329433661263	0.0
9817168785	3	0.9362236144791201	1.0	1	2	0.46811180723956003	0.5
9817168786	4	2.115682680935551	1.0	1	3	0.7052275603118504	0.3333333333333333
9817168787	2	0.45015566511631727	1.0	1	1	0.45015566511631727	1.0
9817168788	2	0.9003704872528406	0.0	0	2	0.4501852436264203	0.0
9817168789	2	0.45021808806194163	1.0	1	1	0.45021808806194163	1.0
9817168790	44	13.677075328098406	14.0	14	30	0.45590251093661355	0.4666666666666667
9817168791	5	1.3513275498620112	2.0	2	3	0.4504425166206704	0.6666666666666666
9817168792	4	0.900665531628518	2.0	2	2	0.450332765814259	1.0
9817168793	3	1.3551787156475572	1.0	1	2	0.6775893578237786	0.5
9817168794	10	2.885036159349821	4.0	4	6	0.4808393598916368	0.6666666666666666
9817168795	2	0.4504128314910091	1.0	1	1	0.4504128314910091	1.0
9817168796	6	1.8026304638721817	2.0	2	4	0.45065761596804543	0.5
9817168797	28	8.701623774347851	9.0	9	19	0.4579801986498869	0.47368421052631576
9817168798	2	0.4505381824222709	1.0	1	1	0.4505381824222709	1.0
9817168799	10	2.4567779854539724	3.0	4	6	0.49135559709079446	0.6666666666666666
9817168800	2	0.45060387129331353	1.0	1	1	0.45060387129331353	1.0
9817168801	4	0.9014081424638417	2.0	2	2	0.45070407123192086	1.0
9817168802	2	0.4507154514668837	1.0	1	1	0.4507154514668837	1.0
9817168803	19	5.327376128246763	8.0	8	11	0.4843069207497057	0.7272727272727273
9817168804	4	0.9015632234172105	2.0	2	2	0.45078161170860526	1.0
9817168805	40	11.809357832532571	14.0	14	26	0.454206070482022	0.5384615384615384
9817168806	2	0.4508921818021491	1.0	1	1	0.4508921818021491	1.0
9817168807	2	0.45090342735977507	1.0	1	1	0.45090342735977507	1.0
9817168808	2	0.9018694460118455	0.0	0	2	0.45093472300592274	0.0
9817168809	10	2.2557036778057507	5.0	5	5	0.45114073556115014	1.0
9817168810	3	0.9021401811282237	1.0	1	2	0.45107009056411185	0.5
9817168811	2	0.45108120144440095	1.0	1	1	0.45108120144440095	1.0
9817168812	4	0.9022805822518771	2.0	2	2	0.45114029112593856	1.0
9817168813	41	12.269694026895134	14.0	14	27	0.4544331121072272	0.5185185185185185
9817168814	6	1.805510841744466	2.0	2	4	0.4513777104361165	0.5
9817168815	6	2.41758273910606	2.0	2	4	0.604395684776515	0.5
9817168816	2	0.45124907674476933	1.0	1	1	0.45124907674476933	1.0
9817168817	4	0.9026350530024343	2.0	2	2	0.45131752650121715	1.0
9817168818	4	0.9029430937411166	2.0	2	2	0.4514715468705583	1.0
9817168819	20	15.416888208079985	1.0	1	19	0.811415168846315	0.05263157894736842
10087715752	4	0.40710921931352473	2.0	2	2	0.20355460965676236	1.0
10087715753	11	5.337408849115828	1.0	1	10	0.5337408849115828	0.1
10087715754	2	0.40746022212265826	0.0	0	2	0.20373011106132913	0.0
10087715755	51	12.58502333470042	9.0	14	37	0.4661119753592748	0.3783783783783784
10087715756	55	12.164502003443229	9.0	14	41	0.3924032904336525	0.34146341463414637
10087715757	57	12.953336693308428	13.5	16	41	0.39252535434267966	0.3902439024390244
10087715758	54	12.451964011387373	10.0	13	41	0.3891238753558554	0.3170731707317073
10087715759	40	10.869418268314087	9.0	10	30	0.43477673073256345	0.3333333333333333
10087715760	22	5.178041553816879	3.5	5	17	0.39831088875514453	0.29411764705882354
10087715761	32	8.004487549871438	8.5	9	23	0.38116607380340184	0.391304347826087
10087715762	25	11.655743313345981	4.0	4	21	0.5550353958736182	0.19047619047619047
10087715763	15	3.578883226567313	3.0	3	12	0.29824026888060945	0.25
10087715764	13	5.3820826685183	2.0	2	11	0.4892802425925727	0.18181818181818182
10087715765	2	1.0620950399784623	0.0	0	2	0.5310475199892312	0.0
10087715766	4	1.8322669188993617	0.0	0	4	0.4580667297248404	0.0
10087715767	1	0.20489045732618955	0.0	0	1	0.20489045732618955	0.0
10087715768	1	0.2049034536891944	0.0	0	1	0.2049034536891944	0.0
10087715769	2	0.4100503366647231	0.0	0	2	0.20502516833236156	0.0
10087715770	3	1.109772298669755	0.0	0	3	0.36992409955658495	0.0
10087715771	2	1.0728579813678618	0.0	0	2	0.5364289906839309	0.0
10087715772	3	1.1544818412358235	0.0	0	3	0.3848272804119412	0.0
10087715773	2	0.4099338744376927	0.0	0	2	0.20496693721884635	0.0
10087715774	1	0.20497944537650514	0.0	0	1	0.20497944537650514	0.0
10087715775	1	0.20499348548887047	0.0	0	1	0.20499348548887047	0.0
10087715776	2	0.41007080761992254	0.0	0	2	0.20503540380996127	0.0
10087715777	2	0.5285349795931849	0.0	0	2	0.2642674897965924	0.0
10087715778	2	0.5756671991022948	0.0	0	2	0.2878335995511474	0.0
10087715779	3	1.1126883323669672	0.0	0	3	0.37089611078898904	0.0
10087715780	3	1.1511393517515143	0.0	0	3	0.3837131172505048	0.0
10087715781	1	0.2050782985417441	0.0	0	1	0.2050782985417441	0.0
10087715782	1	0.20508654752862543	0.0	0	1	0.20508654752862543	0.0
10087715783	2	0.41022343071189393	0.0	0	2	0.20511171535594697	0.0
10087715784	4	2.008112255715092	0.0	0	4	0.502028063928773	0.0
10087715785	4	0.738023556884357	1.0	1	3	0.24600785229478564	0.3333333333333333
10087715786	4	1.8862257642661093	0.0	0	4	0.47155644106652733	0.0
10087715787	11	1.9508918282741399	4.0	4	7	0.2786988326105914	0.5714285714285714
10087715788	1	0.2051666132053755	0.0	0	1	0.2051666132053755	0.0
10087715789	2	0.5068960688594449	0.0	0	2	0.25344803442972247	0.0
10087715790	1	0.20518775754725904	0.0	0	1	0.20518775754725904	0.0
10087715791	2	0.4685129605219986	0.0	0	2	0.2342564802609993	0.0
10087715792	4	1.2012354490817478	0.0	0	4	0.4004118163605826	0.0
10087715793	1	0.20528381615775862	0.0	0	1	0.20528381615775862	0.0
10087715794	4	1.4271909906787457	0.0	0	4	0.3567977476696864	0.0
10087715795	4	1.8353982679888434	0.0	0	4	0.6117994226629478	0.0
10087715796	3	0.6530140097762952	0.0	0	3	0.2176713365920984	0.0
10087715797	4	1.9405900220860732	0.0	0	4	0.4851475055215183	0.0
10087715798	1	0.2053650265918718	0.0	0	1	0.2053650265918718	0.0
10087715799	1	0.20538014412293185	0.0	0	1	0.20538014412293185	0.0
10087715800	1	0.20540287092352325	0.0	0	1	0.20540287092352325	0.0
10087715801	3	0.8584017294994242	0.0	0	3	0.2861339098331414	0.0
10087715802	6	3.806363079931976	0.0	0	6	0.6343938466553293	0.0
10087715803	6	1.8381770991491524	2.0	2	4	0.4595442747872881	0.5
10087715804	5	2.970160249532863	0.0	0	5	0.7425400623832158	0.0
10087715805	2	0.4110245588500737	0.0	0	2	0.20551227942503686	0.0
10087715806	1	0.2054909835711494	0.0	0	1	0.2054909835711494	0.0
10087715807	2	0.4110076905136348	0.0	0	2	0.2055038452568174	0.0
10087715808	2	0.4405889951713798	0.0	0	2	0.2202944975856899	0.0
10087715809	4	1.2669252628657512	0.0	0	4	0.3167313157164378	0.0
10087715810	2	0.5092158859864764	0.0	0	2	0.2546079429932382	0.0
10087715811	2	0.5786154206830114	0.0	0	2	0.2893077103415057	0.0
10087715812	4	1.014468150611147	0.0	0	4	0.25361703765278676	0.0
10087715813	1	0.2056904743763404	0.0	0	1	0.2056904743763404	0.0
10087715814	1	0.20572666891061556	0.0	0	1	0.20572666891061556	0.0
10087715815	3	1.2318399648061185	0.0	0	3	0.4106133216020395	0.0
10087715816	4	2.059107155922047	0.0	0	4	0.5147767889805117	0.0
10087715817	1	0.20576390719425122	0.0	0	1	0.20576390719425122	0.0
10087715818	1	0.2057838731094374	0.0	0	1	0.2057838731094374	0.0
10087715819	2	0.5294772159110365	0.0	0	2	0.26473860795551823	0.0
10087715820	2	0.41184090552731617	0.0	0	2	0.20592045276365809	0.0
10087715821	2	1.1575212393735792	0.0	0	2	0.5787606196867896	0.0
10087715822	5	1.3951070780785464	0.0	0	5	0.3487767695196366	0.0
10087715823	2	0.4845881147856289	0.0	0	2	0.24229405739281445	0.0
10087715824	1	0.2059020188031784	0.0	0	1	0.2059020188031784	0.0
10087715825	12	3.750177849840628	4.0	4	8	0.4687722312300785	0.5
10087715826	2	0.41191682987595846	0.0	0	2	0.20595841493797923	0.0
10087715827	1	0.2059721856956709	0.0	0	1	0.2059721856956709	0.0
10087715828	2	0.41209268480853445	0.0	0	2	0.20604634240426722	0.0
10087715829	2	0.4120455814099754	0.0	0	2	0.2060227907049877	0.0
10087715830	2	0.9704036114805292	0.0	0	2	0.4852018057402646	0.0
10087715831	1	0.206035214689311	0.0	0	1	0.206035214689311	0.0
10087715832	3	1.3739135116283947	0.0	0	3	0.45797117054279823	0.0
10087715833	1	0.20606012999662598	0.0	0	1	0.20606012999662598	0.0
10087715834	6	2.9386454160194715	1.0	1	5	0.5877290832038943	0.2
10087715835	2	0.4121630873863664	0.0	0	2	0.2060815436931832	0.0
10087715836	4	0.41255429138054606	2.0	2	2	0.20627714569027303	1.0
10087715837	2	0.20623706234789668	1.0	1	1	0.20623706234789668	1.0
10087715838	14	2.3552264924328004	5.0	6	8	0.3364609274904001	0.75
10087715839	3	0.8445410073467496	0.0	0	3	0.4222705036733748	0.0
10087715840	2	0.20631167359250482	1.0	1	1	0.20631167359250482	1.0
10087715841	54	8.803404050494978	14.0	17	37	0.27510637657796805	0.4594594594594595
10087715842	10	2.1434439223939354	1.0	2	8	0.4286887844787871	0.25
10087715843	3	0.6194500942522507	0.0	0	3	0.20648336475075024	0.0
10087715844	37	7.198814354597416	6.5	10	27	0.37888496603144295	0.37037037037037035
10087715845	48	10.583583431953619	7.0	10	38	0.3919845715538377	0.2631578947368421
10087715846	62	16.219478066735114	6.0	9	53	0.4914993353556095	0.16981132075471697
10087715847	16	5.091400256095691	2.0	2	14	0.4242833546746409	0.14285714285714285
10087715848	46	10.703221821957433	7.0	10	36	0.39641562303546046	0.2777777777777778
10087715849	6	1.5114696438797888	2.0	2	4	0.3778674109699472	0.5
10087715850	9	2.857731440393982	2.0	2	7	0.5715462880787964	0.2857142857142857
10087715851	11	2.483893752106227	4.0	5	6	0.4967787504212454	0.8333333333333334
10087715852	8	1.8519850277857866	2.0	3	5	0.46299625694644664	0.6
10087715853	5	1.7443764552096677	0.5	1	4	0.5814588184032226	0.25
10087715854	6	1.803405329929678	2.0	2	4	0.4508513324824195	0.5
10087715855	5	0.8366926518731916	1.0	2	3	0.4183463259365958	0.6666666666666666
10087715856	3	0.7393656838846142	1.0	1	2	0.3696828419423071	0.5
10087715857	4	0.28960748525863955	1.0	2	2	0.28960748525863955	1.0
10087715858	6	0.814585064007256	2.0	3	3	0.407292532003628	1.0
10087715859	4	0.8040345761167184	0.5	1	3	0.4020172880583592	0.3333333333333333
10087715860	8	1.9325922757766278	2.0	3	5	0.48314806894415696	0.6
10087715861	6	2.086198950008345	0.5	1	5	0.5215497375020862	0.2
10087715862	6	1.3446930075560384	1.0	2	4	0.4482310025186795	0.5
10087715863	11	5.815257945651432	1.0	2	9	0.726907243206429	0.2222222222222222
10087715864	4	0.2890472948760627	1.0	2	2	0.2890472948760627	1.0
10087715865	4	0.7412157127914212	2.0	2	2	0.3706078563957106	1.0
10087715866	1	0.20791329015151436	0.0	0	1	0.20791329015151436	0.0
10087715867	5	1.6595043126545148	0.5	1	4	0.8297521563272574	0.25
10087715868	4	1.2012564587462948	1.0	1	3	0.6006282293731474	0.3333333333333333
10087715869	3	1.9865644205303883	0.0	0	3	0.9932822102651941	0.0
10087715870	3	0.4159727725521662	1.0	1	2	0.2079863862760831	0.5
10087715871	1	0.20798365906001212	0.0	0	1	0.20798365906001212	0.0
10087715872	1	0.20798813708146197	0.0	0	1	0.20798813708146197	0.0
10087715873	2	0.2080024802178352	1.0	1	1	0.2080024802178352	1.0
10087715874	5	1.1172944656334916	2.0	2	3	0.3724314885444972	0.6666666666666666
10087715875	9	1.3613158945485881	4.0	4	5	0.27226317890971763	0.8
10087715876	6	1.8782343814608295	2.0	2	4	0.4695585953652074	0.5
10087715877	6	3.4102879411562395	0.0	0	6	0.5683813235260399	0.0
10087715878	6	3.89732576936028	0.0	0	6	0.64955429489338	0.0
10087715879	2	0.20819311598812915	1.0	1	1	0.20819311598812915	1.0
10087715880	3	0.41640565918209715	1.0	1	2	0.20820282959104858	0.5
11226435467	2	0.03223811815087882	1.0	1	1	0.03223811815087882	1.0
11226435468	10	0.33383602771619186	5.0	5	5	0.06676720554323837	1.0
11226435469	2	0.06455737939720242	0.0	0	2	0.03227868969860121	0.0
11226435470	3	0.06462512209763184	1.0	1	2	0.03231256104881592	0.5
11226435471	2	0.0323171064089342	1.0	1	1	0.0323171064089342	1.0
11226435472	31	10.300597627315284	0.0	0	31	0.3678784866898316	0.0
11226435473	43	1.0690789016268585	15.0	15	28	0.038181389343816374	0.5357142857142857
11226435474	10	0.768831873088697	5.0	5	5	0.1537663746177394	1.0
11226435475	12	0.8668762672506096	6.0	6	6	0.1444793778751016	1.0
11226435476	10	1.7216446042181546	2.0	2	8	0.28694076736969243	0.25
11226435477	6	1.520979816681923	1.0	1	5	0.3041959633363846	0.2
11226435478	5	3.1541228587944827	0.0	0	5	0.6308245717588965	0.0
11226435479	3	0.047827154567193	0.5	1	2	0.047827154567193	0.5
11226435480	4	0.5111236578014524	1.0	1	3	0.2555618289007262	0.3333333333333333
11226435481	2	0.03252269136361713	1.0	1	1	0.03252269136361713	1.0
11226435482	1	0.03253211877719577	0.0	0	1	0.03253211877719577	0.0
11226435483	9	1.9038226714280042	1.0	2	7	0.38076453428560086	0.2857142857142857
11226435484	5	0.10768453059409508	2.0	2	3	0.035894843531365024	0.6666666666666666
11226435485	4	0.06514201371641538	2.0	2	2	0.03257100685820769	1.0
11226435486	11	3.1088131940154646	0.6666666666666666	2	9	0.6217626388030929	0.2222222222222222
11226435487	3	0.06530288579526816	1.0	1	2	0.03265144289763408	0.5
11226435488	7	0.47895284464965826	3.0	3	4	0.11973821116241457	0.75
11226435489	16	0.6177980746999296	8.0	8	8	0.0772247593374912	1.0
11226435490	13	3.075602638153948	5.0	5	8	0.3844503297692435	0.625
11226435491	12	1.5620656634843646	5.0	5	7	0.2231522376406235	0.7142857142857143
11226435492	8	1.8356828075322476	2.0	2	6	0.3059471345887079	0.3333333333333333
11226435493	3	1.6905956532822197	0.0	0	3	0.8452978266411099	0.0
11226435494	2	0.8255119077155871	0.0	0	2	0.41275595385779357	0.0
11226435495	7	1.2634918998484106	3.0	3	4	0.31587297496210265	0.75
11226435496	7	3.063927830186154	0.5	1	6	0.6127855660372308	0.16666666666666666
11226435497	6	2.092915005772439	0.5	1	5	0.5232287514431098	0.2
11226435498	1	0.03283850971850181	0.0	0	1	0.03283850971850181	0.0
11226435499	4	1.2852786862979984	0.0	0	4	0.42842622876599945	0.0
11226435500	6	0.14158534147623936	2.0	2	4	0.03539633536905984	0.5
11226435501	4	0.6530855907808246	1.0	1	3	0.21769519692694153	0.3333333333333333
11226435502	7	0.13168928443473077	3.0	3	4	0.03292232110868269	0.75
11226435503	3	0.06592246888339054	1.0	1	2	0.03296123444169527	0.5
11226435504	2	0.032987597530381274	1.0	1	1	0.032987597530381274	1.0
11226435505	2	0.032987866885054944	1.0	1	1	0.032987866885054944	1.0
11226435506	47	1.4389165720025272	13.0	13	34	0.04232107564713315	0.38235294117647056
11226435507	6	0.9141607394890146	1.0	2	4	0.4570803697445073	0.5
11226435508	7	1.6683869900749873	0.5	1	6	0.5561289966916624	0.16666666666666666
11226435509	4	0.8079120376522817	0.5	1	3	0.40395601882614085	0.3333333333333333
11226435510	1	0.03313921054232644	0.0	0	1	0.03313921054232644	0.0
11226435511	2	0.033169411935112324	1.0	1	1	0.033169411935112324	1.0
11226435512	10	0.7876865992379889	4.0	4	6	0.13128109987299816	0.6666666666666666
11226435513	2	0.033236615926194396	1.0	1	1	0.033236615926194396	1.0
11226435514	11	0.7063277843689242	5.0	5	6	0.11772129739482069	0.8333333333333334
11226435515	7	0.43552280412221733	3.0	3	4	0.10888070103055433	0.75
11226435516	12	1.58258274567158	5.0	5	7	0.22608324938165428	0.7142857142857143
11226435517	10	1.6309818075496545	5.0	5	5	0.3261963615099309	1.0
11226435518	11	2.710822438469881	1.8333333333333333	3	8	0.5421644876939762	0.375
11226435519	1	0.03334425678766202	0.0	0	1	0.03334425678766202	0.0
11226435520	10	6.937436552244016	0.5	1	9	0.867179569030502	0.1111111111111111
11226435521	3	0.11473677466027053	0.5	1	2	0.11473677466027053	0.5
11226435522	1	0.033375939631153116	0.0	0	1	0.033375939631153116	0.0
11226435523	1	0.033387151519444866	0.0	0	1	0.033387151519444866	0.0
11226435524	40	1.2208652769738757	11.0	11	29	0.04209880265427158	0.3793103448275862
11226435525	4	0.06685702859304235	2.0	2	2	0.033428514296521175	1.0
11226435526	6	0.10038949695893523	3.0	3	3	0.03346316565297841	1.0
11226435527	2	0.06694133660590283	0.0	0	2	0.033470668302951416	0.0
11226435528	3	0.067018843413253	1.0	1	2	0.0335094217066265	0.5
11226435529	11	4.492435594856498	3.0	3	8	0.5615544493570622	0.375
11226435530	10	1.5526258932600627	1.0	2	8	0.25877098221001044	0.25
11226435531	12	2.029957896160878	4.333333333333333	5	7	0.4059915792321756	0.7142857142857143
11226435532	8	1.4990021251073673	4.0	4	4	0.3747505312768418	1.0
11226435533	10	1.2693493202514952	4.0	5	5	0.3173373300628738	1.0
11226435534	10	1.749560286912558	5.0	5	5	0.3499120573825116	1.0
11226435535	1	0.0336333416911844	0.0	0	1	0.0336333416911844	0.0
11226435536	3	0.06734179966699008	1.0	1	2	0.03367089983349504	0.5
11226435537	4	0.14806796774625927	2.0	2	2	0.07403398387312964	1.0
11226435538	1	0.0336618596172598	0.0	0	1	0.0336618596172598	0.0
11226435539	4	0.39528202393909867	0.5	1	3	0.19764101196954934	0.3333333333333333
11226435540	1	0.033677852551009295	0.0	0	1	0.033677852551009295	0.0
11226435541	3	1.4506483821531386	0.0	0	3	0.4835494607177129	0.0
11226435542	10	0.20423515107447093	5.0	5	5	0.040847030214894185	1.0
11226435543	4	0.927627294746099	1.0	1	3	0.30920909824869963	0.3333333333333333
11226435544	9	0.34931510008697797	4.0	4	5	0.0698630200173956	0.8
11226435545	2	0.03379337203668193	1.0	1	1	0.03379337203668193	1.0
11226435546	15	3.8907748953498174	7.0	7	8	0.48634686191872717	0.875
11226435547	17	2.770317364114018	7.5	8	9	0.34628967051425225	0.8888888888888888
11226435548	3	0.1251220134585083	0.5	1	2	0.1251220134585083	0.5
11226435549	8	0.8972147952347252	4.0	4	4	0.2243036988086813	1.0
11226435550	3	0.05370460822413218	0.5	1	2	0.05370460822413218	0.5
11226435551	1	0.03392394171474619	0.0	0	1	0.03392394171474619	0.0
11226435552	1	0.033944311661942915	0.0	0	1	0.033944311661942915	0.0
11226435553	2	0.033952156616813715	1.0	1	1	0.033952156616813715	1.0
11226435554	6	0.14511631189345325	2.0	2	4	0.03627907797336331	0.5
11226435555	41	1.2254743394724765	12.0	12	29	0.0422577358438785	0.41379310344827586
11226435556	5	0.9176187147896624	2.0	2	3	0.30587290492988745	0.6666666666666666
11226435557	9	0.3505911005148479	4.0	4	5	0.07011822010296957	0.8
11226435558	6	0.14597346580375756	2.0	2	4	0.03649336645093939	0.5
11226435559	11	4.619352419513709	3.0	3	8	0.5774190524392137	0.375
11226435560	10	0.3515319563899969	5.0	5	5	0.07030639127799938	1.0
11226435561	2	0.03423332922679687	1.0	1	1	0.03423332922679687	1.0
11226435562	48	1.540965024396631	14.0	14	34	0.045322500717547974	0.4117647058823529
11226435563	8	1.285279730047359	0.6666666666666666	2	6	0.6426398650236795	0.3333333333333333
11226435564	3	0.9076023235476893	0.0	0	3	0.45380116177384466	0.0
11226435565	3	0.10306038423376862	0.0	0	3	0.034353461411256205	0.0
11226435566	4	0.1745278557681142	0.5	1	3	0.0872639278840571	0.3333333333333333
11226435567	1	0.034359521891413905	0.0	0	1	0.034359521891413905	0.0
11226435568	3	0.0687831165258284	1.0	1	2	0.0343915582629142	0.5
11226435569	3	0.9937197937672473	0.0	0	3	0.3312399312557491	0.0
11226435570	2	0.3850575225423768	0.0	0	2	0.1925287612711884	0.0
11226435571	5	0.17396689099085047	2.0	2	3	0.057988963663616826	0.6666666666666666
11226435572	11	0.38741417392103333	5.0	5	6	0.06456902898683889	0.8333333333333334
11226435573	4	0.06903627624974928	2.0	2	2	0.03451813812487464	1.0
11226435574	1	0.03461682294344256	0.0	0	1	0.03461682294344256	0.0
11226435575	2	0.0346280348317343	1.0	1	1	0.0346280348317343	1.0
11226435576	2	0.03464126688007862	1.0	1	1	0.03464126688007862	1.0
11226435577	1	0.03465247876837037	0.0	0	1	0.03465247876837037	0.0
11226435578	3	0.06935047847659193	1.0	1	2	0.03467523923829596	0.5
11226435579	3	1.3600323521898552	0.0	0	3	0.4533441173966184	0.0
11226435580	46	1.3988206036258435	14.0	14	32	0.04371314386330761	0.4375
11226435581	7	2.6559250267427106	2.0	2	5	0.5311850053485421	0.4
11226435582	11	0.38892993367780876	5.0	5	6	0.06482165561296813	0.8333333333333334
11226435583	2	0.06951060983009208	0.0	0	2	0.03475530491504604	0.0
11226435584	2	0.03478924360392917	1.0	1	1	0.03478924360392917	1.0
11226435585	3	0.1967111659666868	0.5	1	2	0.1967111659666868	0.5
11226435586	2	0.8271558802970322	0.0	0	2	0.8271558802970322	0.0
11226435587	3	0.4896605009922858	0.5	1	2	0.4896605009922858	0.5
11226435588	3	1.6543715236622862	0.0	0	3	0.8271857618311431	0.0
11226435589	3	0.5642635976215579	0.5	1	2	0.5642635976215579	0.5
11226435590	3	1.0110075827717653	0.0	0	3	0.5055037913858826	0.0
11226435591	2	0.034959105395015865	1.0	1	1	0.034959105395015865	1.0
11226435592	2	0.8983032238017143	0.0	0	2	0.4491516119008572	0.0
11226435593	5	0.11344710448271159	2.0	2	3	0.03781570149423719	0.6666666666666666
11226435594	4	0.0699996232401502	2.0	2	2	0.0349998116200751	1.0
11226435595	10	0.3553795532261165	5.0	5	5	0.0710759106452233	1.0
11226435596	3	0.07014817234268231	1.0	1	2	0.035074086171341154	0.5
11226435597	15	3.0578095061122803	7.0	7	8	0.38222618826403504	0.875
11226435598	2	0.5019621982937257	0.0	0	2	0.5019621982937257	0.0
11226435599	6	4.3564881833936315	0.0	0	6	0.7260813638989386	0.0
11226435600	15	3.1289670514252284	5.5	6	9	0.39112088142815354	0.6666666666666666
11226435601	3	0.19832247929394867	0.5	1	2	0.19832247929394867	0.5
11226435602	1	0.035183107475511365	0.0	0	1	0.035183107475511365	0.0
11226435603	3	0.07040473266935834	1.0	1	2	0.03520236633467917	0.5
11226435604	1	0.03520580060676854	0.0	0	1	0.03520580060676854	0.0
11226435605	1	0.035210884676234164	0.0	0	1	0.035210884676234164	0.0
11226435606	2	0.3945712306246028	0.0	0	2	0.1972856153123014	0.0
11226435607	6	0.1496115047037575	2.0	2	4	0.037402876175939376	0.5
11226435608	30	0.911997282750052	10.0	10	20	0.045599864137502596	0.5
11226435609	2	0.03526384653894564	1.0	1	1	0.03526384653894564	1.0
11226435610	9	0.3566086859407668	4.0	4	5	0.07132173718815335	0.8
11226435611	3	0.07066668008950791	1.0	1	2	0.035333340044753955	0.5
11226435612	10	6.404941654915789	0.5	1	9	0.8006177068644736	0.1111111111111111
11226435613	3	1.1783960919061043	0.0	0	3	0.5891980459530521	0.0
11226435614	2	0.8022434348754438	0.0	0	2	0.8022434348754438	0.0
11226435615	3	0.2995606791603016	0.5	1	2	0.2995606791603016	0.5
11226435616	3	0.6026618571593984	0.5	1	2	0.6026618571593984	0.5
11226435617	2	0.035514447393466604	1.0	1	1	0.035514447393466604	1.0
11226435618	9	0.3577901765475108	4.0	4	5	0.07155803530950215	0.8
11226435619	3	0.25976985595955804	1.0	1	2	0.12988492797977902	0.5
11226435620	31	15.676484936323043	0.0	0	31	0.5806105531971497	0.0
11226435621	48	5.966740185902536	16.0	16	32	0.18646063080945424	0.5
11226435622	7	4.334133698299937	0.0	0	7	0.8668267396599875	0.0
11226435623	13	5.7289055644870945	1.3333333333333333	2	11	0.8184150806410135	0.18181818181818182
11226435624	2	0.8651319263838863	0.0	0	2	0.8651319263838863	0.0
11226435625	4	0.7163228965916769	0.5	1	3	0.35816144829583846	0.3333333333333333
11226435626	4	1.421101588562958	0.5	1	3	0.710550794281479	0.3333333333333333
11226435627	1	0.03572073940416794	0.0	0	1	0.03572073940416794	0.0
11226435628	13	0.922790391862903	2.5	5	8	0.1845580783725806	0.625
11226435629	3	0.107377331588768	0.0	0	3	0.035792443862922664	0.0
11226435630	41	13.935797259700026	7.0	7	34	0.42229688665757653	0.20588235294117646
11226435631	3	0.8676252079207647	0.0	0	3	0.43381260396038235	0.0
11226435632	22	3.4867859479148193	3.5	6	16	0.34867859479148194	0.375
11226435633	14	0.5829522329451944	3.0	3	11	0.05299565754047222	0.2727272727272727
11226435634	8	0.8112672541449224	4.0	4	4	0.2028168135362306	1.0
11226435635	14	2.92128665205844	6.0	6	8	0.365160831507305	0.75
11226435636	3	0.22299371760526052	0.5	1	2	0.22299371760526052	0.5
11226435637	9	3.7913019450067313	1.5	2	7	0.6318836575011219	0.2857142857142857
11226435638	2	0.7856817924018211	0.0	0	2	0.7856817924018211	0.0
11226435639	8	4.753166104259719	0.5	1	7	0.7921943507099533	0.14285714285714285
11226435640	1	0.03599827572605647	0.0	0	1	0.03599827572605647	0.0
11226435641	1	0.03600612068092727	0.0	0	1	0.03600612068092727	0.0
11226435642	6	0.8186858879059651	2.0	2	4	0.20467147197649127	0.5
11226435643	14	0.38427067020190186	5.0	5	9	0.04269674113354465	0.5555555555555556
11226435644	14	0.5834880803991378	4.5	6	8	0.0972480133998563	0.75
11226435645	3	0.07218247351561753	1.0	1	2	0.036091236757808766	0.5
11226435646	27	0.9307488797286602	8.0	8	19	0.04898678314361369	0.42105263157894735
11226435647	1	0.03620288427004732	0.0	0	1	0.03620288427004732	0.0
11226435648	3	0.35496383795663233	0.5	1	2	0.35496383795663233	0.5
11226435649	4	0.16411494077715627	1.0	1	3	0.05470498025905209	0.3333333333333333
11226435650	2	0.3565726260838285	0.0	0	2	0.17828631304191425	0.0
11226435651	11	0.22721464001909455	5.0	5	6	0.03786910666984909	0.8333333333333334
11226435652	3	0.1088973000123196	0.0	0	3	0.036299100004106535	0.0
11226435653	3	0.1343478824025777	1.0	1	2	0.06717394120128885	0.5
11226435654	30	1.1274642880314574	9.0	9	21	0.05368877562054559	0.42857142857142855
11226435655	3	0.5593390871307489	0.5	1	2	0.5593390871307489	0.5
11226435656	6	0.6280996452026568	1.0	2	4	0.3140498226013284	0.5
11226435657	2	0.21761810537471327	0.0	0	2	0.10880905268735663	0.0
11226435658	3	0.2820426592484594	0.5	1	2	0.2820426592484594	0.5
11226435659	1	0.03645739076733658	0.0	0	1	0.03645739076733658	0.0
11226435660	3	1.3177185847687944	0.0	0	3	0.43923952825626483	0.0
11226435661	12	1.3703052027505018	5.0	5	7	0.19575788610721453	0.7142857142857143
11226435662	3	0.10959620805183945	0.0	0	3	0.03653206935061315	0.0
11226435663	4	0.07311551810522994	2.0	2	2	0.03655775905261497	1.0
11226435664	22	0.5744304234487789	8.0	8	14	0.04103074453205564	0.5714285714285714
11226435665	8	0.8321952032174954	4.0	4	4	0.20804880080437385	1.0
11226435666	12	1.1509268982526524	6.0	6	6	0.1918211497087754	1.0
11226435667	10	1.8353586055131448	4.0	4	6	0.367071721102629	0.6666666666666666
11226435668	2	0.8901747057981995	0.0	0	2	0.8901747057981995	0.0
11226435669	4	0.6251529724113138	0.3333333333333333	1	3	0.6251529724113138	0.3333333333333333
11226435670	4	0.48436343931844916	0.3333333333333333	1	3	0.48436343931844916	0.3333333333333333
11226435671	2	0.03671300835265476	1.0	1	1	0.03671300835265476	1.0
11226435672	1	0.036720853307525565	0.0	0	1	0.036720853307525565	0.0
11226435673	9	0.43887923271088947	2.0	2	7	0.06269703324441278	0.2857142857142857
11226435674	10	1.6327036236317918	4.0	4	6	0.2721172706052986	0.6666666666666666
11226435675	3	0.11039982772075072	0.0	0	3	0.03679994257358357	0.0
11226435676	3	0.13442431179123315	1.0	1	2	0.06721215589561658	0.5
11226435677	5	0.9688762694727857	1.0	1	4	0.24221906736819643	0.25
11226435678	26	0.9064019444444539	8.0	8	18	0.050355663580247435	0.4444444444444444
11226435679	11	0.4030696062644086	5.0	5	6	0.06717826771073476	0.8333333333333334
11226435680	3	0.11088739334943783	0.0	0	3	0.03696246444981261	0.0
11226435681	4	0.33751928453203517	1.0	1	3	0.11250642817734506	0.3333333333333333
11226435682	31	1.241084385553337	9.0	9	22	0.05641292661606078	0.4090909090909091
11226435683	16	1.1856007233789116	8.0	8	8	0.14820009042236396	1.0
11226435684	11	4.28373410559114	3.0	3	8	0.5354667631988925	0.375
11226435685	9	0.7795932320193887	4.0	4	5	0.15591864640387773	0.8
11226435686	1	0.03708724300239285	0.0	0	1	0.03708724300239285	0.0
11226435687	8	1.351807034850488	4.0	4	4	0.337951758712622	1.0
11226435688	2	0.03711478451777618	1.0	1	1	0.03711478451777618	1.0
11226435689	1	0.03712599640606793	0.0	0	1	0.03712599640606793	0.0
11226435690	2	0.03714606332925676	1.0	1	1	0.03714606332925676	1.0
11226435691	1	0.037157005862874834	0.0	0	1	0.037157005862874834	0.0
11226435692	3	0.07433744558235944	1.0	1	2	0.03716872279117972	0.5
11226435693	1	0.03717215706326909	0.0	0	1	0.03717215706326909	0.0
11226435694	10	0.36722045201956577	5.0	5	5	0.07344409040391316	1.0
11226435695	3	0.11170097914127508	0.0	0	3	0.03723365971375836	0.0
11226435696	3	0.13443919363695372	1.0	1	2	0.06721959681847686	0.5
11226435697	22	0.6213173955275071	7.0	7	15	0.041421159701833805	0.4666666666666667
11226435698	2	0.037348180342516114	1.0	1	1	0.037348180342516114	1.0
11226435699	4	1.0306422927173533	1.0	1	3	0.5153211463586767	0.3333333333333333
11226435700	1	0.03737602488190733	0.0	0	1	0.03737602488190733	0.0
11226435701	3	0.07477322777503242	1.0	1	2	0.03738661388751621	0.5
11226435702	13	0.6762788126590097	3.0	3	10	0.06762788126590097	0.3
11226435703	9	0.18728772536947633	4.0	4	5	0.03745754507389527	0.8
11226435704	3	0.11236995514268272	0.0	0	3	0.03745665171422757	0.0
11226435705	3	0.07496504197202368	1.0	1	2	0.03748252098601184	0.5
11226435706	24	0.8455414579434495	8.0	8	16	0.05284634112146559	0.5
11226435707	9	0.18836800595758668	4.0	4	5	0.03767360119151734	0.8
11226435708	3	0.11301842651955682	0.0	0	3	0.03767280883985227	0.0
11226435709	7	0.8950508671250836	3.0	3	4	0.2237627167812709	0.75
11226435710	32	1.9419176712726207	9.0	9	23	0.0844312030988096	0.391304347826087
11226435711	21	1.789312289370958	6.0	6	15	0.11928748595806388	0.4
11226435712	2	0.5111661485012248	0.0	0	2	0.5111661485012248	0.0
11226435713	13	1.261344234027192	6.0	6	7	0.18019203343245602	0.8571428571428571
11226435714	7	1.882291536233069	0.5	1	6	0.3764583072466138	0.16666666666666666
11226435715	12	5.256684465511272	2.5	3	9	0.657085558188909	0.3333333333333333
11226435716	9	3.666232388370922	0.5	1	8	0.7332464776741844	0.125
11226435717	7	3.8668969402218147	0.0	0	7	0.7733793880443629	0.0
11226435718	4	2.1101456579168034	0.0	0	4	0.7033818859722678	0.0
11226435719	6	1.6795255465568273	0.5	1	5	0.5598418488522757	0.2
11226435720	1	0.03783163831242967	0.0	0	1	0.03783163831242967	0.0
11226435721	4	0.5288126842617444	0.3333333333333333	1	3	0.5288126842617444	0.3333333333333333
11226435722	3	0.11374679522650993	0.0	0	3	0.03791559840883665	0.0
11226435723	6	0.4046921314799622	2.0	2	4	0.10117303286999055	0.5
11438831504	3	1.2003461072879396	1.0	1	2	0.6001730536439698	0.5
11438831505	2	0.6001874641190114	1.0	1	1	0.6001874641190114	1.0
11438831506	25	11.667879222845775	6.0	6	19	0.6140989064655671	0.3157894736842105
11438831507	1	0.6002904922816923	0.0	0	1	0.6002904922816923	0.0
11438831508	1	0.6003017041699841	0.0	0	1	0.6003017041699841	0.0
11438831509	3	1.2006557641546638	1.0	1	2	0.6003278820773319	0.5
11438831510	5	3.205942859705574	0.0	0	5	0.6411885719411148	0.0
11438831511	2	1.2008462315782866	0.0	0	2	0.6004231157891433	0.0
11438831512	2	0.6004532161739267	1.0	1	1	0.6004532161739267	1.0
11438831513	19	7.2507391681459	7.0	7	12	0.6042282640121583	0.5833333333333334
11438831514	5	2.403445995751536	1.0	1	4	0.600861498937884	0.25
11438831515	11	4.979063195892529	3.0	3	8	0.6223828994865661	0.375
11438831516	2	1.201326928662795	0.0	0	2	0.6006634643313975	0.0
11438831517	3	1.2013958497899218	1.0	1	2	0.6006979248949609	0.5
11438831518	30	12.878147312562563	9.0	9	21	0.6132451101220268	0.42857142857142855
11438831519	9	4.894463572928467	0.5	1	8	0.6992090818469239	0.125
11438831520	28	11.593944967540573	9.0	9	19	0.6102076298705564	0.47368421052631576
11438831521	5	3.217850693135432	0.0	0	5	0.6435701386270865	0.0
11438831522	3	1.8035262028394898	0.0	0	3	0.6011754009464966	0.0
11438831523	5	2.5282206090196713	1.0	1	4	0.6320551522549178	0.25
11438831524	23	9.665381294940776	7.0	7	16	0.6040863309337985	0.4375
11438831525	1	0.6013613117868898	0.0	0	1	0.6013613117868898	0.0
11438831526	1	0.6013725236751816	0.0	0	1	0.6013725236751816	0.0
11438831527	8	3.0072052711901573	3.0	3	5	0.6014410542380315	0.6
11438831528	3	1.804318206588099	0.0	0	3	0.601439402196033	0.0
11438831529	2	1.202937299248699	0.0	0	2	0.6014686496243495	0.0
11438831530	18	7.21994876402736	6.0	6	12	0.60166239700228	0.5
11438831531	1	0.6015769302031672	0.0	0	1	0.6015769302031672	0.0
11438831532	2	0.6015881420914589	1.0	1	1	0.6015881420914589	1.0
11438831533	2	1.511510013411506	0.0	0	2	0.755755006705753	0.0
11438831534	6	3.163672660402981	1.0	1	5	0.6327345320805962	0.2
11438831535	2	0.601652450519799	1.0	1	1	0.601652450519799	1.0
11438831536	1	0.6016636960774249	0.0	0	1	0.6016636960774249	0.0
11438831537	2	1.2034135519810918	0.0	0	2	0.6017067759905459	0.0
11438831538	2	0.6017492498556511	1.0	1	1	0.6017492498556511	1.0
11438831539	23	9.081683656605517	8.0	8	15	0.6054455771070344	0.5333333333333333
11438831540	12	7.798550683307354	1.0	1	11	0.7089591530279413	0.09090909090909091
11438831541	10	3.875849885542782	1.0	2	8	0.645974980923797	0.25
11438831542	4	2.461622564945368	0.0	0	4	0.615405641236342	0.0
11438831543	4	1.2039176492528758	2.0	2	2	0.6019588246264379	1.0
11438831544	25	11.70629088277863	6.0	6	19	0.6161205727778226	0.3157894736842105
11438831545	6	3.8243010574494125	0.0	0	6	0.6373835095749021	0.0
11438831546	3	1.80636631218806	0.0	0	3	0.6021221040626866	0.0
11438831547	30	12.259472219045145	10.0	10	20	0.6129736109522572	0.5
11438831548	10	3.443051199912783	1.0	2	8	0.6886102399825565	0.25
11438831549	3	1.8071056907672995	0.0	0	3	0.6023685635890998	0.0
11438831550	24	10.455877633787878	7.0	7	17	0.615051625516934	0.4117647058823529
11438831551	1	0.6025091667287585	0.0	0	1	0.6025091667287585	0.0
11438831552	3	1.811169478398378	0.0	0	3	0.905584739199189	0.0
11438831553	5	3.224224567455956	0.0	0	5	0.6448449134911912	0.0
11438831554	3	1.8077979322786462	0.0	0	3	0.6025993107595488	0.0
11438831555	13	6.789210978344322	2.0	2	11	0.617200998031302	0.18181818181818182
11438831556	3	0.6606459387695549	0.5	1	2	0.6606459387695549	0.5
11438831557	2	0.6027557272631744	1.0	1	1	0.6027557272631744	1.0
11438831558	3	2.4873119639231738	0.0	0	3	0.8291039879743912	0.0
11438831559	1	0.6027700030608791	0.0	0	1	0.6027700030608791	0.0
11438831560	15	7.499113200240925	3.0	3	12	0.6249261000200771	0.25
11438831561	6	3.8282189895246956	0.0	0	6	0.6380364982541159	0.0
11438831562	3	1.8085477820208247	0.0	0	3	0.6028492606736082	0.0
11438831563	29	13.917490905997006	7.0	7	22	0.6326132229998639	0.3181818181818182
11438831564	1	0.6029569352044101	0.0	0	1	0.6029569352044101	0.0
11438831565	1	0.6029647801592809	0.0	0	1	0.6029647801592809	0.0
11438831566	3	1.3404174061434482	1.0	1	2	0.6702087030717241	0.5
11438831567	1	0.6029868672425223	0.0	0	1	0.6029868672425223	0.0
11438831568	3	1.2060287165078085	1.0	1	2	0.6030143582539043	0.5
11438831569	2	0.6030368998731576	1.0	1	1	0.6030368998731576	1.0
11438831570	1	0.603084878674406	0.0	0	1	0.603084878674406	0.0
11438831571	26	13.59445485593784	4.0	4	22	0.6179297661789928	0.18181818181818182
11438831572	2	0.6033071636188568	1.0	1	1	0.6033071636188568	1.0
11438831573	2	0.6033290150167587	1.0	1	1	0.6033290150167587	1.0
11438831574	6	3.831068122254834	0.0	0	6	0.638511353709139	0.0
11438831575	20	10.091258373521331	4.0	4	16	0.6307036483450832	0.25
11438831576	11	4.988740368592342	3.0	3	8	0.6235925460740428	0.375
11438831577	5	3.228534578928108	0.0	0	5	0.6457069157856216	0.0
11438831578	1	0.603605069887942	0.0	0	1	0.603605069887942	0.0
11438831579	25	11.081432079340304	7.0	7	18	0.6156351155189058	0.3888888888888889
11438831580	3	1.8115561370324396	0.0	0	3	0.6038520456774799	0.0
11438831581	28	12.34650068044041	8.0	8	20	0.6173250340220205	0.4
11438831582	4	1.81261234404659	1.0	1	3	0.6042041146821967	0.3333333333333333
11438831583	6	3.834955112211979	0.0	0	6	0.6391591853686632	0.0
11438831584	28	12.35047369554646	8.0	8	20	0.617523684777323	0.4
11438831585	3	1.2086650253764089	1.0	1	2	0.6043325126882044	0.5
11438831586	5	3.2360329416725584	0.0	0	5	0.6472065883345117	0.0
11438831587	1	0.6043109811489775	0.0	0	1	0.6043109811489775	0.0
11438831588	18	7.410817425106017	6.0	6	12	0.6175681187588348	0.5
11438831589	2	0.6043888919883381	1.0	1	1	0.6043888919883381	1.0
11438831590	14	6.860124521992255	3.0	3	11	0.6236476838174777	0.2727272727272727
11438831591	6	3.2369156506075276	1.0	1	5	0.6473831301215055	0.2
11438831592	5	3.023103021731838	0.0	0	5	0.6046206043463676	0.0
11438831593	1	0.6046111095941206	0.0	0	1	0.6046111095941206	0.0
11438831594	6	3.5104178812177538	1.0	1	5	0.7020835762435508	0.2
11438831595	13	7.287241473805073	1.0	1	12	0.6072701228170895	0.08333333333333333
11438831596	2	1.212167275851542	0.0	0	2	0.606083637925771	0.0
11438831597	6	3.64001128326728	0.0	0	6	0.6066685472112133	0.0
11438831598	22	12.149607565391653	2.0	2	20	0.6074803782695827	0.1
11438831599	23	11.522354367251024	4.0	4	19	0.6064397035395276	0.21052631578947367
11438831600	6	3.647050194277109	0.0	0	6	0.6078416990461849	0.0
11438831601	2	0.6073747222153668	1.0	1	1	0.6073747222153668	1.0
11438831602	2	1.2154522581130216	0.0	0	2	0.6077261290565108	0.0
11438831603	2	1.2395500066547438	0.0	0	2	0.6197750033273719	0.0
11438831604	1	0.6102501506955226	0.0	0	1	0.6102501506955226	0.0
11438831605	24	11.17930964195121	6.0	6	18	0.6210727578861783	0.3333333333333333
11438831606	3	1.2210063514842133	1.0	1	2	0.6105031757421067	0.5
11438831607	2	1.5208237256485277	0.0	0	2	0.7604118628242639	0.0
11438831608	2	0.6104650283864473	1.0	1	1	0.6104650283864473	1.0
11438831609	9	3.288544241353639	2.0	3	6	0.6577088482707278	0.5
11438831610	2	1.2209909645984796	0.0	0	2	0.6104954822992398	0.0
11438831611	3	1.2214685977735749	1.0	1	2	0.6107342988867874	0.5
11438831612	3	1.2213476911944288	1.0	1	2	0.6106738455972144	0.5
11438831613	1	0.6106713203971487	0.0	0	1	0.6106713203971487	0.0
11438831614	3	1.2213739869444464	1.0	1	2	0.6106869934722232	0.5
11438831615	1	0.6106802764400484	0.0	0	1	0.6106802764400484	0.0
11438831616	3	1.2213783639578937	1.0	1	2	0.6106891819789468	0.5
11438831617	2	0.6107478507938068	1.0	1	1	0.6107478507938068	1.0
11438831618	6	3.8735500343309366	0.0	0	6	0.6455916723884895	0.0
11438831619	2	1.2215851946779424	0.0	0	2	0.6107925973389712	0.0
11438831620	3	1.2216486277035927	1.0	1	2	0.6108243138517964	0.5
11438831621	9	4.421369899487273	2.0	2	7	0.6316242713553247	0.2857142857142857
11438831622	3	1.2219776107681533	1.0	1	2	0.6109888053840766	0.5
11438831623	17	7.332745343303811	5.0	5	12	0.6110621119419842	0.4166666666666667
11438831624	3	1.833221511862868	0.0	0	3	0.6110738372876227	0.0
11438831625	17	8.281934008306965	4.0	4	13	0.6370718467928435	0.3076923076923077
11438831626	1	0.6112157872006497	0.0	0	1	0.6112157872006497	0.0
11438831627	1	0.6112160565553234	0.0	0	1	0.6112160565553234	0.0
11438831628	2	1.222467162887559	0.0	0	2	0.6112335814437795	0.0
11438831629	1	0.6112345746891387	0.0	0	1	0.6112345746891387	0.0
11438831630	1	0.6112491871801855	0.0	0	1	0.6112491871801855	0.0
11438831631	14	6.1606757192956625	4.0	4	10	0.6160675719295663	0.4
11438831632	10	7.762048411317515	0.0	0	10	0.7762048411317515	0.0
11438831633	3	1.8340051992859272	0.0	0	3	0.6113350664286424	0.0
11438831634	3	1.2227324435717952	1.0	1	2	0.6113662217858976	0.5
11438831635	26	13.082252297990982	5.0	5	21	0.6229643951424277	0.23809523809523808
11438831636	2	1.2231715253592206	0.0	0	2	0.6115857626796103	0.0
11438831637	2	0.6116159809070633	1.0	1	1	0.6116159809070633	1.0
11438831638	30	13.084511577655105	9.0	9	21	0.6230719798883383	0.42857142857142855
11438831639	6	3.879092680128497	0.0	0	6	0.6465154466880828	0.0
11438831640	2	1.2235119896667466	0.0	0	2	0.6117559948333733	0.0
11438831641	3	1.2235854898233258	1.0	1	2	0.6117927449116629	0.5
11438831642	15	6.779045532959803	4.0	4	11	0.6162768666327094	0.36363636363636365
11438831643	1	0.6119314625686059	0.0	0	1	0.6119314625686059	0.0
11438831644	13	5.6507997460120105	4.0	4	9	0.627866638445779	0.4444444444444444
11438831645	5	3.268466813332531	0.0	0	5	0.6536933626665062	0.0
11438831646	2	1.2240464566779874	0.0	0	2	0.6120232283389937	0.0
11438831647	29	12.433789540466448	9.0	9	20	0.6216894770233223	0.45
11438831648	6	3.8815758608651127	0.0	0	6	0.6469293101441854	0.0
11438831649	2	1.2244353038187725	0.0	0	2	0.6122176519093863	0.0
11438831650	2	0.6122540821290009	1.0	1	1	0.6122540821290009	1.0
11438831651	29	13.098835623515837	8.0	8	21	0.623754077310278	0.38095238095238093
11438831652	1	0.6123412520352691	0.0	0	1	0.6123412520352691	0.0
11438831653	1	0.6123724971774155	0.0	0	1	0.6123724971774155	0.0
11438831654	1	0.6123837090657073	0.0	0	1	0.6123837090657073	0.0
11438831655	2	1.225095054422607	0.0	0	2	0.6125475272113035	0.0
11438831656	2	1.2249107484871442	0.0	0	2	0.6124553742435721	0.0
11438831657	4	1.2249922619452653	2.0	2	2	0.6124961309726327	1.0
11438831658	22	9.89679594871716	6.0	6	16	0.6185497467948226	0.375
11438831659	3	1.2256349758659897	1.0	1	2	0.6128174879329948	0.5
11438831660	1	0.6127290217573594	0.0	0	1	0.6127290217573594	0.0
11438831661	3	1.2257365899166337	1.0	1	2	0.6128682949583169	0.5
11438831662	3	1.2276649336948118	1.0	1	2	0.6138324668474059	0.5
11438831663	1	0.612889388796199	0.0	0	1	0.612889388796199	0.0
11438831664	3	1.225810258419884	1.0	1	2	0.612905129209942	0.5
11438831665	2	1.4392728945664663	0.0	0	2	0.7196364472832332	0.0
11438831666	1	0.6129259536931505	0.0	0	1	0.6129259536931505	0.0
11438831667	1	0.6129460206163394	0.0	0	1	0.6129460206163394	0.0
11438831668	5	3.0650310395908615	0.0	0	5	0.6130062079181723	0.0
11438831669	2	1.2260743943467571	0.0	0	2	0.6130371971733786	0.0
11438831670	2	0.613112650151342	1.0	1	1	0.613112650151342	1.0
11438831671	5	3.2743426171920937	0.0	0	5	0.6548685234384187	0.0
11438831672	2	1.2276118708240977	0.0	0	2	0.6138059354120489	0.0
11438831673	1	0.61335634879235	0.0	0	1	0.61335634879235	0.0
11438831674	4	2.4537062984247093	0.0	0	4	0.6134265746061773	0.0
11438831675	3	1.3044212515854468	1.0	1	2	0.6522106257927234	0.5
11438831676	2	0.6142525927996715	1.0	1	1	0.6142525927996715	1.0
11438831677	1	0.6142638046879633	0.0	0	1	0.6142638046879633	0.0
11438831678	1	0.6148053422593881	0.0	0	1	0.6148053422593881	0.0
11438831679	3	1.2305928526670002	1.0	1	2	0.6152964263335001	0.5
11438831680	2	1.3510849959783664	0.0	0	2	0.6755424979891832	0.0
11438831681	1	0.6157321580221717	0.0	0	1	0.6157321580221717	0.0
11438831682	2	1.5712557082568352	0.0	0	2	0.7856278541284176	0.0
11438831683	2	0.6162312385631584	1.0	1	1	0.6162312385631584	1.0
11438831684	4	2.465212423028114	0.0	0	4	0.6163031057570285	0.0
11438831685	2	1.2325857405588578	0.0	0	2	0.6162928702794289	0.0
11438831686	16	9.877407933983323	0.0	0	16	0.6173379958739577	0.0
11438831687	12	6.166011029333163	2.0	2	10	0.6166011029333163	0.2
11438831688	1	0.6165112664157785	0.0	0	1	0.6165112664157785	0.0
11438831689	27	14.804423221241498	3.0	3	24	0.6168509675517291	0.125
11438831690	20	11.120844425555202	2.0	2	18	0.6178246903086223	0.1111111111111111
11438831691	2	0.6178930895610687	1.0	1	1	0.6178930895610687	1.0
11438831692	1	0.6179045708040342	0.0	0	1	0.6179045708040342	0.0
11438831693	1	0.6196242993874505	0.0	0	1	0.6196242993874505	0.0
11438831694	2	0.6196674298045728	1.0	1	1	0.6196674298045728	1.0
11438831695	1	0.6197314688782392	0.0	0	1	0.6197314688782392	0.0
11438831696	1	0.6200314289767112	0.0	0	1	0.6200314289767112	0.0
11438831697	2	1.2430005073631971	0.0	0	2	0.6215002536815986	0.0
11438831698	2	1.2402796211270628	0.0	0	2	0.6201398105635314	0.0
11438831699	2	1.2403084757464802	0.0	0	2	0.6201542378732401	0.0
11438831700	2	1.2430375099614934	0.0	0	2	0.6215187549807467	0.0
11438831701	1	0.6201756347351303	0.0	0	1	0.6201756347351303	0.0
11438831702	7	4.6580960590818705	1.0	1	6	0.7763493431803118	0.16666666666666666
11438831703	2	1.2426493362073927	0.0	0	2	0.6213246681036964	0.0
11438831704	1	0.6202233105123708	0.0	0	1	0.6202233105123708	0.0
11438831705	4	2.835185208441966	0.0	0	4	0.7087963021104915	0.0
11438831706	25	13.084180271406481	4.0	4	21	0.6230562034003087	0.19047619047619047
11438831707	24	11.221070188541876	6.0	6	18	0.6233927882523265	0.3333333333333333
11438831708	27	12.477136081045051	7.0	7	20	0.6238568040522525	0.35
11438831709	17	9.347666885169422	2.0	2	15	0.6231777923446281	0.13333333333333333
11438831710	23	11.235993077180854	5.0	5	18	0.6242218376211586	0.2777777777777778
11438831711	15	7.482981077463812	3.0	3	12	0.6235817564553177	0.25
11438831712	21	10.597265066917632	4.0	4	17	0.623368533348096	0.23529411764705882
11438831713	1	0.6215942247933772	0.0	0	1	0.6215942247933772	0.0
11438831714	4	2.7320257690269534	0.0	0	4	0.6830064422567383	0.0
11438831715	2	1.2433989502642318	0.0	0	2	0.6216994751321159	0.0
11438831716	4	2.772866469407016	0.0	0	4	0.693216617351754	0.0
11438831717	1	0.621718936007289	0.0	0	1	0.621718936007289	0.0
11438831718	2	1.2435929529679468	0.0	0	2	0.6217964764839734	0.0
11438831719	2	1.2435926162746047	0.0	0	2	0.6217963081373024	0.0
11438831720	1	0.6218045234548495	0.0	0	1	0.6218045234548495	0.0
11438831721	2	1.4201260869429078	0.0	0	2	0.7100630434714539	0.0
11438831722	1	0.6218930401344861	0.0	0	1	0.6218930401344861	0.0
11438831723	3	1.9464032009840064	0.0	0	3	0.6488010669946688	0.0
11438831724	2	1.5731122016758103	0.0	0	2	0.7865561008379052	0.0
11438831725	1	0.6219453959491817	0.0	0	1	0.6219453959491817	0.0
11438831726	1	0.6219600757788971	0.0	0	1	0.6219600757788971	0.0
11438831727	1	0.621981119112778	0.0	0	1	0.621981119112778	0.0
11438831728	1	0.6219927350330803	0.0	0	1	0.6219927350330803	0.0
11438831729	1	0.6220043509533826	0.0	0	1	0.6220043509533826	0.0
11438831730	4	3.0287442176706296	0.0	0	4	0.7571860544176574	0.0
11438831731	2	1.5857066201688672	0.0	0	2	0.7928533100844336	0.0
11438831732	7	5.309884606100943	0.0	0	7	0.7585549437287061	0.0
11438831733	3	2.522120399047602	0.0	0	3	0.840706799682534	0.0
11438831734	1	0.6221641119442064	0.0	0	1	0.6221641119442064	0.0
11438831735	2	1.2444605443718562	0.0	0	2	0.6222302721859281	0.0
11438831736	1	0.6221867040674609	0.0	0	1	0.6221867040674609	0.0
11438831737	1	0.6221983199877632	0.0	0	1	0.6221983199877632	0.0
11438831738	1	0.622209531876055	0.0	0	1	0.622209531876055	0.0
11438831739	1	0.6222450866929802	0.0	0	1	0.6222450866929802	0.0
11438831740	2	1.244546064480748	0.0	0	2	0.622273032240374	0.0
11438831741	1	0.6223070719372598	0.0	0	1	0.6223070719372598	0.0
11438831742	2	1.2446690248892809	0.0	0	2	0.6223345124446404	0.0
11438831743	4	1.9164682336397254	1.0	1	3	0.6388227445465752	0.3333333333333333
11438831744	1	0.6223782152404443	0.0	0	1	0.6223782152404443	0.0
11438831745	1	0.6224144771133879	0.0	0	1	0.6224144771133879	0.0
11438831746	1	0.6224531295090604	0.0	0	1	0.6224531295090604	0.0
11438831747	1	0.6225022867370061	0.0	0	1	0.6225022867370061	0.0
11438831748	2	1.2450748750438416	0.0	0	2	0.6225374375219208	0.0
11438831749	1	0.6225298955910579	0.0	0	1	0.6225298955910579	0.0
11438831750	1	0.622545013122118	0.0	0	1	0.622545013122118	0.0
11438831751	1	0.622567369560033	0.0	0	1	0.622567369560033	0.0
11438831752	1	0.6225962241794506	0.0	0	1	0.6225962241794506	0.0
11438831753	1	0.6226044731663318	0.0	0	1	0.6226044731663318	0.0
11438831754	1	0.6226160890866341	0.0	0	1	0.6226160890866341	0.0
11438831755	1	0.6226628557918511	0.0	0	1	0.6226628557918511	0.0
11438831756	2	1.2453885048920026	0.0	0	2	0.6226942524460013	0.0
11438831757	1	0.6227270295428543	0.0	0	1	0.6227270295428543	0.0
11438831758	4	2.573758518215295	0.0	0	4	0.6434396295538237	0.0
11438831759	2	1.245614729148556	0.0	0	2	0.622807364574278	0.0
11438831760	2	1.24561924083934	0.0	0	2	0.62280962041967	0.0
11438831761	1	0.6228467240259689	0.0	0	1	0.6228467240259689	0.0
11438831762	3	1.2476387611745574	1.0	1	2	0.6238193805872787	0.5
11438831763	1	0.6258377056611315	0.0	0	1	0.6258377056611315	0.0
11438831764	2	0.6259189834339132	1.0	1	1	0.6259189834339132	1.0
11438831765	2	0.6259698577979037	1.0	1	1	0.6259698577979037	1.0
11438831766	2	0.6260304625994807	1.0	1	1	0.6260304625994807	1.0
11438831767	2	0.6261952066517675	1.0	1	1	0.6261952066517675	1.0
11438831768	2	0.6262593130641023	1.0	1	1	0.6262593130641023	1.0
11438831769	2	0.6263093793640718	1.0	1	1	0.6263093793640718	1.0
11438831770	2	0.6263742938404276	1.0	1	1	0.6263742938404276	1.0
11438831771	2	0.6264260436071075	1.0	1	1	0.6264260436071075	1.0
11438831772	2	0.6264889715927451	1.0	1	1	0.6264889715927451	1.0
11438831773	1	0.6265424721648039	0.0	0	1	0.6265424721648039	0.0
11438831774	2	0.6265982622515889	1.0	1	1	0.6265982622515889	1.0
11438831775	1	0.6267093710544801	0.0	0	1	0.6267093710544801	0.0
11438831776	3	1.344457591571246	1.0	1	2	0.672228795785623	0.5
11438831777	2	0.6268146550625531	1.0	1	1	0.6268146550625531	1.0
11438831778	2	0.6268631389038147	1.0	1	1	0.6268631389038147	1.0
11438831779	4	2.1076097173334816	1.0	1	3	0.7025365724444939	0.3333333333333333
11438831780	2	0.6271559611034343	1.0	1	1	0.6271559611034343	1.0
11438831781	2	0.62727774308527	1.0	1	1	0.62727774308527	1.0
11438831782	3	2.1014818311686922	0.0	0	3	0.7004939437228974	0.0
11438831783	2	1.2575314512826452	0.0	0	2	0.6287657256413226	0.0
11438831784	2	1.4804209622985272	0.0	0	2	0.7402104811492636	0.0
11438831785	5	3.1451221703576056	0.0	0	5	0.6290244340715211	0.0
11438831786	2	1.25801676106594	0.0	0	2	0.62900838053297	0.0
11438831787	3	1.2580889817878194	1.0	1	2	0.6290444908939097	0.5
11438831788	2	0.6290579754622606	1.0	1	1	0.6290579754622606	1.0
11438831789	23	10.802853725227324	6.0	6	17	0.6354619838369014	0.35294117647058826
11438831790	5	4.155777605562874	0.0	0	5	0.8311555211125748	0.0
11438831791	1	0.629208814079519	0.0	0	1	0.629208814079519	0.0
11438831792	1	0.6292230898772238	0.0	0	1	0.6292230898772238	0.0
11438831793	2	1.2584740916325072	0.0	0	2	0.6292370458162536	0.0
11438831794	1	0.6292609678782094	0.0	0	1	0.6292609678782094	0.0
11438831795	1	0.6292615065875568	0.0	0	1	0.6292615065875568	0.0
11438831796	1	0.6292727184758485	0.0	0	1	0.6292727184758485	0.0
11438831797	2	0.6292944351964136	1.0	1	1	0.6292944351964136	1.0
11438831798	6	3.9784404142176575	0.0	0	6	0.6630734023696095	0.0
11438831799	3	1.2587637489147112	1.0	1	2	0.6293818744573556	0.5
11438831800	22	9.547371726318008	7.0	7	15	0.6364914484212005	0.4666666666666667
11438831801	2	0.6295061143005884	1.0	1	1	0.6295061143005884	1.0
11438831802	13	6.609423433863343	3.0	3	10	0.6609423433863343	0.3
11438831803	5	3.3501593923116144	0.0	0	5	0.6700318784623229	0.0
11438831804	3	1.2591781847494952	1.0	1	2	0.6295890923747476	0.5
11438831805	1	0.6297324732344786	0.0	0	1	0.6297324732344786	0.0
11438831806	21	10.86302553916641	4.0	4	17	0.6390015023039064	0.23529411764705882
11438831807	5	3.351595120060974	0.0	0	5	0.6703190240121948	0.0
11438831808	3	1.259712954784744	1.0	1	2	0.629856477392372	0.5
11438831809	1	0.6298789685076239	0.0	0	1	0.6298789685076239	0.0
11438831810	25	14.223670841585546	3.0	3	22	0.646530492799343	0.13636363636363635
11438831811	3	2.0924923546201075	0.0	0	3	0.6974974515400358	0.0
11438831812	2	1.2600634862231987	0.0	0	2	0.6300317431115994	0.0
11438831813	3	1.8900693207821238	0.0	0	3	0.6300231069273746	0.0
11438831814	5	2.2041593277338314	2.0	2	3	0.7347197759112771	0.6666666666666666
11438831815	30	13.493128543423863	9.0	9	21	0.6425299306392316	0.42857142857142855
11438831816	5	3.150959961538846	0.0	0	5	0.6301919923077692	0.0
11438831817	3	1.8905754718832946	0.0	0	3	0.6301918239610982	0.0
11438831818	4	2.235068685610134	1.0	1	3	0.745022895203378	0.3333333333333333
11438831819	4	2.5215636766064486	0.0	0	4	0.6303909191516122	0.0
11438831820	2	1.2607727307483207	0.0	0	2	0.6303863653741604	0.0
11438831821	16	8.830578233442086	2.0	2	14	0.6307555881030061	0.14285714285714285
11438831822	9	5.683613643447205	0.0	0	9	0.6315126270496895	0.0
11438831823	4	2.5225718711500167	0.0	0	4	0.6306429677875042	0.0
11438831824	2	1.261264168350442	0.0	0	2	0.630632084175221	0.0
11438831825	1	0.630870799754766	0.0	0	1	0.630870799754766	0.0
11438831826	1	0.6308710691094397	0.0	0	1	0.6308710691094397	0.0
11438831827	2	0.6308713721334476	1.0	1	1	0.6308713721334476	1.0
11438831828	1	0.6308825840217394	0.0	0	1	0.6308825840217394	0.0
11438831829	2	1.2618780613210832	0.0	0	2	0.6309390306605416	0.0
11438831830	4	2.5249278828113235	0.0	0	4	0.6312319707028309	0.0
11438831831	2	1.262447443431899	0.0	0	2	0.6312237217159495	0.0
11438831832	14	7.5772000965501825	2.0	2	12	0.6314333413791818	0.16666666666666666
11438831833	1	0.6314438181536768	0.0	0	1	0.6314438181536768	0.0
11438831834	1	0.6314550300419685	0.0	0	1	0.6314550300419685	0.0
11438831835	4	2.526097353465755	0.0	0	4	0.6315243383664387	0.0
11438831836	2	1.2630386096019486	0.0	0	2	0.6315193048009743	0.0
11438831837	2	1.2634831794908503	0.0	0	2	0.6317415897454252	0.0
11438831838	2	1.2635381951829485	0.0	0	2	0.6317690975914743	0.0
11438831839	28	15.175649818991975	4.0	4	24	0.6323187424579989	0.16666666666666666
11438831840	1	0.631946029942745	0.0	0	1	0.631946029942745	0.0
11438831841	5	3.1601425653884565	0.0	0	5	0.6320285130776913	0.0
11438831842	2	1.2640371073772643	0.0	0	2	0.6320185536886321	0.0
11438831843	4	2.5290019395893357	0.0	0	4	0.6322504848973339	0.0
11438831844	2	1.264488141778334	0.0	0	2	0.632244070889167	0.0
11438831845	4	2.5301448114697416	0.0	0	4	0.6325362028674354	0.0
11438831846	17	9.51324253634192	2.0	2	15	0.6342161690894613	0.13333333333333333
11438831847	4	2.5310442877331467	0.0	0	4	0.6327610719332867	0.0
11438831848	2	1.2655114875222964	0.0	0	2	0.6327557437611482	0.0
11438831849	2	1.2660952464388198	0.0	0	2	0.6330476232194099	0.0
11438831850	24	13.31816598288177	3.0	3	21	0.6341983801372271	0.14285714285714285
11438831851	5	3.167581097726017	0.0	0	5	0.6335162195452033	0.0
11438831852	2	1.6315286648758844	0.0	0	2	0.8157643324379422	0.0
11438831853	2	1.5562790833604567	0.0	0	2	0.7781395416802284	0.0
11438831854	2	1.2665652366750495	0.0	0	2	0.6332826183375247	0.0
11438831855	1	0.6332854633962655	0.0	0	1	0.6332854633962655	0.0
11438831856	6	3.957180620187116	0.0	0	6	0.6595301033645193	0.0
11438831857	2	1.2672680503573377	0.0	0	2	0.6336340251786688	0.0
11438831858	23	12.06804703754134	4.0	4	19	0.6351603703969126	0.21052631578947367
11438831859	1	0.6337243768370199	0.0	0	1	0.6337243768370199	0.0
11438831860	2	0.6352740752826784	1.0	1	1	0.6352740752826784	1.0
11438831861	2	1.2710130567321212	0.0	0	2	0.6355065283660606	0.0
11438831862	2	0.636607077893365	1.0	1	1	0.636607077893365	1.0
11438831863	3	1.274163530003434	1.0	1	2	0.637081765001717	0.5
11438831864	3	1.5703858273381996	1.0	1	2	0.7851929136690998	0.5
11438831865	1	0.6371229257627881	0.0	0	1	0.6371229257627881	0.0
11438831866	2	0.6381802775343017	1.0	1	1	0.6381802775343017	1.0
11438831867	1	0.6384120235616654	0.0	0	1	0.6384120235616654	0.0
11438831868	1	0.6385965315131332	0.0	0	1	0.6385965315131332	0.0
11438831869	2	0.6386113796895195	1.0	1	1	0.6386113796895195	1.0
11438831870	5	1.9992058077446675	0.5	1	4	0.6664019359148892	0.25
11438831871	3	1.5848885900249143	0.0	0	3	0.7924442950124572	0.0
11438831872	1	0.6390097215825516	0.0	0	1	0.6390097215825516	0.0
11438831873	1	0.6390099909372253	0.0	0	1	0.6390099909372253	0.0
11438831874	1	0.6394104876676467	0.0	0	1	0.6394104876676467	0.0
11438831875	1	0.6394504868366876	0.0	0	1	0.6394504868366876	0.0
11438831876	30	17.282677528214315	3.0	3	27	0.6400991677116413	0.1111111111111111
11438831877	17	10.238549556058045	1.0	1	16	0.6399093472536278	0.0625
11438831878	2	1.2805873022772558	0.0	0	2	0.6402936511386279	0.0
11438831879	6	3.844885141611705	0.0	0	6	0.6408141902686175	0.0
11438831880	12	7.037598612850367	1.0	1	11	0.6397816920773061	0.09090909090909091
11438831881	3	1.9205626603649346	0.0	0	3	0.6401875534549782	0.0
11438831882	16	10.259237139753697	0.0	0	16	0.6412023212346061	0.0
11438831883	1	0.6409544623264897	0.0	0	1	0.6409544623264897	0.0
11438831884	1	0.641020420552206	0.0	0	1	0.641020420552206	0.0
11438831885	20	10.411761715253256	4.0	4	16	0.6507351072033285	0.25
11438831886	9	3.89039658671064	3.0	3	6	0.64839943111844	0.5
11438831887	1	0.6426209596925209	0.0	0	1	0.6426209596925209	0.0
11438831888	4	1.2854289525365754	2.0	2	2	0.6427144762682877	1.0
11438831889	2	0.6426638544243037	1.0	1	1	0.6426638544243037	1.0
11438831890	2	0.6426750999819296	1.0	1	1	0.6426750999819296	1.0
11438831891	6	4.0512496760589185	0.0	0	6	0.6752082793431531	0.0
11438831892	3	1.2854867291140786	1.0	1	2	0.6427433645570393	0.5
11438831893	3	1.2863665761556402	1.0	1	2	0.6431832880778201	0.5
11438831894	9	3.313551432281693	2.5	3	6	0.6627102864563386	0.5
11438831895	10	5.295376052288746	2.0	2	8	0.6619220065360932	0.25
11438831896	6	3.2266332379559657	1.0	1	5	0.6453266475911932	0.2
11438831897	2	0.6429101792733801	1.0	1	1	0.6429101792733801	1.0
11438831898	1	0.6429180242282508	0.0	0	1	0.6429180242282508	0.0
11438831899	1	0.6433179149106566	0.0	0	1	0.6433179149106566	0.0
11438831900	2	0.6433291267989483	1.0	1	1	0.6433291267989483	1.0
11438831901	3	2.464294495969562	0.0	0	3	0.8214314986565207	0.0
11438831902	28	14.809092955880345	5.0	5	23	0.6438736067774063	0.21739130434782608
11438831903	4	2.1642085415262584	1.0	1	3	0.7214028471754195	0.3333333333333333
11438831904	4	2.5773046398329034	0.0	0	4	0.6443261599582258	0.0
11438831905	1	0.6449323258166657	0.0	0	1	0.6449323258166657	0.0
11438831906	11	6.319171618555938	0.5	1	10	0.7021301798395486	0.1
11438831907	3	1.2900319882243525	1.0	1	2	0.6450159941121762	0.5
11438831908	43	21.545553683278705	10.0	10	33	0.6528955661599607	0.30303030303030304
11438831909	1	0.6451661930120846	0.0	0	1	0.6451661930120846	0.0
11438831910	5	2.5897306106469102	1.0	1	4	0.6474326526617276	0.25
11438831911	3	1.2904186131890796	1.0	1	2	0.6452093065945398	0.5
11438831912	5	3.4189514312110085	0.0	0	5	0.6837902862422017	0.0
11438831913	2	0.6452720493988391	1.0	1	1	0.6452720493988391	1.0
11438831914	6	2.59042695981703	2.0	2	4	0.6476067399542575	0.5
11438831915	36	18.937156827415407	7.0	7	29	0.6530054078419106	0.2413793103448276
11438831916	3	1.2907335561412747	1.0	1	2	0.6453667780706374	0.5
11438831917	5	3.4197873397714265	0.0	0	5	0.6839574679542852	0.0
11438831918	3	1.4036561597356716	1.0	1	2	0.7018280798678358	0.5
11438831919	1	0.6455047044982264	0.0	0	1	0.6455047044982264	0.0
11438831920	1	0.6455392492351253	0.0	0	1	0.6455392492351253	0.0
11438831921	3	0.6544142500473981	0.5	1	2	0.6544142500473981	0.5
11438831922	2	0.6455812012255503	1.0	1	1	0.6455812012255503	1.0
11438831923	6	4.042676588166501	0.0	0	6	0.6737794313610835	0.0
11438831924	2	0.6456632533930188	1.0	1	1	0.6456632533930188	1.0
11438831925	3	2.266819574825668	0.0	0	3	0.7556065249418893	0.0
11438831926	2	1.3835316956546728	0.0	0	2	0.6917658478273364	0.0
11438831927	1	0.6458219032958137	0.0	0	1	0.6458219032958137	0.0
11438831928	1	0.6458241928105399	0.0	0	1	0.6458241928105399	0.0
11438831929	39	17.55214869778631	12.0	12	27	0.650079581399493	0.4444444444444444
11438831930	2	0.6458673905663307	1.0	1	1	0.6458673905663307	1.0
11438831931	6	4.068280803728758	0.0	0	6	0.6780468006214596	0.0
11438831932	2	1.2918192911615272	0.0	0	2	0.6459096455807636	0.0
11438831933	5	1.954317245328607	2.0	2	3	0.6514390817762024	0.6666666666666666
11438831934	3	1.292109116790402	1.0	1	2	0.646054558395201	0.5
11438831935	44	24.172003699451764	7.0	7	37	0.6532973972824802	0.1891891891891892
11438831936	6	2.5934272005191	2.0	2	4	0.648356800129775	0.5
11438831937	5	3.4256458712625397	0.0	0	5	0.685129174252508	0.0
11438831938	4	1.2926229781691068	2.0	2	2	0.6463114890845534	1.0
11438831939	5	2.5942952632936884	1.0	1	4	0.6485738158234221	0.25
11438831940	31	17.61752818131691	4.0	4	27	0.6525010437524782	0.14814814814814814
11438831941	5	3.2324574267261856	0.0	0	5	0.6464914853452371	0.0
11438831942	1	0.6466405731571165	0.0	0	1	0.6466405731571165	0.0
11438831943	3	1.2933124251257138	1.0	1	2	0.6466562125628569	0.5
11438831944	1	0.646664747739079	0.0	0	1	0.646664747739079	0.0
11438831945	2	0.6466787205127759	1.0	1	1	0.6466787205127759	1.0
11438831946	1	0.6466792928914574	0.0	0	1	0.6466792928914574	0.0
11438831947	1	0.6466899324010676	0.0	0	1	0.6466899324010676	0.0
11438831948	1	0.6467263962900165	0.0	0	1	0.6467263962900165	0.0
11438831949	5	3.4280158220282093	0.0	0	5	0.6856031644056418	0.0
11438831950	3	2.18521557986489	0.0	0	3	0.7284051932882966	0.0
11438831951	1	0.6469345401140993	0.0	0	1	0.6469345401140993	0.0
11438831952	35	15.633689731092119	11.0	11	24	0.651403738795505	0.4583333333333333
11438831953	2	0.646975785048506	1.0	1	1	0.646975785048506	1.0
11438831954	5	3.4291677172901833	0.0	0	5	0.6858335434580367	0.0
11438831955	2	1.2940434200407351	0.0	0	2	0.6470217100203676	0.0
11438831956	1	0.6470831228859656	0.0	0	1	0.6470831228859656	0.0
11438831957	2	0.6471597206212921	1.0	1	1	0.6471597206212921	1.0
11438831958	2	1.3116657812192924	0.0	0	2	0.6558328906096462	0.0
11438831959	3	1.9494132057929976	0.0	0	3	0.6498044019309992	0.0
11438831960	2	0.647210325630609	1.0	1	1	0.647210325630609	1.0
11438831961	3	1.294569671734429	1.0	1	2	0.6472848358672145	0.5
11438831962	2	1.5395337073300532	0.0	0	2	0.7697668536650266	0.0
11438831963	1	0.6474771214348847	0.0	0	1	0.6474771214348847	0.0
11438831964	2	0.6475194101186518	1.0	1	1	0.6475194101186518	1.0
11438831965	2	0.6475878262057654	1.0	1	1	0.6475878262057654	1.0
11438831966	28	13.151653246799553	8.0	8	20	0.6575826623399776	0.4
11438831967	10	4.8236238997997924	1.5	2	8	0.6890891285428274	0.25
11438831968	2	1.2955618733442473	0.0	0	2	0.6477809366721237	0.0
11438831969	4	2.2206647760886584	1.0	1	3	0.7402215920295528	0.3333333333333333
11438831970	18	9.186149634534528	4.0	4	14	0.6561535453238949	0.2857142857142857
11438831971	4	1.9439106601724805	1.0	1	3	0.6479702200574935	0.3333333333333333
11438831972	12	6.714745690299969	2.0	2	10	0.6714745690299969	0.2
11438831973	5	3.4338092706962957	0.0	0	5	0.6867618541392592	0.0
11438831974	3	1.3360821090013046	1.0	1	2	0.6680410545006523	0.5
11438831975	25	11.742753323946099	7.0	7	18	0.6523751846636722	0.3888888888888889
11438831976	2	1.2962382565991812	0.0	0	2	0.6481191282995906	0.0
11438831977	9	3.4559839278759767	1.0	2	7	0.6911967855751954	0.2857142857142857
11438831978	2	1.3360337261680457	0.0	0	2	0.6680168630840229	0.0
11438831979	25	13.848526614783792	4.0	4	21	0.6594536483230377	0.19047619047619047
11438831980	5	3.241441011141284	0.0	0	5	0.6482882022282568	0.0
11438831981	3	1.9448697648267712	0.0	0	3	0.6482899216089237	0.0
11438831982	3	1.3359894509935604	1.0	1	2	0.6679947254967802	0.5
11438831983	28	13.12787320209543	8.0	8	20	0.6563936601047715	0.4
11438831984	1	0.6483907724879924	0.0	0	1	0.6483907724879924	0.0
11438831985	3	0.6885552579597926	0.5	1	2	0.6885552579597926	0.5
11438831986	3	1.2968502640871065	1.0	1	2	0.6484251320435532	0.5
11438831987	1	0.6484261926275807	0.0	0	1	0.6484261926275807	0.0
11438831988	2	0.6484462258814354	1.0	1	1	0.6484462258814354	1.0
11438831989	1	0.6484574377697271	0.0	0	1	0.6484574377697271	0.0
11438831990	5	3.242751185943376	0.0	0	5	0.6485502371886752	0.0
11438831991	3	1.945646819390991	0.0	0	3	0.648548939796997	0.0
11438831992	3	1.2971619411138833	1.0	1	2	0.6485809705569416	0.5
11438831993	14	7.291536031052823	3.0	3	11	0.662866911913893	0.2727272727272727
11438831994	6	4.504962573673133	0.0	0	6	0.7508270956121889	0.0
11438831995	8	6.018143427794784	0.0	0	8	0.752267928474348	0.0
11438831996	8	4.420875734669082	2.0	2	6	0.7368126224448469	0.3333333333333333
11438831997	8	6.622575753224252	0.0	0	8	0.8278219691530315	0.0
11438831998	8	6.2315625294922325	0.0	0	8	0.7789453161865291	0.0
11438831999	14	7.213348497103613	3.0	3	11	0.6557589542821467	0.2727272727272727
11438832000	4	2.7890994991787545	0.0	0	4	0.6972748747946886	0.0
11438832001	3	1.9464487892625262	0.0	0	3	0.6488162630875087	0.0
11438832002	1	0.6488546012360619	0.0	0	1	0.6488546012360619	0.0
11438832003	29	14.594102944056687	7.0	7	22	0.6633683156389403	0.3181818181818182
11438832004	3	1.9469217760695006	0.0	0	3	0.6489739253565002	0.0
11438832005	3	1.3360500221258031	1.0	1	2	0.6680250110629016	0.5
11438832006	28	12.451719538351677	9.0	9	19	0.6553536599132461	0.47368421052631576
11438832007	7	4.094543355782811	1.0	1	6	0.6824238926304685	0.16666666666666666
11438832008	3	1.947708392724636	0.0	0	3	0.649236130908212	0.0
11438832009	2	1.298530666888166	0.0	0	2	0.649265333444083	0.0
11438832010	13	7.220379495819902	2.0	2	11	0.6563981359836274	0.18181818181818182
11438832011	12	7.43751060794461	1.0	1	11	0.6761373279949645	0.09090909090909091
11438832012	3	1.9484544041627148	0.0	0	3	0.6494848013875716	0.0
11438832013	1	0.6495410516219242	0.0	0	1	0.6495410516219242	0.0
11438832014	26	14.564423190265712	4.0	4	22	0.6620192359211687	0.18181818181818182
11438832015	7	3.2494409122881187	0.5	1	6	0.6498881824576237	0.16666666666666666
11438832016	3	1.9491032795715992	0.0	0	3	0.649701093190533	0.0
12938757715	2	1.8913963639206552	0.0	0	2	0.9456981819603276	0.0
12938757716	5	4.728560554819451	0.0	0	5	0.9457121109638902	0.0
12938757717	15	14.388478966615406	0.0	0	15	0.9592319311076937	0.0
12938757718	1	0.945903682741675	0.0	0	1	0.945903682741675	0.0
12938757719	1	0.9459148946299668	0.0	0	1	0.9459148946299668	0.0
12938757720	2	1.8919850385599735	0.0	0	2	0.9459925192799867	0.0
12938757721	7	6.661340739150302	0.0	0	7	0.9516201055929002	0.0
12938757722	5	4.730033823876454	0.0	0	5	0.9460067647752908	0.0
12938757723	2	1.9326293457135924	0.0	0	2	0.9663146728567962	0.0
12938757724	20	19.12366541072194	0.0	0	20	0.9561832705360971	0.0
12938757725	3	2.9433759911452344	0.0	0	3	0.9811253303817448	0.0
12938757726	4	3.8265389234169778	0.0	0	4	0.9566347308542444	0.0
12938757727	2	1.8925743529166414	0.0	0	2	0.9462871764583207	0.0
12938757728	21	20.074568383545703	0.0	0	21	0.9559318277878907	0.0
12938757729	4	3.786040572827157	0.0	0	4	0.9465101432067893	0.0
12938757730	3	2.8395159938933254	0.0	0	3	0.9465053312977751	0.0
12938757731	2	1.8930665985827837	0.0	0	2	0.9465332992913918	0.0
12938757732	19	18.104701797945815	0.0	0	19	0.9528790419971481	0.0
12938757733	4	3.7868077286071196	0.0	0	4	0.9467019321517799	0.0
12938757734	3	2.840099550793844	0.0	0	3	0.9466998502646146	0.0
12938757735	2	1.9326530489248759	0.0	0	2	0.9663265244624379	0.0
12938757736	11	10.53527776880864	0.0	0	11	0.9577525244371491	0.0
12938757737	11	10.575031353725748	0.0	0	11	0.9613664867023407	0.0
12938757738	4	3.7876751179950237	0.0	0	4	0.9469187794987559	0.0
12938757739	3	2.8407607828483834	0.0	0	3	0.9469202609494611	0.0
12938757740	2	1.9326849001150381	0.0	0	2	0.9663424500575191	0.0
12938757741	21	20.12951656862886	0.0	0	21	0.9585484080299457	0.0
12938757742	1	0.9470914695139162	0.0	0	1	0.9470914695139162	0.0
12938757743	5	4.7360669982041115	0.0	0	5	0.9472133996408223	0.0
12938757744	3	2.8415955129821038	0.0	0	3	0.947198504327368	0.0
12938757745	21	20.093517484838785	0.0	0	21	0.956834165944704	0.0
12938757746	3	2.842319807699618	0.0	0	3	0.9474399358998727	0.0
12938757747	3	2.9000295852439697	0.0	0	3	0.9666765284146566	0.0
12938757748	14	13.308773484402696	0.0	0	14	0.9506266774573354	0.0
12938757749	1	0.9476154316928836	0.0	0	1	0.9476154316928836	0.0
12938757750	1	0.9476266435811754	0.0	0	1	0.9476266435811754	0.0
12938757751	1	0.947653579048543	0.0	0	1	0.947653579048543	0.0
12938757752	1	0.9476608516247322	0.0	0	1	0.9476608516247322	0.0
12938757753	1	0.9476807165319158	0.0	0	1	0.9476807165319158	0.0
12938757754	8	7.828524000023299	0.0	0	8	0.9785655000029124	0.0
12938757755	4	3.790967339163358	0.0	0	4	0.9477418347908395	0.0
12938757756	17	16.237136218415934	0.0	0	17	0.9551256599068196	0.0
12938757757	1	0.9479166375567215	0.0	0	1	0.9479166375567215	0.0
12938757758	5	4.739920318827046	0.0	0	5	0.9479840637654092	0.0
12938757759	2	1.9329339185108512	0.0	0	2	0.9664669592554256	0.0
12938757760	21	20.116004492431927	0.0	0	21	0.9579049758300917	0.0
12938757761	1	0.9481328956903488	0.0	0	1	0.9481328956903488	0.0
12938757762	1	0.9481331650450224	0.0	0	1	0.9481331650450224	0.0
12938757763	1	0.9481441075786405	0.0	0	1	0.9481441075786405	0.0
12938757764	4	3.7928553470791533	0.0	0	4	0.9482138367697883	0.0
12938757765	2	1.8965027561548637	0.0	0	2	0.9482513780774319	0.0
12938757766	20	19.13061048529733	0.0	0	20	0.9565305242648664	0.0
12938757767	5	4.742001083681191	0.0	0	5	0.9484002167362382	0.0
12938757768	2	1.9329540527727085	0.0	0	2	0.9664770263863542	0.0
12938757769	15	14.309546532316144	0.0	0	15	0.9539697688210763	0.0
12938757770	1	0.9485415067303147	0.0	0	1	0.9485415067303147	0.0
12938757771	1	0.9485417760849884	0.0	0	1	0.9485417760849884	0.0
12938757772	7	6.802255656843762	0.0	0	7	0.9717508081205375	0.0
12938757773	5	4.74308247535733	0.0	0	5	0.948616495071466	0.0
12938757774	2	1.932958295108819	0.0	0	2	0.9664791475544094	0.0
12938757775	1	0.9487738924750284	0.0	0	1	0.9487738924750284	0.0
12938757776	1	0.9487741618297021	0.0	0	1	0.9487741618297021	0.0
12938757777	1	0.9487744311843758	0.0	0	1	0.9487744311843758	0.0
12938757778	1	0.948898570019606	0.0	0	1	0.948898570019606	0.0
12938757779	2	1.9003564808098095	0.0	0	2	0.9501782404049047	0.0
12938757780	1	0.9489238556895973	0.0	0	1	0.9489238556895973	0.0
12938757781	2	1.900371227978193	0.0	0	2	0.9501856139890965	0.0
12938757782	4	3.8657545060427534	0.0	0	4	0.9664386265106883	0.0
12938757783	1	0.9490004534249238	0.0	0	1	0.9490004534249238	0.0
12938757784	2	1.8980330273946835	0.0	0	2	0.9490165136973417	0.0
12938757785	2	1.8981476714776666	0.0	0	2	0.9490738357388333	0.0
12938757786	19	18.651271924754965	0.0	0	19	0.9816458907765772	0.0
12938757787	22	21.63605907580977	0.0	0	22	0.9834572307186259	0.0
12938757788	21	20.614191482958077	0.0	0	21	0.9816281658551466	0.0
12938757789	2	1.9019636528089636	0.0	0	2	0.9509818264044818	0.0
12938757790	1	0.9504037576054396	0.0	0	1	0.9504037576054396	0.0
12938757791	1	0.950435642464936	0.0	0	1	0.950435642464936	0.0
12938757792	2	1.9010216521764516	0.0	0	2	0.9505108260882258	0.0
12938757793	1	0.9504732847805821	0.0	0	1	0.9504732847805821	0.0
12938757794	2	1.9009722929325004	0.0	0	2	0.9504861464662502	0.0
12938757795	3	2.856838799005421	0.0	0	3	0.9522795996684738	0.0
12938757796	2	1.9012570008225755	0.0	0	2	0.9506285004112878	0.0
12938757797	1	0.950694930007683	0.0	0	1	0.950694930007683	0.0
12938757798	1	0.9507173537842665	0.0	0	1	0.9507173537842665	0.0
12938757799	1	0.9507285656725583	0.0	0	1	0.9507285656725583	0.0
12938757800	1	0.95073977756085	0.0	0	1	0.95073977756085	0.0
12938757801	1	0.9507680261322518	0.0	0	1	0.9507680261322518	0.0
12938757802	1	0.95080600514124	0.0	0	1	0.95080600514124	0.0
12938757803	1	0.9508305164165445	0.0	0	1	0.9508305164165445	0.0
12938757804	2	1.9017309303709078	0.0	0	2	0.9508654651854539	0.0
12938757805	1	0.9508817948125454	0.0	0	1	0.9508817948125454	0.0
12938757806	1	0.9508930067008372	0.0	0	1	0.9508930067008372	0.0
12938757807	1	0.9509256322856862	0.0	0	1	0.9509256322856862	0.0
12938757808	1	0.9510402426993352	0.0	0	1	0.9510402426993352	0.0
12938757809	1	0.9510626664759186	0.0	0	1	0.9510626664759186	0.0
12938757810	1	0.951090376337973	0.0	0	1	0.951090376337973	0.0
12938757811	1	0.9511032716929753	0.0	0	1	0.9511032716929753	0.0
12938757812	2	1.9023229382743128	0.0	0	2	0.9511614691371564	0.0
12938757813	2	1.9023267429090782	0.0	0	2	0.9511633714545391	0.0
12938757814	1	0.9511983202234485	0.0	0	1	0.9511983202234485	0.0
12938757815	2	1.9025312841144006	0.0	0	2	0.9512656420572003	0.0
12938757816	1	0.9512382183844867	0.0	0	1	0.9512382183844867	0.0
12938757817	2	1.9025146177939671	0.0	0	2	0.9512573088969836	0.0
12938757818	2	1.902728418066197	0.0	0	2	0.9513642090330985	0.0
12938757819	2	1.9027536027281857	0.0	0	2	0.9513768013640929	0.0
12938757820	1	0.9514544765181141	0.0	0	1	0.9514544765181141	0.0
12938757821	1	0.9514739373932871	0.0	0	1	0.9514739373932871	0.0
12938757822	1	0.9515233976452409	0.0	0	1	0.9515233976452409	0.0
12938757823	1	0.95153514824288	0.0	0	1	0.95153514824288	0.0
12938757824	3	2.8851074709996767	0.0	0	3	0.9617024903332255	0.0
12938757825	1	0.9515633968142817	0.0	0	1	0.9515633968142817	0.0
12938757826	2	1.9031632575175121	0.0	0	2	0.9515816287587561	0.0
12938757827	1	0.9516000627192358	0.0	0	1	0.9516000627192358	0.0
12938757828	2	1.9033184394788836	0.0	0	2	0.9516592197394418	0.0
12938757829	1	0.9516210723837825	0.0	0	1	0.9516210723837825	0.0
12938757830	2	1.9033325132605832	0.0	0	2	0.9516662566302916	0.0
12938757831	2	1.9033864515339867	0.0	0	2	0.9516932257669933	0.0
12938757832	3	2.879671119290215	0.0	0	3	0.9598903730967384	0.0
12938757833	2	1.906542480245444	0.0	0	2	0.953271240122722	0.0
12938757834	5	4.766635521410212	0.0	0	5	0.9533271042820424	0.0
12938757835	1	0.953341642700554	0.0	0	1	0.953341642700554	0.0
12938757836	32	30.713931532129454	0.0	0	32	0.9598103603790454	0.0
12938757837	1	0.9534336946602826	0.0	0	1	0.9534336946602826	0.0
12938757838	1	0.9534482061433269	0.0	0	1	0.9534482061433269	0.0
12938757839	1	0.9534521454554294	0.0	0	1	0.9534521454554294	0.0
12938757840	2	1.9069755688913803	0.0	0	2	0.9534877844456902	0.0
12938757841	4	3.824676975565861	0.0	0	4	0.9561692438914653	0.0
12938757842	5	4.767977076031787	0.0	0	5	0.9535954152063575	0.0
12938757843	2	1.9072136447535752	0.0	0	2	0.9536068223767876	0.0
12938757844	1	0.9538360768734199	0.0	0	1	0.9538360768734199	0.0
12938757845	1	0.9538472887617115	0.0	0	1	0.9538472887617115	0.0
12938757846	3	2.8622143102279662	0.0	0	3	0.9540714367426554	0.0
12938757847	2	1.9077722863467785	0.0	0	2	0.9538861431733893	0.0
12938757848	4	3.8156893171613238	0.0	0	4	0.9539223292903309	0.0
12938757849	33	31.750891505048532	0.0	0	33	0.962148227425713	0.0
12938757850	1	0.9540470825909105	0.0	0	1	0.9540470825909105	0.0
12938757851	1	0.9540582944792022	0.0	0	1	0.9540582944792022	0.0
12938757852	1	0.9540785634183964	0.0	0	1	0.9540785634183964	0.0
12938757853	1	0.9540819303518173	0.0	0	1	0.9540819303518173	0.0
12938757854	19	18.240083833948635	0.0	0	19	0.9600044123130861	0.0
12938757855	3	2.872574701057557	0.0	0	3	0.957524900352519	0.0
12938757856	5	4.771787232568266	0.0	0	5	0.9543574465136532	0.0
12938757857	1	0.9543766043648184	0.0	0	1	0.9543766043648184	0.0
12938757858	30	28.809301638413775	0.0	0	30	0.9603100546137925	0.0
12938757859	1	0.9544602389909947	0.0	0	1	0.9544602389909947	0.0
12938757860	1	0.954456905726908	0.0	0	1	0.954456905726908	0.0
12938757861	1	0.9544714172099522	0.0	0	1	0.9544714172099522	0.0
12938757862	1	0.9544686226552128	0.0	0	1	0.9544686226552128	0.0
12938757863	4	3.8280281517383967	0.0	0	4	0.9570070379345992	0.0
12938757864	5	4.7727619934629635	0.0	0	5	0.9545523986925927	0.0
12938757865	1	0.9545807752074645	0.0	0	1	0.9545807752074645	0.0
12938757866	1	0.9546957223144557	0.0	0	1	0.9546957223144557	0.0
12938757867	1	0.9547069342027473	0.0	0	1	0.9547069342027473	0.0
12938757868	1	0.9547212100004522	0.0	0	1	0.9547212100004522	0.0
12938757869	1	0.954729054955323	0.0	0	1	0.954729054955323	0.0
12938757870	1	0.9547456876064224	0.0	0	1	0.9547456876064224	0.0
12938757871	32	30.745319095559537	0.0	0	32	0.9607912217362355	0.0
12938757872	1	0.9550865559459589	0.0	0	1	0.9550865559459589	0.0
12938757873	4	3.820498240827791	0.0	0	4	0.9551245602069478	0.0
12938757874	2	1.9102545580113706	0.0	0	2	0.9551272790056853	0.0
12938757875	23	22.185999907005304	0.0	0	23	0.9646086916089263	0.0
12938757876	2	1.9105874467186994	0.0	0	2	0.9552937233593497	0.0
12938757877	4	3.8213066078728266	0.0	0	4	0.9553266519682067	0.0
12938757878	2	1.910670643643531	0.0	0	2	0.9553353218217655	0.0
12938757879	1	0.9553642606145185	0.0	0	1	0.9553642606145185	0.0
12938757880	2	1.9109382475118277	0.0	0	2	0.9554691237559139	0.0
12938757881	1	0.9554686018812336	0.0	0	1	0.9554686018812336	0.0
12938757882	1	0.9554792077215096	0.0	0	1	0.9554792077215096	0.0
12938757883	1	0.9554904196098014	0.0	0	1	0.9554904196098014	0.0
12938757884	3	2.875544875044178	0.0	0	3	0.9585149583480593	0.0
12938757885	2	1.9110688508592262	0.0	0	2	0.9555344254296131	0.0
12938757886	5	4.777900775596682	0.0	0	5	0.9555801551193364	0.0
12938757887	2	1.9112017100520169	0.0	0	2	0.9556008550260084	0.0
12938757888	7	6.692317974404371	0.0	0	7	0.9560454249149101	0.0
12938757889	1	0.9558115240501569	0.0	0	1	0.9558115240501569	0.0
12938757890	1	0.9558217595277566	0.0	0	1	0.9558217595277566	0.0
12938757891	2	1.9203983203446582	0.0	0	2	0.9601991601723291	0.0
12938757892	4	3.82398981812398	0.0	0	4	0.955997454530995	0.0
12938757893	2	1.9120646214184709	0.0	0	2	0.9560323107092354	0.0
12938757894	20	19.294509134271518	0.0	0	20	0.9647254567135759	0.0
12938757895	3	2.868722626199988	0.0	0	3	0.9562408753999959	0.0
12938757896	15	14.481548110599858	0.0	0	15	0.9654365407066572	0.0
12938757897	1	0.9564321172183056	0.0	0	1	0.9564321172183056	0.0
12938757898	1	0.9564433291065974	0.0	0	1	0.9564433291065974	0.0
12938757899	1	0.9564745405794095	0.0	0	1	0.9564745405794095	0.0
12938757900	6	5.808422094396221	0.0	0	6	0.9680703490660368	0.0
12938757901	4	3.826201489349531	0.0	0	4	0.9565503723373827	0.0
12938757902	3	2.869675434688781	0.0	0	3	0.9565584782295936	0.0
12938757903	1	0.9565828884968955	0.0	0	1	0.9565828884968955	0.0
12938757904	20	19.304566770447902	0.0	0	20	0.9652283385223951	0.0
12938757905	1	0.9566747384406189	0.0	0	1	0.9566747384406189	0.0
12938757906	1	0.9566859503289107	0.0	0	1	0.9566859503289107	0.0
12938757907	4	3.8271370254698747	0.0	0	4	0.9567842563674687	0.0
12938757908	3	2.8703588548345644	0.0	0	3	0.9567862849448548	0.0
12938757909	1	0.9568110992441672	0.0	0	1	0.9568110992441672	0.0
12938757910	17	16.337955672772722	0.0	0	17	0.9610562160454542	0.0
12938757911	3	2.949730741283927	0.0	0	3	0.9832435804279757	0.0
12938757912	4	3.828246194346737	0.0	0	4	0.9570615485866842	0.0
12938757913	3	2.871230486558579	0.0	0	3	0.9570768288528596	0.0
12938757914	2	1.9491285652415908	0.0	0	2	0.9745642826207954	0.0
12938757915	12	11.520913791117538	0.0	0	12	0.9600761492597948	0.0
12938757916	1	0.9572384304339536	0.0	0	1	0.9572384304339536	0.0
12938757917	1	0.9572386997886273	0.0	0	1	0.9572386997886273	0.0
12938757918	1	0.957252975586332	0.0	0	1	0.957252975586332	0.0
12938757919	8	7.793667956460299	0.0	0	8	0.9742084945575373	0.0
12938757920	3	2.871992625607744	0.0	0	3	0.9573308752025813	0.0
12938757921	1	0.957496505880669	0.0	0	1	0.957496505880669	0.0
12938757922	1	0.9575165054651895	0.0	0	1	0.9575165054651895	0.0
12938757923	2	1.9150644917578648	0.0	0	2	0.9575322458789324	0.0
12938757924	1	0.9575476832686675	0.0	0	1	0.9575476832686675	0.0
12938757925	4	3.8304755083034134	0.0	0	4	0.9576188770758534	0.0
12938757926	3	2.872871361561277	0.0	0	3	0.9576237871870923	0.0
12938757927	22	21.307839665418395	0.0	0	22	0.9685381666099271	0.0
12938757928	1	0.9577571401967845	0.0	0	1	0.9577571401967845	0.0
12938757929	1	0.9577574095514582	0.0	0	1	0.9577574095514582	0.0
12938757930	4	3.831321147301418	0.0	0	4	0.9578302868253545	0.0
12938757931	2	1.9156488903917384	0.0	0	2	0.9578244451958692	0.0
12938757932	14	13.445133917588311	0.0	0	14	0.960366708399165	0.0
12938757933	2	1.9158778418643627	0.0	0	2	0.9579389209321814	0.0
12938757934	6	5.882659609394646	0.0	0	6	0.980443268232441	0.0
12938757935	4	3.832004769463207	0.0	0	4	0.9580011923658017	0.0
12938757936	2	1.9160146403692555	0.0	0	2	0.9580073201846278	0.0
12938757937	1	0.958051073484433	0.0	0	1	0.958051073484433	0.0
12938757938	21	20.290154746616885	0.0	0	21	0.9661978450769946	0.0
12938757939	2	1.9165712954717407	0.0	0	2	0.9582856477358703	0.0
12938757940	5	4.791073868936797	0.0	0	5	0.9582147737873594	0.0
12938757941	2	1.9163870905442806	0.0	0	2	0.9581935452721403	0.0
12938757942	21	20.29497872047574	0.0	0	21	0.9664275581178924	0.0
12938757943	1	0.9583659490979598	0.0	0	1	0.9583659490979598	0.0
12938757944	1	0.9583662184526335	0.0	0	1	0.9583662184526335	0.0
12938757945	1	0.9583696527247229	0.0	0	1	0.9583696527247229	0.0
12938757946	1	0.9583679355886782	0.0	0	1	0.9583679355886782	0.0
12938757947	1	0.9583676662340045	0.0	0	1	0.9583676662340045	0.0
12938757948	3	2.875570665754183	0.0	0	3	0.9585235552513943	0.0
12938757949	5	4.792228929116186	0.0	0	5	0.9584457858232373	0.0
12938757950	19	18.349816840505365	0.0	0	19	0.9657798337108087	0.0
12938757951	1	0.958639411430409	0.0	0	1	0.958639411430409	0.0
12938757952	1	0.9586396807850827	0.0	0	1	0.9586396807850827	0.0
12938757953	4	3.8348339026088243	0.0	0	4	0.9587084756522061	0.0
12938757954	17	16.372636164427156	0.0	0	17	0.9630962449663033	0.0
12938757955	1	0.9589172844456396	0.0	0	1	0.9589172844456396	0.0
12938757956	1	0.9589284963339314	0.0	0	1	0.9589284963339314	0.0
12938757957	4	3.8359900065375747	0.0	0	4	0.9589975016343937	0.0
12938757958	3	2.8769890874657587	0.0	0	3	0.9589963624885862	0.0
12938757959	1	0.9590226021230468	0.0	0	1	0.9590226021230468	0.0
12938757960	11	10.691315975018297	0.0	0	11	0.9719378159107542	0.0
12938757961	1	0.959110714770673	0.0	0	1	0.959110714770673	0.0
12938757962	1	0.9591302093151802	0.0	0	1	0.9591302093151802	0.0
12938757963	1	0.959141421203472	0.0	0	1	0.959141421203472	0.0
12938757964	1	0.9591726326762842	0.0	0	1	0.9591726326762842	0.0
12938757965	12	11.61622036336821	0.0	0	12	0.9680183636140175	0.0
12938757966	4	3.837053890159925	0.0	0	4	0.9592634725399812	0.0
12938757967	3	2.877768566222042	0.0	0	3	0.9592561887406806	0.0
12938757968	1	0.9593192626267663	0.0	0	1	0.9593192626267663	0.0
12938757969	20	19.36418539722592	0.0	0	20	0.9682092698612961	0.0
12938757970	1	0.9593971397967928	0.0	0	1	0.9593971397967928	0.0
12938757971	1	0.959414210149237	0.0	0	1	0.959414210149237	0.0
12938757972	2	1.9192383107731397	0.0	0	2	0.9596191553865698	0.0
12938757973	4	3.8379081821768217	0.0	0	4	0.9594770455442054	0.0
12938757974	2	1.949613403654207	0.0	0	2	0.9748067018271035	0.0
12938757975	1	0.9597180422211431	0.0	0	1	0.9597180422211431	0.0
12938757976	1	0.9597624184036312	0.0	0	1	0.9597624184036312	0.0
12938757977	8	7.818158154761566	0.0	0	8	0.9772697693451957	0.0
12938757978	4	3.839247144259663	0.0	0	4	0.9598117860649158	0.0
12938757979	19	18.379340334916275	0.0	0	19	0.9673337018376987	0.0
12938757980	1	0.960007059785997	0.0	0	1	0.960007059785997	0.0
12938757981	5	4.800322228996118	0.0	0	5	0.9600644457992236	0.0
12938757982	2	1.9201756313681968	0.0	0	2	0.9600878156840984	0.0
12938757983	1	0.9602405902880738	0.0	0	1	0.9602405902880738	0.0
12938757984	1	0.9602838217131987	0.0	0	1	0.9602838217131987	0.0
12938757985	2	1.9233408181385592	0.0	0	2	0.9616704090692796	0.0
12938757986	1	0.9616646684477969	0.0	0	1	0.9616646684477969	0.0
12938757987	2	1.9233529727682088	0.0	0	2	0.9616764863841044	0.0
12938757988	1	0.9617047686248403	0.0	0	1	0.9617047686248403	0.0
12938757989	2	1.923504417433483	0.0	0	2	0.9617522087167415	0.0
12938757990	1	0.9618584691355065	0.0	0	1	0.9618584691355065	0.0
12938757991	1	0.9618745630772586	0.0	0	1	0.9618745630772586	0.0
12938757992	2	1.923870739789682	0.0	0	2	0.961935369894841	0.0
12938757993	1	0.9620716296903866	0.0	0	1	0.9620716296903866	0.0
12938757994	2	1.9242926165473262	0.0	0	2	0.9621463082736631	0.0
12938757995	2	1.9243263532202042	0.0	0	2	0.9621631766101021	0.0
12938757996	1	0.9621920312295196	0.0	0	1	0.9621920312295196	0.0
12938757997	1	0.9622386632573997	0.0	0	1	0.9622386632573997	0.0
12938757998	1	0.9623478192389067	0.0	0	1	0.9623478192389067	0.0
12938757999	1	0.9623620613672773	0.0	0	1	0.9623620613672773	0.0
12938758000	1	0.9624513524416007	0.0	0	1	0.9624513524416007	0.0
12938758001	1	0.9624947185440625	0.0	0	1	0.9624947185440625	0.0
12938758002	1	0.9625589259644	0.0	0	1	0.9625589259644	0.0
12938758003	1	0.962570979586047	0.0	0	1	0.962570979586047	0.0
12938758004	1	0.962601686018846	0.0	0	1	0.962601686018846	0.0
12938758005	1	0.9626133019391483	0.0	0	1	0.9626133019391483	0.0
12938758006	1	0.9626249178594505	0.0	0	1	0.9626249178594505	0.0
12938758007	1	0.9626573414282943	0.0	0	1	0.9626573414282943	0.0
12938758008	1	0.9626689573485965	0.0	0	1	0.9626689573485965	0.0
12938758009	1	0.9626801692368883	0.0	0	1	0.9626801692368883	0.0
12938758010	2	1.9254196638406536	0.0	0	2	0.9627098319203268	0.0
12938758011	1	0.9627011789014349	0.0	0	1	0.9627011789014349	0.0
12938758012	1	0.9627107746616846	0.0	0	1	0.9627107746616846	0.0
12938758013	1	0.9627223905819869	0.0	0	1	0.9627223905819869	0.0
12938758014	2	1.9255863270449902	0.0	0	2	0.9627931635224951	0.0
12938758015	2	1.9256231949659497	0.0	0	2	0.9628115974829748	0.0
12938758016	2	1.9257304654647411	0.0	0	2	0.9628652327323706	0.0
12938758017	1	0.9628486842546066	0.0	0	1	0.9628486842546066	0.0
12938758018	1	0.9628589870708747	0.0	0	1	0.9628589870708747	0.0
12938758019	2	1.9257425864250564	0.0	0	2	0.9628712932125282	0.0
12938758020	1	0.9628843064102002	0.0	0	1	0.9628843064102002	0.0
12938758021	1	0.9629532948759953	0.0	0	1	0.9629532948759953	0.0
12938758022	2	1.9259573631079785	0.0	0	2	0.9629786815539892	0.0
12938758023	1	0.963006458754712	0.0	0	1	0.963006458754712	0.0
12938758024	1	0.9630216099551063	0.0	0	1	0.9630216099551063	0.0
12938758025	1	0.9645636991312335	0.0	0	1	0.9645636991312335	0.0
12938758026	2	1.9317359635996787	0.0	0	2	0.9658679817998393	0.0
12938758027	1	0.9646107688604584	0.0	0	1	0.9646107688604584	0.0
12938758028	1	0.9646398928345495	0.0	0	1	0.9646398928345495	0.0
12938758029	1	0.9646844036943745	0.0	0	1	0.9646844036943745	0.0
12938758030	17	16.42570092062397	0.0	0	17	0.9662177012131747	0.0
12938758031	17	16.428407127030393	0.0	0	17	0.9663768898253172	0.0
12938758032	18	17.39953722173516	0.0	0	18	0.9666409567630644	0.0
12938758033	19	18.373684425478434	0.0	0	19	0.9670360223936018	0.0
12938758034	15	14.503406444384641	0.0	0	15	0.9668937629589761	0.0
12938758035	19	18.380474318092446	0.0	0	19	0.9673933851627603	0.0
12938758036	1	0.966109693950129	0.0	0	1	0.966109693950129	0.0
12938758037	1	0.9661227576518023	0.0	0	1	0.9661227576518023	0.0
12938758038	1	0.9661473362657752	0.0	0	1	0.9661473362657752	0.0
12938758039	1	0.9661701640743692	0.0	0	1	0.9661701640743692	0.0
12938758040	1	0.9661886822081844	0.0	0	1	0.9661886822081844	0.0
12938758041	1	0.9662255164598096	0.0	0	1	0.9662255164598096	0.0
12938758042	1	0.9662528559591876	0.0	0	1	0.9662528559591876	0.0
12938758043	2	1.9325816699363518	0.0	0	2	0.9662908349681759	0.0
12938758044	1	0.9663561534765422	0.0	0	1	0.9663561534765422	0.0
12938758045	1	0.966388913738728	0.0	0	1	0.966388913738728	0.0
12938758046	1	0.9664943324241378	0.0	0	1	0.9664943324241378	0.0
12938758047	2	1.9333127995287103	0.0	0	2	0.9666563997643551	0.0
12938758048	1	0.9665841622078086	0.0	0	1	0.9665841622078086	0.0
12938758049	1	0.9665939599840636	0.0	0	1	0.9665939599840636	0.0
12938758050	2	1.933226774379805	0.0	0	2	0.9666133871899025	0.0
12938758051	1	0.9666855405731134	0.0	0	1	0.9666855405731134	0.0
12938758052	1	0.9667646298391713	0.0	0	1	0.9667646298391713	0.0
12938758053	1	0.9667896798238231	0.0	0	1	0.9667896798238231	0.0
12938758054	1	0.9668121036004067	0.0	0	1	0.9668121036004067	0.0
12938758055	2	1.9336633309671647	0.0	0	2	0.9668316654835823	0.0
12938758056	1	0.9668905531491148	0.0	0	1	0.9668905531491148	0.0
12938758057	1	0.9669133809577087	0.0	0	1	0.9669133809577087	0.0
12938758058	1	0.9669377575556763	0.0	0	1	0.9669377575556763	0.0
12938758059	2	1.9340240305445506	0.0	0	2	0.9670120152722753	0.0
12938758060	2	1.9339798900474021	0.0	0	2	0.9669899450237011	0.0
12938758061	1	0.967034792576868	0.0	0	1	0.967034792576868	0.0
12938758062	2	1.934101099650556	0.0	0	2	0.967050549825278	0.0
12938758063	1	0.9671080570481078	0.0	0	1	0.9671080570481078	0.0
12938758064	1	0.9671196729684101	0.0	0	1	0.9671196729684101	0.0
12938758065	1	0.9671694699137058	0.0	0	1	0.9671694699137058	0.0
12938758066	1	0.9671810858340081	0.0	0	1	0.9671810858340081	0.0
12938758067	1	0.9671922977222999	0.0	0	1	0.9671922977222999	0.0
12938758068	1	0.9672340813660538	0.0	0	1	0.9672340813660538	0.0
12938758069	2	1.9345541542116784	0.0	0	2	0.9672770771058392	0.0
12938758070	1	0.9675030993463873	0.0	0	1	0.9675030993463873	0.0
12938758071	1	0.9675714144254983	0.0	0	1	0.9675714144254983	0.0
12938758072	1	0.9676844087111053	0.0	0	1	0.9676844087111053	0.0
12938758073	1	0.9677924872739175	0.0	0	1	0.9677924872739175	0.0
12938758074	1	0.9678428565978949	0.0	0	1	0.9678428565978949	0.0
12938758075	1	0.9679028553514561	0.0	0	1	0.9679028553514561	0.0
12938758076	1	0.9679608339449648	0.0	0	1	0.9679608339449648	0.0
12938758077	1	0.9680231895519208	0.0	0	1	0.9680231895519208	0.0
12938758078	1	0.9681308640827226	0.0	0	1	0.9681308640827226	0.0
12938758079	1	0.9682373265174928	0.0	0	1	0.9682373265174928	0.0
12938758080	1	0.9684577933178964	0.0	0	1	0.9684577933178964	0.0
12938758081	1	0.9685778581636874	0.0	0	1	0.9685778581636874	0.0
12938758082	1	0.9686884282572311	0.0	0	1	0.9686884282572311	0.0
12938758083	1	0.9688016245588433	0.0	0	1	0.9688016245588433	0.0
12938758084	1	0.9689245849673762	0.0	0	1	0.9689245849673762	0.0
12938758085	13	12.598806213352402	0.0	0	13	0.9691389394886463	0.0
12938758086	1	0.9690293976047702	0.0	0	1	0.9690293976047702	0.0
12938758087	2	1.9380902760370264	0.0	0	2	0.9690451380185132	0.0
12938758088	1	0.9690572421441616	0.0	0	1	0.9690572421441616	0.0
12938758089	1	0.9690684540324532	0.0	0	1	0.9690684540324532	0.0
12938758090	1	0.9690884199476395	0.0	0	1	0.9690884199476395	0.0
12938758091	2	1.9383625599427783	0.0	0	2	0.9691812799713891	0.0
12938758092	2	1.938264279156221	0.0	0	2	0.9691321395781105	0.0
12938758093	5	4.8459419210045365	0.0	0	5	0.9691883842009072	0.0
12938758094	2	1.9384189224082449	0.0	0	2	0.9692094612041224	0.0
12938758095	21	20.357046185269486	0.0	0	21	0.9693831516794993	0.0
12938758096	4	3.8775958088682128	0.0	0	4	0.9693989522170532	0.0
12938758097	3	2.9081594500208534	0.0	0	3	0.9693864833402844	0.0
12938758098	7	6.786655273861819	0.0	0	7	0.9695221819802599	0.0
12938758099	1	0.9694578735519198	0.0	0	1	0.9694578735519198	0.0
12938758100	1	0.9694698261655642	0.0	0	1	0.9694698261655642	0.0
12938758101	1	0.9695590499012192	0.0	0	1	0.9695590499012192	0.0
12938758102	2	1.939464590920788	0.0	0	2	0.969732295460394	0.0
12938758103	6	5.819530786178617	0.0	0	6	0.9699217976964362	0.0
12938758104	22	21.34542723472714	0.0	0	22	0.9702466924875973	0.0
12938758105	4	3.8827657014667407	0.0	0	4	0.9706914253666852	0.0
12938758106	1	0.9712730883671541	0.0	0	1	0.9712730883671541	0.0
12938758107	1	0.9712843002554459	0.0	0	1	0.9712843002554459	0.0
12938758108	3	2.914227034408073	0.0	0	3	0.9714090114693578	0.0
12938758109	1	0.9713268582938867	0.0	0	1	0.9713268582938867	0.0
12938758110	1	0.971338507883523	0.0	0	1	0.971338507883523	0.0
12938758111	1	0.971400863490479	0.0	0	1	0.971400863490479	0.0
12938758112	2	1.9428464398567882	0.0	0	2	0.9714232199283941	0.0
12938758113	9	8.744961729246231	0.0	0	9	0.9716624143606923	0.0
12938758114	1	0.9715834522898968	0.0	0	1	0.9715834522898968	0.0
12938758115	1	0.9716130813040011	0.0	0	1	0.9716130813040011	0.0
12938758116	6	5.830121980294214	0.0	0	6	0.9716869967157024	0.0
12938758117	5	4.858514252414353	0.0	0	5	0.9717028504828706	0.0
12938758118	1	0.9717307556270632	0.0	0	1	0.9717307556270632	0.0
12938758119	15	14.57859845133857	0.0	0	15	0.9719065634225713	0.0
12938758120	5	4.8596683361830495	0.0	0	5	0.9719336672366099	0.0
12938758121	2	1.9439275621782537	0.0	0	2	0.9719637810891268	0.0
12938758122	16	15.554308955938522	0.0	0	16	0.9721443097461576	0.0
12938758123	1	0.9721694670518124	0.0	0	1	0.9721694670518124	0.0
12938758124	2	1.9444199425217328	0.0	0	2	0.9722099712608664	0.0
12938758125	16	15.558764991313142	0.0	0	16	0.9724228119570714	0.0
12938758126	1	0.9723994959431315	0.0	0	1	0.9723994959431315	0.0
12938758127	4	3.8898554195018913	0.0	0	4	0.9724638548754728	0.0
12938758128	2	1.9449794595176255	0.0	0	2	0.9724897297588128	0.0
12938758129	1	0.9726727225902412	0.0	0	1	0.9726727225902412	0.0
12938758130	4	3.890929774287181	0.0	0	4	0.9727324435717952	0.0
12938758131	4	3.892192441658704	0.0	0	4	0.973048110414676	0.0
12938758132	2	1.9461436440865858	0.0	0	2	0.9730718220432929	0.0
12938758133	5	4.866216583985444	0.0	0	5	0.9732433167970888	0.0
12938758134	1	0.9732666496456959	0.0	0	1	0.9732666496456959	0.0
12938758135	4	3.893165148724015	0.0	0	4	0.9732912871810038	0.0
12938758136	1	0.9733079619187709	0.0	0	1	0.9733079619187709	0.0
12938758137	2	1.946646158899662	0.0	0	2	0.973323079449831	0.0
12938758138	5	4.869019859082389	0.0	0	5	0.9738039718164778	0.0
12938758139	1	0.9737786592110191	0.0	0	1	0.9737786592110191	0.0
12938758140	2	1.9477681221235237	0.0	0	2	0.9738840610617618	0.0
12938758141	9	8.764847343070347	0.0	0	9	0.9738719270078163	0.0
12938758142	1	0.9738345503058068	0.0	0	1	0.9738345503058068	0.0
12938758143	5	4.869455237243051	0.0	0	5	0.9738910474486102	0.0
12938758144	2	1.9478356964772818	0.0	0	2	0.9739178482386409	0.0
12938758145	16	15.584960305706783	0.0	0	16	0.974060019106674	0.0
12938758146	4	3.8963410760119896	0.0	0	4	0.9740852690029974	0.0
12938758147	2	1.94816074022974	0.0	0	2	0.97408037011487	0.0
12938758148	15	14.614495146683314	0.0	0	15	0.9742996764455543	0.0
12938758149	2	1.9488694123761805	0.0	0	2	0.9744347061880902	0.0
12938758150	4	3.8973371495952422	0.0	0	4	0.9743342873988106	0.0
12938758151	2	1.9486560161359612	0.0	0	2	0.9743280080679806	0.0
12938758152	1	0.9743584114767717	0.0	0	1	0.9743584114767717	0.0
12938758153	2	1.9489485016422385	0.0	0	2	0.9744742508211193	0.0
12938758154	1	0.9744816075706441	0.0	0	1	0.9744816075706441	0.0
12938758155	1	0.9744928194589358	0.0	0	1	0.9744928194589358	0.0
12938758156	1	0.9745351081427029	0.0	0	1	0.9745351081427029	0.0
12938758157	1	0.9745161859768772	0.0	0	1	0.9745161859768772	0.0
12938758158	1	0.974527397865169	0.0	0	1	0.974527397865169	0.0
12938758159	2	1.9493853612536063	0.0	0	2	0.9746926806268031	0.0
12938758160	13	12.669667030822962	0.0	0	13	0.9745897716017663	0.0
12938758161	4	3.898406218295061	0.0	0	4	0.9746015545737653	0.0
12938758162	16	15.597029886618182	0.0	0	16	0.9748143679136364	0.0
12938758163	1	0.9747878975039475	0.0	0	1	0.9747878975039475	0.0
12938758164	5	4.874232107703352	0.0	0	5	0.9748464215406705	0.0
12938758165	16	15.601411815788202	0.0	0	16	0.9750882384867626	0.0
12938758166	1	0.9750243235687662	0.0	0	1	0.9750243235687662	0.0
12938758167	1	0.9750592049990072	0.0	0	1	0.9750592049990072	0.0
12938758168	4	3.9004275231049914	0.0	0	4	0.9751068807762479	0.0
12938758169	1	0.9751476206706413	0.0	0	1	0.9751476206706413	0.0
12938758170	4	3.9030853130088174	0.0	0	4	0.9757713282522044	0.0
12938758171	14	13.654926326951388	0.0	0	14	0.9753518804965278	0.0
12938758172	1	0.9752927018317499	0.0	0	1	0.9752927018317499	0.0
12938758173	1	0.9752994356985917	0.0	0	1	0.9752994356985917	0.0
12938758174	2	1.9506083998187647	0.0	0	2	0.9753041999093823	0.0
12938758175	2	1.9507855341860405	0.0	0	2	0.9753927670930203	0.0
12938758176	2	1.950684795538086	0.0	0	2	0.975342397769043	0.0
12938758177	4	3.9015579710010737	0.0	0	4	0.9753894927502684	0.0
12938758178	1	0.9754402408542556	0.0	0	1	0.9754402408542556	0.0
12938758179	15	14.634090833870555	0.0	0	15	0.9756060555913704	0.0
12938758180	4	3.9025132036819303	0.0	0	4	0.9756283009204826	0.0
12938758181	3	2.926905053857972	0.0	0	3	0.9756350179526573	0.0
12938758182	1	0.9756547818518383	0.0	0	1	0.9756547818518383	0.0
12938758183	13	12.68605275102534	0.0	0	13	0.9758502116173339	0.0
12938758184	1	0.9757572713051719	0.0	0	1	0.9757572713051719	0.0
12938758185	1	0.9757766311723423	0.0	0	1	0.9757766311723423	0.0
12938758186	1	0.9757932638234418	0.0	0	1	0.9757932638234418	0.0
12938758187	1	0.9758011087783126	0.0	0	1	0.9758011087783126	0.0
12938758188	7	6.8320104932500225	0.0	0	7	0.9760014990357175	0.0
12938758189	5	4.879377724711914	0.0	0	5	0.9758755449423828	0.0
12938758190	2	1.9517390160615182	0.0	0	2	0.9758695080307591	0.0
12938758191	10	9.761269370262578	0.0	0	10	0.9761269370262579	0.0
12938758192	2	1.952268803035304	0.0	0	2	0.976134401517652	0.0
12938758193	1	0.9761743333480244	0.0	0	1	0.9761743333480244	0.0
12938758194	16	15.622273032240376	0.0	0	16	0.9763920645150235	0.0
12938758195	5	4.8821695859045615	0.0	0	5	0.9764339171809123	0.0
12938758196	2	1.95284266316757	0.0	0	2	0.976421331583785	0.0
12938758197	1	0.9764473243097946	0.0	0	1	0.9764473243097946	0.0
12938758198	15	14.649009951544102	0.0	0	15	0.9766006634362735	0.0
12938758199	1	0.9765780286651957	0.0	0	1	0.9765780286651957	0.0
12938758200	5	4.883209126598279	0.0	0	5	0.9766418253196558	0.0
12938758201	1	0.976630620165231	0.0	0	1	0.976630620165231	0.0
12938758202	2	1.953349656002096	0.0	0	2	0.976674828001048	0.0
12938758203	1	0.9768322994771456	0.0	0	1	0.9768322994771456	0.0
12938758204	1	0.9768473160002029	0.0	0	1	0.9768473160002029	0.0
12938758205	1	0.9768990657668829	0.0	0	1	0.9768990657668829	0.0
12938758206	1	0.9773275753833666	0.0	0	1	0.9773275753833666	0.0
12938758207	1	0.9777521456877478	0.0	0	1	0.9777521456877478	0.0
12938758208	1	0.9777633575760396	0.0	0	1	0.9777633575760396	0.0
12938758209	1	0.9784992008751872	0.0	0	1	0.9784992008751872	0.0
12938758210	2	1.9611958566382643	0.0	0	2	0.9805979283191322	0.0
12938758211	1	0.9787000721230809	0.0	0	1	0.9787000721230809	0.0
12938758212	1	0.9787112840113725	0.0	0	1	0.9787112840113725	0.0
12938758213	1	0.9793978017359033	0.0	0	1	0.9793978017359033	0.0
12938758214	1	0.9794152424510238	0.0	0	1	0.9794152424510238	0.0
12938758215	1	0.9794155118056975	0.0	0	1	0.9794155118056975	0.0
12938758216	2	1.9597245067333113	0.0	0	2	0.9798622533666557	0.0
12938758217	1	0.9798777917643933	0.0	0	1	0.9798777917643933	0.0
12938758218	2	1.9625590606417367	0.0	0	2	0.9812795303208683	0.0
12938758219	1	0.9799556015957513	0.0	0	1	0.9799556015957513	0.0
12938758220	2	1.9600442980696327	0.0	0	2	0.9800221490348163	0.0
12938758221	1	0.9802225657466981	0.0	0	1	0.9802225657466981	0.0
12938758222	18	17.67209694667286	0.0	0	18	0.9817831637040477	0.0
12938758223	19	18.656296466837713	0.0	0	19	0.9819103403598796	0.0
12938758224	14	13.746548867991532	0.0	0	14	0.9818963477136808	0.0
12938758225	16	15.717494926115508	0.0	0	16	0.9823434328822193	0.0
12938758226	16	15.714760976177704	0.0	0	16	0.9821725610111065	0.0
12938758227	20	19.652472034503525	0.0	0	20	0.9826236017251763	0.0
12954820911	10	2.067909599319098	4.0	4	6	0.34465159988651634	0.6666666666666666
12954820912	6	1.9593336394324736	2.0	2	4	0.39186672788649474	0.5
12954820913	9	0.5978465026500964	5.0	5	4	0.11956930053001928	1.25
12954820914	2	0.32081986714282734	1.0	1	1	0.32081986714282734	1.0
12954820915	5	2.840585836987831	1.0	1	4	0.7101464592469577	0.25
12954820916	9	1.077416640873151	4.0	4	5	0.17956944014552514	0.8
12954820917	1	0.0	1.0	1	0	0.0	inf
12954820918	6	0.6414239811920406	3.0	3	3	0.21380799373068018	1.0
12954820919	2	0.3208378465672952	1.0	1	1	0.1604189232836476	1.0
12954820920	1	0.0	1.0	1	0	0.0	inf
12954820922	13	0.5528044080700412	8.0	8	5	0.06910055100875515	1.6
12954820924	4	0.0	4.0	4	0	0.0	inf
12954820926	1	0.0	1.0	1	0	0.0	inf
12954820927	4	0.0	4.0	4	0	0.0	inf
12954820928	3	0.0	3.0	3	0	0.0	inf
12954820929	3	0.0	3.0	3	0	0.0	inf
12954820930	2	0.882591833024883	1.0	1	1	0.4412959165124415	1.0
12954820931	9	0.18947902664783026	8.0	8	1	0.023684878330978782	8.0
12954820932	9	0.4024375318532945	8.0	8	1	0.05030469148166181	8.0
12954820933	6	0.0	6.0	6	0	0.0	inf
12954820934	5	0.0	5.0	5	0	0.0	inf
12954820935	5	0.0	5.0	5	0	0.0	inf
12954820936	8	0.026518102300703048	7.0	7	1	0.003314762787587881	7.0
12954820937	10	1.807744398037253	5.0	5	5	0.2582491997196076	1.0
12954820938	8	0.6266150295800252	4.0	4	4	0.12532300591600504	1.0
12954820939	7	0.38064141899813053	4.0	4	3	0.09516035474953263	1.3333333333333333
12954820940	7	0.417827784520436	4.0	4	3	0.104456946130109	1.3333333333333333
12954820941	12	2.1579943608578906	5.0	6	6	0.3082849086939844	1.0
12954820942	9	0.5442748882960916	4.0	4	5	0.09071248138268194	0.8
12954820943	133	23.376045925241222	40.5	53	80	0.3962041682244275	0.6625
12954820944	7	2.6562611140367896	2.0	2	5	0.44271018567279824	0.4
12954820945	7	1.010825869375037	2.5	3	4	0.3369419564583456	0.75
12954820946	4	0.23500468020580179	1.0	2	2	0.23500468020580179	1.0
12954820947	2	0.036172312514585137	1.0	1	1	0.036172312514585137	1.0
12954820948	3	0.3602916734019364	0.5	1	2	0.3602916734019364	0.5
12954820949	1	0.5536005531467578	0.0	0	1	0.5536005531467578	0.0
12954820950	2	0.0	2.0	2	0	0.0	inf
12954820951	8	2.5216472438939563	3.0	3	5	0.3602353205562795	0.6
12954820953	4	0.0	4.0	4	0	0.0	inf
12954820954	8	1.3316406187790644	5.0	5	3	0.1902343741112949	1.6666666666666667
12954820955	1	0.0	1.0	1	0	0.0	inf
12954820956	4	1.6372090182503616	0.0	0	4	0.4093022545625904	0.0
12954820957	2	0.0	2.0	2	0	0.0	inf
12954820958	5	0.0	5.0	5	0	0.0	inf
12954820959	6	0.0	6.0	6	0	0.0	inf
12954820960	8	1.9132186715178343	3.0	3	5	0.27331695307397635	0.6
12954820961	8	0.0	8.0	8	0	0.0	inf
12954820962	4	0.0	4.0	4	0	0.0	inf
12954820963	7	0.4864234638627204	2.0	2	5	0.09728469277254408	0.4
12954820964	14	1.872400630599694	7.0	7	7	0.23405007882496176	1.0
12954820965	7	1.411778179557684	3.0	3	4	0.2823556359115368	0.75
12954820966	4	1.4720930544978241	0.5	1	3	0.7360465272489121	0.3333333333333333
12954820967	5	4.304921880915807	0.0	0	5	0.8609843761831615	0.0
12954820969	2	0.6649734246261618	1.0	1	1	0.3324867123130809	1.0
12954820970	1	0.0	1.0	1	0	0.0	inf
12954820974	2	0.0	2.0	2	0	0.0	inf
12954820975	4	0.0	4.0	4	0	0.0	inf
13017940047	1	0.03845209680324149	0.0	0	1	0.03845209680324149	0.0
13017940048	15	0.8816856565639697	3.0	3	12	0.07347380471366415	0.25
13017940049	12	0.804154910317183	5.0	5	7	0.11487927290245471	0.7142857142857143
13017940050	2	0.0770687693120988	0.0	0	2	0.0385343846560494	0.0
13017940051	3	0.134518484919017	1.0	1	2	0.0672592424595085	0.5
13021600834	10	1.3499537400182628	5.0	5	5	0.2699907480036526	1.0
13021600835	1	0.2368743383344528	0.0	0	1	0.2368743383344528	0.0
13295608220	5	1.0964734166970336	2.0	2	3	0.3654911388990112	0.6666666666666666
13295608221	20	4.8850855522631065	7.0	7	13	0.37577581171254665	0.5384615384615384
13295608222	9	2.0240781529892122	4.0	4	5	0.4048156305978424	0.8
13295608223	3	0.773341308027372	1.0	1	2	0.386670654013686	0.5
13295608224	28	7.535015013324471	8.0	8	20	0.37675075066622354	0.4
13295608225	4	1.3536997901424068	1.0	1	3	0.4512332633808023	0.3333333333333333
13295608226	1	0.3655598804563555	0.0	0	1	0.3655598804563555	0.0
13295608227	3	2.3148504962034964	0.0	0	3	0.7716168320678322	0.0
13295608228	2	0.36558435806232575	1.0	1	1	0.36558435806232575	1.0
13295608229	4	0.7313473319426327	2.0	2	2	0.36567366597131634	1.0
13295608230	4	0.7314388115236798	2.0	2	2	0.3657194057618399	1.0
13295608231	31	8.362935658878737	9.0	9	22	0.38013343903994257	0.4090909090909091
13295608232	1	0.365819403684442	0.0	0	1	0.365819403684442	0.0
13295608233	2	0.3658306155727337	1.0	1	1	0.3658306155727337	1.0
13295608234	2	0.36585728168542764	1.0	1	1	0.36585728168542764	1.0
13295608235	1	0.3658539484213409	0.0	0	1	0.3658539484213409	0.0
13295608236	7	1.8304456772733035	2.0	2	5	0.3660891354546607	0.4
13650017732	8	2.026352078813716	3.0	3	5	0.40527041576274325	0.6
13650017733	20	4.803822055279189	7.0	7	13	0.3695247734830145	0.5384615384615384
13650017734	15	4.097026334503421	7.0	7	8	0.5121282918129276	0.875
13650017735	3	1.6531583502120513	0.0	0	3	0.8265791751060256	0.0
13650017736	1	0.36606929748294453	0.0	0	1	0.36606929748294453	0.0
13875226028	5	0.13664685821173345	3.0	3	2	0.027329371642346688	1.5
13875226029	7	0.0	7.0	7	0	0.0	inf
13875226030	5	0.0	5.0	5	0	0.0	inf
13875226031	7	0.0	7.0	7	0	0.0	inf
13875226032	12	1.7092625718852912	5.0	6	6	0.2848770953142152	1.0
13875226033	9	0.2890166221125978	5.0	5	4	0.0481694370187663	1.25
13875226034	8	1.225510971708096	4.0	4	4	0.306377742927024	1.0
13875226035	10	4.5270010047266025	3.0	3	7	0.5658751255908253	0.42857142857142855
13875226036	13	2.1727572528207073	2.5	5	8	0.5431893132051768	0.625
13875226037	139	8.563228602287959	43.16666666666667	61	78	0.150232080741894	0.782051282051282
13875226038	150	18.28474630678548	47.5	67	83	0.29023406836167426	0.8072289156626506
13875226039	3	0.5704087224854621	0.5	1	2	0.5704087224854621	0.5
13875226040	112	21.43686078979437	34.166666666666664	44	68	0.38976110526898855	0.6470588235294118
13875226041	2	0.5626553145343748	1.0	1	1	0.5626553145343748	1.0
13875226042	3	2.100733765901227	0.0	0	3	0.7002445886337423	0.0
13875226043	3	0.8728160428451704	1.0	1	2	0.4364080214225852	0.5
13875226044	3	1.7234057124133146	0.0	0	3	0.5744685708044382	0.0
13875226045	1	0.8269461876835758	0.0	0	1	0.8269461876835758	0.0
13875226046	2	0.0	2.0	2	0	0.0	inf
13875226049	3	0.0	3.0	3	0	0.0	inf
13875226051	1	0.0	1.0	1	0	0.0	inf
13875226052	5	0.38953880991765255	2.5	3	2	0.12984626997255086	1.5
13875226053	2	0.0	2.0	2	0	0.0	inf
13875226054	4	0.0	4.0	4	0	0.0	inf
13875226055	2	0.36262694475336993	1.0	1	1	0.18131347237668496	1.0
13875226056	6	0.0	6.0	6	0	0.0	inf
13875226057	6	0.0	6.0	6	0	0.0	inf
13875226058	9	0.03254767400960054	8.0	8	1	0.00464966771565722	8.0
13875226059	6	0.25056344789066165	5.0	5	1	0.05011268957813233	5.0
13875226060	4	0.0	4.0	4	0	0.0	inf
13875226061	6	0.0	6.0	6	0	0.0	inf
13875226062	9	1.0297749706681179	4.0	4	5	0.11441944118534643	0.8
13875226063	9	2.2443018944690607	4.0	4	5	0.44886037889381214	0.8
13875226064	5	0.1818948071011454	3.0	3	2	0.04547370177528635	1.5
13875226065	6	1.2251962644412404	3.0	3	3	0.4083987548137468	1.0
13875226066	9	0.8427646469431931	4.0	4	5	0.1685529293886386	0.8
13875226067	6	1.447577065486552	3.0	3	3	0.361894266371638	1.0
13875226068	11	1.327171317686767	5.0	5	6	0.22119521961446117	0.8333333333333334
13875226069	7	1.0623187053656158	4.0	4	3	0.26557967634140395	1.3333333333333333
13875226070	7	0.9660699641357617	3.0	3	4	0.19321399282715235	0.75
13875226071	3	1.3815597500886934	0.0	0	3	0.6907798750443467	0.0
13875226072	8	1.9984180463321686	2.0	3	5	0.49960451158304214	0.6
13875226073	3	0.47202531179739465	0.5	1	2	0.47202531179739465	0.5
13875226074	70	20.58253443017699	17.5	20	50	0.4677848734131134	0.4
13875226075	6	3.5652464054871316	1.0	1	5	0.7130492810974263	0.2
13875226076	2	0.6223894944674045	1.0	1	1	0.6223894944674045	1.0
13875226077	1	0.9718473188620964	0.0	0	1	0.9718473188620964	0.0
13875226078	7	0.9939805290913654	2.5	3	4	0.3313268430304551	0.75
13875226081	1	0.0	1.0	1	0	0.0	inf
13875226082	4	0.0	4.0	4	0	0.0	inf
13875226083	2	0.22667158732763026	1.0	1	1	0.22667158732763026	1.0
13875226084	1	0.0	1.0	1	0	0.0	inf
13875226085	2	0.0	2.0	2	0	0.0	inf
13875226086	4	0.0	4.0	4	0	0.0	inf
13875226087	1	0.0	1.0	1	0	0.0	inf
13875226089	15	2.02012951448113	7.5	8	7	0.22445883494234778	1.1428571428571428
13875226090	6	0.39135971485036825	5.0	5	1	0.06522661914172805	5.0
13875226092	1	0.0	1.0	1	0	0.0	inf
14163834089	14	7.640917560736197	0.0	0	14	0.5457798257668712	0.0
14163834090	23	3.641994137697544	8.0	8	15	0.24279960917983626	0.5333333333333333
14163834091	10	1.2146754729034754	4.0	5	5	0.30366886822586886	1.0
14163834092	8	1.3241667673099182	3.0	3	5	0.26483335346198367	0.6
14163834093	10	2.584377994571628	5.0	5	5	0.5168755989143257	1.0
14163834094	4	1.097062461699028	1.0	1	3	0.548531230849514	0.3333333333333333
14163834095	2	0.2370705968835597	1.0	1	1	0.2370705968835597	1.0
14163834096	1	0.23708180877185145	0.0	0	1	0.23708180877185145	0.0
14163834097	2	0.23710211138037973	1.0	1	1	0.23710211138037973	1.0
14163834098	1	0.2371054783138007	0.0	0	1	0.2371054783138007	0.0
14163834099	2	0.23710601702314804	1.0	1	1	0.23710601702314804	1.0
14163834100	2	1.1965078705267302	0.0	0	2	0.5982539352633651	0.0
14163834101	3	0.47429149367503043	1.0	1	2	0.23714574683751521	0.5
14163834102	5	2.940748503642197	1.0	1	4	0.7351871259105492	0.25
14163834103	11	1.5888891803156815	5.0	5	6	0.2648148633859469	0.8333333333333334
14163834104	2	0.4743761047118987	0.0	0	2	0.23718805235594936	0.0
14163834105	2	0.2372272602956363	1.0	1	1	0.2372272602956363	1.0
14163834106	26	4.399288136000676	8.0	8	18	0.244404896444482	0.4444444444444444
14163834107	4	0.47474815085491323	2.0	2	2	0.23737407542745662	1.0
14163834108	9	1.1869369919150163	4.0	4	5	0.23738739838300327	0.8
14163834109	3	0.47483229052110265	1.0	1	2	0.23741614526055133	0.5
14163834110	27	4.690476160815111	8.0	8	19	0.24686716635869005	0.42105263157894735
14163834111	2	0.9411415594497582	0.0	0	2	0.4705707797248791	0.0
14163834112	3	1.313930313299552	0.0	0	3	0.656965156649776	0.0
14163834113	2	0.6918366376025118	0.0	0	2	0.6918366376025118	0.0
14163834114	6	1.1452123705039527	1.0	2	4	0.5726061852519764	0.5
14163834115	4	2.0406655861728393	0.0	0	4	0.6802218620576131	0.0
14163834116	2	0.6918360652238302	0.0	0	2	0.6918360652238302	0.0
14163834117	3	0.7129433371704029	0.0	0	3	0.23764777905680098	0.0
14163834118	3	0.4753499902039072	1.0	1	2	0.2376749951019536	0.5
14163834119	26	3.8498892127392503	10.0	10	16	0.24061807579620315	0.625
14163834120	2	0.845514051105403	0.0	0	2	0.845514051105403	0.0
14163834121	1	0.2377970801077971	0.0	0	1	0.2377970801077971	0.0
14163834122	3	0.44913332945238144	0.5	1	2	0.44913332945238144	0.5
14163834123	3	1.6911108277649585	0.0	0	3	0.8455554138824792	0.0
14163834124	3	0.551691535566416	0.5	1	2	0.551691535566416	0.5
14163834125	1	0.23784192766096407	0.0	0	1	0.23784192766096407	0.0
14163834126	3	1.3311906281273551	0.0	0	3	0.44373020937578506	0.0
14163834127	4	1.8495766266404496	1.0	1	3	0.6165255422134832	0.3333333333333333
14163834128	9	1.3551035320242675	4.0	4	5	0.2710207064048535	0.8
14163834129	2	0.2379566390826157	1.0	1	1	0.2379566390826157	1.0
14163834130	11	2.6857702653113233	1.0	1	10	0.26857702653113236	0.1
14163834131	2	0.5628311357976166	0.0	0	2	0.2814155678988083	0.0
14163834132	3	0.47614142157383466	1.0	1	2	0.23807071078691733	0.5
14163834133	2	0.2381013162117137	1.0	1	1	0.2381013162117137	1.0
14163834134	1	0.2380931345635008	0.0	0	1	0.2380931345635008	0.0
14163834135	1	0.2380934039181745	0.0	0	1	0.2380934039181745	0.0
14163834136	2	0.23810794907055297	1.0	1	1	0.23810794907055297	1.0
14163834137	22	3.7035507376833285	7.0	7	15	0.2469033825122219	0.4666666666666667
14163834138	10	1.3561466753367446	5.0	5	5	0.2712293350673489	1.0
14163834139	2	0.2381956240168344	1.0	1	1	0.2381956240168344	1.0
14163834140	30	4.9855775723447096	10.0	10	20	0.24927887861723547	0.5
14163834141	3	0.41454650588571945	0.5	1	2	0.41454650588571945	0.5
14163834142	1	0.23831552051595425	0.0	0	1	0.23831552051595425	0.0
14163834143	1	0.23832642938023813	0.0	0	1	0.23832642938023813	0.0
14163834144	2	0.23833764126852988	1.0	1	1	0.23833764126852988	1.0
14163834145	3	0.47672999520515014	1.0	1	2	0.23836499760257507	0.5
14163834146	1	0.23836615919460527	0.0	0	1	0.23836615919460527	0.0
14163834147	11	1.5966933279534228	5.0	5	6	0.2661155546589038	0.8333333333333334
14163834148	4	0.4769634920378927	2.0	2	2	0.23848174601894634	1.0
14163834149	30	5.272957864814728	9.0	9	21	0.2510932316578442	0.42857142857142855
14163834150	2	0.2386027199367609	1.0	1	1	0.2386027199367609	1.0
14163834151	1	0.2386029892914346	0.0	0	1	0.2386029892914346	0.0
14163834152	2	0.23861497557441316	1.0	1	1	0.23861497557441316	1.0
14163834153	1	0.23862282052928396	0.0	0	1	0.23862282052928396	0.0
14163834154	2	0.23863709632698876	1.0	1	1	0.23863709632698876	1.0
14163834155	2	1.0488539682525788	0.0	0	2	0.5244269841262894	0.0
14163834156	9	1.359478558980778	4.0	4	5	0.2718957117961556	0.8
14163834157	3	0.7161402067842564	0.0	0	3	0.2387134022614188	0.0
14163834158	2	0.23873672388691453	1.0	1	1	0.23873672388691453	1.0
14163834159	20	3.191926753575524	7.0	7	13	0.24553282719811723	0.5384615384615384
14163834160	11	2.0885050973856876	3.0	3	8	0.26106313717321095	0.375
14163834161	9	1.3602859159457865	4.0	4	5	0.2720571831891573	0.8
14163834162	2	0.47771630468148185	0.0	0	2	0.23885815234074093	0.0
14163834163	2	0.23889274758164114	1.0	1	1	0.23889274758164114	1.0
14163834164	29	5.045058087513805	9.0	9	20	0.25225290437569026	0.45
14163834165	9	1.1951759790040726	4.0	4	5	0.2390351958008145	0.8
14163834166	2	0.47805299802357637	0.0	0	2	0.23902649901178818	0.0
14163834167	3	0.47812414132676095	1.0	1	2	0.23906207066338048	0.5
14163834168	28	5.004500108533099	8.0	8	20	0.25022500542665493	0.4
14163834169	2	0.5944723976609644	0.0	0	2	0.5944723976609644	0.0
14163834170	3	0.5944836095492562	0.5	1	2	0.5944836095492562	0.5
14163834171	3	0.47853622030815046	1.0	1	2	0.23926811015407523	0.5
14163834172	10	1.3620044324331713	5.0	5	5	0.27240088648663424	1.0
14163834173	1	0.23921641089139664	0.0	0	1	0.23921641089139664	0.0
14163834174	27	4.112987753756092	10.0	10	17	0.2419404561032995	0.5882352941176471
14163834175	2	0.2393266442915984	1.0	1	1	0.2393266442915984	1.0
14163834176	9	1.1969528781169765	4.0	4	5	0.2393905756233953	0.8
14163834177	3	0.4788475606415853	1.0	1	2	0.23942378032079265	0.5
14163834178	13	2.6147673632503996	3.0	3	10	0.26147673632504	0.3
14163834179	2	0.2395346871076786	1.0	1	1	0.2395346871076786	1.0
14163834180	21	3.5307859429317587	7.0	7	14	0.25219899592369704	0.5
14163834181	10	1.3646205060319119	5.0	5	5	0.2729241012063824	1.0
14163834182	4	0.4792374515317308	2.0	2	2	0.2396187257658654	1.0
14163834183	29	5.0585568643237275	9.0	9	20	0.2529278432161864	0.45
14163834184	2	0.5543311103604346	0.0	0	2	0.5543311103604346	0.0
14163834185	2	0.5543423222487264	0.0	0	2	0.5543423222487264	0.0
14163834186	2	0.2397572077374689	1.0	1	1	0.2397572077374689	1.0
14163834187	9	1.1990430367153653	4.0	4	5	0.23980860734307305	0.8
14163834188	4	0.7246100981673209	1.0	1	3	0.24153669938910696	0.3333333333333333
14163834189	30	6.345149193365243	8.0	8	22	0.3021499615888211	0.36363636363636365
14163834190	11	1.6066433906070032	5.0	5	6	0.26777389843450056	0.8333333333333334
14163834191	3	0.719949386910043	0.0	0	3	0.2399831289700143	0.0
14163834192	2	0.2400082462933346	1.0	1	1	0.2400082462933346	1.0
14163834193	16	9.84897913063557	0.0	0	16	0.7034985093311121	0.0
14163834194	21	4.096310053087449	4.0	4	17	0.240959414887497	0.23529411764705882
14163834195	2	0.24014484278222234	1.0	1	1	0.24014484278222234	1.0
14163834196	11	1.4438823947664117	5.0	5	6	0.24064706579440195	0.8333333333333334
14163834197	6	4.126705313899708	0.0	0	6	0.6877842189832847	0.0
14163834198	2	0.48034190670180354	0.0	0	2	0.24017095335090177	0.0
14163834199	2	0.4831692890420425	0.0	0	2	0.24158464452102124	0.0
14163834200	2	0.48316959206605037	0.0	0	2	0.24158479603302518	0.0
14163834201	1	0.24021231612797808	0.0	0	1	0.24021231612797808	0.0
14163834202	3	0.48045395824605264	1.0	1	2	0.24022697912302632	0.5
14163834203	2	0.48308535139185826	0.0	0	2	0.24154267569592913	0.0
14163834204	3	0.48191685714811916	1.0	1	2	0.24095842857405958	0.5
14163834205	3	0.4819400553193895	1.0	1	2	0.24097002765969475	0.5
14163834206	34	6.763053676629009	6.0	6	28	0.2415376313081789	0.21428571428571427
14163834207	25	4.836197241289633	5.0	5	20	0.24180986206448166	0.25
14163834208	2	0.4813246808980433	0.0	0	2	0.24066234044902166	0.0
14163834209	18	3.389553119384692	4.0	4	14	0.24211093709890658	0.2857142857142857
14163834210	25	4.604817704628829	6.0	6	19	0.24235882655941204	0.3157894736842105
14163834211	28	5.08784325928313	7.0	7	21	0.24227825044205384	0.3333333333333333
14163834212	19	3.635403937904724	4.0	4	15	0.2423602625269816	0.26666666666666666
14163834213	26	4.617662420952398	7.0	7	19	0.24303486426065254	0.3684210526315789
14163834214	14	2.426795308663116	4.0	4	10	0.2426795308663116	0.4
14163834215	3	0.7274965365197632	0.0	0	3	0.24249884550658773	0.0
14163834216	5	1.3371983147690165	2.0	2	3	0.44573277158967217	0.6666666666666666
14163834217	1	0.24168013075283926	0.0	0	1	0.24168013075283926	0.0
14665197411	1	0.3650722811583342	0.0	0	1	0.3650722811583342	0.0
14665197412	4	1.1760583626932735	1.0	1	3	0.5880291813466367	0.3333333333333333
14665197413	1	0.365095883361615	0.0	0	1	0.365095883361615	0.0
14665197414	2	0.3651190141942169	1.0	1	1	0.3651190141942169	1.0
14665197415	2	1.1526161897579434	0.0	0	2	0.5763080948789717	0.0
14850879364	2	1.0101429879386008	0.0	0	2	0.5050714939693004	0.0
14850879365	2	1.0081590224203087	0.0	0	2	0.5040795112101544	0.0
14850879366	2	0.9847832454120398	0.0	0	2	0.4923916227060199	0.0
14850879367	1	0.12806430923640408	0.0	0	1	0.12806430923640408	0.0
14850879368	2	1.008240434870427	0.0	0	2	0.5041202174352135	0.0
14850879369	3	1.8909158351828177	0.0	0	3	0.6303052783942725	0.0
14850879370	1	0.1280931638558216	0.0	0	1	0.1280931638558216	0.0
14850879371	1	0.12812747290738102	0.0	0	1	0.12812747290738102	0.0
14850879372	3	1.3173324311747465	0.0	0	3	0.4391108103915822	0.0
14850879373	3	0.6633555121093948	0.0	0	3	0.22111850403646494	0.0
14850879374	3	1.6166247320720644	0.0	0	3	0.5388749106906882	0.0
14850879375	2	0.5755978066044891	0.0	0	2	0.28779890330224456	0.0
14850879376	4	0.5863494350975941	0.0	0	4	0.14658735877439852	0.0
14850879377	3	0.4533730056853701	0.0	0	3	0.1511243352284567	0.0
14850879378	2	0.45991886296503537	0.0	0	2	0.22995943148251768	0.0
14850879379	1	0.12825087101725866	0.0	0	1	0.12825087101725866	0.0
14850879380	3	1.1067575128153062	0.0	0	3	0.3689191709384354	0.0
15012942113	3	0.11696592027027587	0.0	0	3	0.03898864009009196	0.0
15012942114	4	0.43446817956677464	1.0	1	3	0.14482272652225822	0.3333333333333333
15012942115	14	0.7189889354823842	5.5	6	8	0.10271270506891203	0.75
15012942116	6	0.23751095810568515	0.0	0	6	0.039585159684280856	0.0
15012942117	3	0.6448786905672701	0.0	0	3	0.21495956352242337	0.0
15012942118	1	0.039057370424324854	0.0	0	1	0.039057370424324854	0.0
15012942119	4	0.38350327873659995	1.0	1	3	0.12783442624553332	0.3333333333333333
15012942120	4	0.9424970868450309	0.0	0	4	0.3141656956150103	0.0
15012942121	2	0.07817521097288989	0.0	0	2	0.039087605486444944	0.0
15012942122	1	0.03912326131137276	0.0	0	1	0.03912326131137276	0.0
15012942123	7	2.214847455862617	0.0	0	7	0.3691412426437695	0.0
15012942124	2	0.07986682566224129	0.0	0	2	0.039933412831120646	0.0
15012942125	3	0.5233431009194186	0.0	0	3	0.17444770030647286	0.0
15012942126	3	0.24907230041719336	1.0	1	2	0.12453615020859668	0.5
15012942127	1	0.03916858023521868	0.0	0	1	0.03916858023521868	0.0
15012942128	2	0.07837052678063894	0.0	0	2	0.03918526339031947	0.0
15012942129	5	0.5843767151369279	2.0	2	3	0.19479223837897597	0.6666666666666666
15012942130	6	0.9771179837779127	0.5	1	5	0.48855899188895635	0.2
15012942131	8	0.15779002166857342	4.0	4	4	0.039447505417143355	1.0
15012942132	14	1.8176704207862078	4.0	4	10	0.22720880259827597	0.4
15012942133	8	0.15894016612516837	4.0	4	4	0.03973504153129209	1.0
15012942134	10	1.4172474598760019	4.0	4	6	0.23620790997933364	0.6666666666666666
15012942135	4	1.0447726388983771	1.0	1	3	0.34825754629945904	0.3333333333333333
15012942136	10	0.19964649219240127	5.0	5	5	0.039929298438480254	1.0
15012942137	8	0.16006940192521926	4.0	4	4	0.040017350481304816	1.0
15012942138	9	0.200597751891821	4.0	4	5	0.0401195503783642	0.8
15012942139	10	0.20111124290784937	5.0	5	5	0.04022224858156988	1.0
15012942140	8	0.16125143124131058	4.0	4	4	0.040312857810327646	1.0
15012942141	12	1.385704243113872	5.0	5	7	0.19795774901626742	0.7142857142857143
15012942142	8	0.16592806809366958	4.0	4	4	0.041482017023417396	1.0
15012942143	2	0.13626854957255602	0.0	0	2	0.06813427478627801	0.0
15012942144	24	1.8703283167484366	4.0	4	20	0.09351641583742183	0.2
15012942145	14	0.47767162547498593	4.0	4	10	0.04776716254749859	0.4
15012942146	2	0.08114205169542438	0.0	0	2	0.04057102584771219	0.0
15012942147	4	1.6699504256090032	0.0	0	4	0.4174876064022508	0.0
15012942148	3	1.8052730015676106	0.0	0	3	0.6017576671892035	0.0
15012942149	4	0.8263516209107711	0.0	0	4	0.20658790522769277	0.0
15012942150	3	0.24576701554718544	0.0	0	3	0.08192233851572849	0.0
15012942151	1	0.04063201784663261	0.0	0	1	0.04063201784663261	0.0
15012942152	2	0.0812863921311803	0.0	0	2	0.04064319606559015	0.0
15012942153	3	0.2460506796879001	0.0	0	3	0.08201689322930003	0.0
15012942154	3	0.2231742525752916	0.0	0	3	0.0743914175250972	0.0
15012942155	3	0.9643032668311233	0.0	0	3	0.3214344222770411	0.0
15012942156	9	2.4038610713036705	2.0	2	7	0.3434087244719529	0.2857142857142857
15012942157	10	6.649874007667921	0.0	0	10	0.6649874007667921	0.0
15012942158	1	0.040736157097342456	0.0	0	1	0.040736157097342456	0.0
15012942159	6	0.8227439180808938	2.0	2	4	0.20568597952022344	0.5
15012942160	2	0.4247374052869003	0.0	0	2	0.21236870264345015	0.0
15012942161	1	0.04077026413289663	0.0	0	1	0.04077026413289663	0.0
15012942162	1	0.040783664527911996	0.0	0	1	0.040783664527911996	0.0
15012942163	2	0.7104910648825915	0.0	0	2	0.35524553244129575	0.0
15012942164	2	0.21771072971312347	0.0	0	2	0.10885536485656173	0.0
15012942165	3	1.440423308377735	0.0	0	3	0.4801411027925783	0.0
15012942166	1	0.04082908445976055	0.0	0	1	0.04082908445976055	0.0
15012942167	11	1.4044776914903823	5.0	5	6	0.23407961524839704	0.8333333333333334
15012942168	5	1.8247039110332288	0.0	0	5	0.3649407822066458	0.0
15012942169	3	0.9570467509142992	0.0	0	3	0.31901558363809973	0.0
15012942170	3	1.8263232376620324	0.0	0	3	0.6087744125540108	0.0
15012942171	5	1.4044907888613896	1.0	1	4	0.3511226972153474	0.25
15012942172	1	0.04093635495855187	0.0	0	1	0.04093635495855187	0.0
15012942173	4	1.0944743673170156	0.0	0	4	0.2736185918292539	0.0
15012942174	2	0.08192826431854934	0.0	0	2	0.04096413215927467	0.0
15012942175	1	0.04098487246914769	0.0	0	1	0.04098487246914769	0.0
15012942176	2	0.8540733682401278	0.0	0	2	0.4270366841200639	0.0
15012942177	4	1.4870757398743601	0.0	0	4	0.37176893496859004	0.0
15012942178	2	0.26503139648580365	0.0	0	2	0.13251569824290182	0.0
15012942179	12	1.9325697846613759	5.0	5	7	0.276081397808768	0.7142857142857143
15012942180	3	0.8468325422330452	0.0	0	3	0.2822775140776817	0.0
15012942181	2	0.08218839359465158	0.0	0	2	0.04109419679732579	0.0
15012942182	2	0.7413139599086442	0.0	0	2	0.3706569799543221	0.0
15012942183	2	0.08217007747684164	0.0	0	2	0.04108503873842082	0.0
15012942184	1	0.041098573810773024	0.0	0	1	0.041098573810773024	0.0
15012942185	1	0.041109886707067396	0.0	0	1	0.041109886707067396	0.0
15012942186	2	0.08224212985204987	0.0	0	2	0.041121064926024936	0.0
15012942187	1	0.04113961672917435	0.0	0	1	0.04113961672917435	0.0
15012942188	1	0.0411497848681056	0.0	0	1	0.0411497848681056	0.0
15012942189	1	0.04115803385498692	0.0	0	1	0.04115803385498692	0.0
15012942190	11	2.8793656710902673	3.0	3	8	0.3599207088862834	0.375
15012942191	4	0.2659080449406152	0.0	0	4	0.0664770112351538	0.0
15012942192	2	0.08238852411719258	0.0	0	2	0.04119426205859629	0.0
15012942193	1	0.04125045617739187	0.0	0	1	0.04125045617739187	0.0
15012942194	4	2.0475421773224443	0.0	0	4	0.5118855443306111	0.0
15012942195	1	0.04127291362330958	0.0	0	1	0.04127291362330958	0.0
15012942196	1	0.04128412551160132	0.0	0	1	0.04128412551160132	0.0
15012942197	6	1.4167389182521024	2.0	2	4	0.3541847295630256	0.5
15012942198	2	1.0074187347690453	0.0	0	2	0.5037093673845227	0.0
15012942199	1	0.04135479744410697	0.0	0	1	0.04135479744410697	0.0
15012942200	3	1.6733948321679648	0.0	0	3	0.5577982773893216	0.0
15012942201	3	1.7871845221262577	0.0	0	3	0.5957281740420859	0.0
15012942202	1	0.041414998213673476	0.0	0	1	0.041414998213673476	0.0
15012942203	2	0.43214772272239327	0.0	0	2	0.21607386136119663	0.0
15012942204	2	0.08287060164440355	0.0	0	2	0.04143530082220177	0.0
15012942205	3	0.4697563690343537	1.0	1	2	0.23487818451717685	0.5
15012942206	12	0.6836815208249714	5.0	5	7	0.09766878868928162	0.7142857142857143
15012942207	1	0.041475737692587326	0.0	0	1	0.041475737692587326	0.0
15012942208	3	0.7060919643521211	1.0	1	2	0.35304598217606054	0.5
15012942209	7	0.6164884386071845	0.0	0	7	0.0880697769438835	0.0
15012942210	1	0.041515568514957114	0.0	0	1	0.041515568514957114	0.0
15012942211	5	2.4173208253552443	0.0	0	5	0.48346416507104883	0.0
15012942212	1	0.04154974288917971	0.0	0	1	0.04154974288917971	0.0
15012942213	2	0.343644881182098	0.0	0	2	0.171822440591049	0.0
15012942214	5	1.51406332737128	0.0	0	5	0.302812665474256	0.0
15012942215	1	0.04158169508734448	0.0	0	1	0.04158169508734448	0.0
15012942216	2	0.9093223888244477	0.0	0	2	0.45466119441222386	0.0
15012942217	4	1.2090426942982364	0.0	0	4	0.3022606735745591	0.0
15012942218	4	1.8610290823251248	0.0	0	4	0.6203430274417082	0.0
15012942219	2	0.7590781026535577	0.0	0	2	0.37953905132677884	0.0
15012942220	4	1.3770960044365408	1.0	1	3	0.45903200147884693	0.3333333333333333
15012942221	2	0.08337907592963473	0.0	0	2	0.041689537964817364	0.0
15012942222	1	0.04169239985822517	0.0	0	1	0.04169239985822517	0.0
15012942223	4	0.1673800918007865	0.0	0	4	0.041845022950196625	0.0
15012942224	12	1.16916914554334	4.0	4	8	0.1461461431929175	0.5
15012942225	2	0.08368088784148828	0.0	0	2	0.04184044392074414	0.0
15012942226	15	8.63995832140457	2.0	2	13	0.6646121785695823	0.15384615384615385
15012942227	32	1.1727611247941412	5.0	5	27	0.043435597214597825	0.18518518518518517
15012942228	7	4.971471771108324	0.0	0	7	0.7102102530154749	0.0
15012942229	8	0.2559332689957249	2.0	2	6	0.042655544832620816	0.3333333333333333
15012942230	18	1.327686626846843	3.5	7	11	0.22128110447447383	0.6363636363636364
15012942231	3	0.9535281708120743	1.0	1	2	0.47676408540603715	0.5
15012942232	2	0.04351438220963558	1.0	1	1	0.04351438220963558	1.0
15012942233	8	0.1748580845980405	4.0	4	4	0.043714521149510126	1.0
15012942234	11	1.8459682167545544	1.0	1	10	0.18459682167545544	0.1
15012942235	2	0.08736030635323165	0.0	0	2	0.043680153176615825	0.0
15012942236	18	12.030187083318838	1.0	1	17	0.7076580637246375	0.058823529411764705
15012942237	10	0.21985758747032091	5.0	5	5	0.04397151749406418	1.0
15012942238	22	14.47881143344598	2.0	2	20	0.723940571672299	0.1
15012942239	22	0.7843395980628954	7.0	7	15	0.052289306537526364	0.4666666666666667
15012942240	4	0.08992580861198944	2.0	2	2	0.04496290430599472	1.0
15012942241	3	0.08982836955878729	1.0	1	2	0.04491418477939364	0.5
15012942242	2	0.04491987489687504	1.0	1	1	0.04491987489687504	1.0
15012942243	11	0.4448158433880347	5.0	5	6	0.07413597389800579	0.8333333333333334
15012942244	2	0.0899092769688926	0.0	0	2	0.0449546384844463	0.0
15012942245	1	0.04498691054128606	0.0	0	1	0.04498691054128606	0.0
15012942246	1	0.04499084985338857	0.0	0	1	0.04499084985338857	0.0
15012942247	2	0.04500266778969609	1.0	1	1	0.04500266778969609	1.0
15012942248	18	7.383469777749062	0.0	0	18	0.4343217516322978	0.0
15012942249	55	12.228476634003933	10.0	12	43	0.34938504668582665	0.27906976744186046
15012942250	11	1.1686281130119285	5.0	5	6	0.19477135216865474	0.8333333333333334
15012942251	10	3.581310482539807	3.0	3	7	0.5116157832199725	0.42857142857142855
15012942252	7	0.9505417682063642	1.3333333333333333	2	5	0.31684725606878805	0.4
15012942253	3	0.22905608324567803	0.5	1	2	0.22905608324567803	0.5
15012942254	1	0.045159869911120025	0.0	0	1	0.045159869911120025	0.0
15012942255	3	0.21525764936129105	0.5	1	2	0.21525764936129105	0.5
15012942256	3	0.0903957315095508	1.0	1	2	0.0451978657547754	0.5
15012942257	1	0.04519892633880299	0.0	0	1	0.04519892633880299	0.0
15012942258	1	0.04521895959265762	0.0	0	1	0.04521895959265762	0.0
15012942259	3	0.09046919799679583	1.0	1	2	0.045234598998397914	0.5
15012942260	4	0.09064882389480326	2.0	2	2	0.04532441194740163	1.0
15012942261	18	1.9063201279623248	4.0	8	10	0.3177200213270541	0.8
15012942262	4	1.2495948821534584	1.0	1	3	0.4165316273844861	0.3333333333333333
15012942263	17	4.770880921430016	3.0	3	14	0.3407772086735726	0.21428571428571427
15012942264	38	15.59616377666497	2.5	3	35	0.5031020573117732	0.08571428571428572
15012942265	28	16.10004704616069	4.0	4	24	0.7666689069600329	0.16666666666666666
15012942266	24	2.337552011124887	4.0	8	16	0.2597280012360985	0.5
15012942267	8	0.8174139277982002	1.0	2	6	0.16348278555964005	0.3333333333333333
15012942268	13	1.6389341002579172	3.0	5	8	0.32778682005158344	0.625
15012942269	34	18.23428368508304	0.0	0	34	0.7293713474033215	0.0
15012942270	50	16.521161395401318	6.5	11	39	0.6608464558160527	0.28205128205128205
15012942271	10	1.8741632539148936	5.0	5	5	0.3748326507829787	1.0
15012942272	6	2.4376988531921744	0.5	1	5	0.8125662843973914	0.2
15012942273	4	0.09128439991667514	2.0	2	2	0.04564219995833757	1.0
15012942274	3	0.5674636658221612	0.5	1	2	0.5674636658221612	0.5
15012942275	9	0.4054028237864553	4.0	4	5	0.08108056475729106	0.8
15012942276	6	3.2772446107769415	0.0	0	6	0.8193111526942354	0.0
15012942277	7	1.3003958469953671	3.0	3	4	0.3250989617488418	0.75
15012942278	45	12.582535271910341	4.5	9	36	0.5991683462814448	0.25
15012942279	11	0.45233487910368997	5.0	5	6	0.07538914651728167	0.8333333333333334
15012942280	6	2.9315817580489996	0.0	0	6	0.9771939193496665	0.0
15012942281	43	12.517526891781408	4.0	8	35	0.6258763445890704	0.22857142857142856
15012942282	2	0.12985659523504176	0.0	0	2	0.06492829761752088	0.0
15012942283	9	0.23050133941661885	4.0	4	5	0.04610026788332377	0.8
15012942284	6	2.932223832252374	0.0	0	6	0.9774079440841247	0.0
15012942285	5	1.0584605026892202	2.0	2	3	0.3528201675630734	0.6666666666666666
15012942286	43	12.472514594562128	5.0	10	33	0.7336773290918899	0.30303030303030304
15012942287	10	1.8133231710304198	5.0	5	5	0.36266463420608397	1.0
15012942288	15	3.413133942638296	5.5	6	9	0.426641742829787	0.6666666666666666
15012942289	2	0.04622924163494651	1.0	1	1	0.04622924163494651	1.0
15012942290	1	0.04623708658981731	0.0	0	1	0.04623708658981731	0.0
15012942291	2	0.04626045310775867	1.0	1	1	0.04626045310775867	1.0
15012942292	3	0.7135899230645613	0.0	0	3	0.2378633076881871	0.0
15012942293	9	0.2317106072240856	4.0	4	5	0.04634212144481712	0.8
15012942294	6	2.932817355275818	0.0	0	6	0.9776057850919394	0.0
15012942295	3	0.09274595204537334	1.0	1	2	0.04637297602268667	0.5
15012942296	21	5.291396437993191	1.5	3	18	0.4409497031660992	0.16666666666666666
15012942297	5	0.625062166216951	0.5	1	4	0.20835405540565033	0.25
15012942298	1	0.046473681001307145	0.0	0	1	0.046473681001307145	0.0
15012942299	4	1.5122723881460107	0.0	0	4	0.5040907960486702	0.0
15012942300	3	0.4743403815483025	0.5	1	2	0.4743403815483025	0.5
15012942301	31	8.197643739185622	3.5	7	24	0.5855459813704016	0.2916666666666667
15012942302	6	2.9335694608633887	0.0	0	6	0.9778564869544629	0.0
15012942303	2	0.04658300532948524	1.0	1	1	0.04658300532948524	1.0
15012942304	47	12.478798908453653	5.0	10	37	0.594228519450174	0.2702702702702703
15012942305	8	5.743940201646316	0.0	0	8	0.7179925252057895	0.0
15012942306	15	2.762182145912996	7.0	7	8	0.3452727682391245	0.875
15012942307	3	0.5689328945590592	0.5	1	2	0.5689328945590592	0.5
15012942308	9	2.751276884247893	3.0	3	6	0.4585461473746488	0.5
15012942309	2	0.8997063596355591	0.0	0	2	0.44985317981777956	0.0
15012942310	2	0.9487666535681734	0.0	0	2	0.9487666535681734	0.0
15012942311	4	0.9954871981279042	1.0	1	3	0.4977435990639521	0.3333333333333333
15012942312	1	0.046708086906073365	0.0	0	1	0.046708086906073365	0.0
15012942313	2	0.04672475322650704	1.0	1	1	0.04672475322650704	1.0
15012942314	1	0.04673259818137785	0.0	0	1	0.04673259818137785	0.0
15012942315	13	1.415640186868845	6.0	6	7	0.202234312409835	0.8571428571428571
15012942316	4	1.9560848517052691	0.0	0	4	0.9780424258526346	0.0
15012942317	4	0.0936625323305573	2.0	2	2	0.04683126616527865	1.0
15012942318	45	11.849334544127487	4.5	9	36	0.5642540259108327	0.25
15012942319	11	0.45811065137131657	5.0	5	6	0.07635177522855276	0.8333333333333334
15012942320	6	2.9348356298456695	0.0	0	6	0.9782785432818898	0.0
15012942321	2	0.04698511818794875	1.0	1	1	0.04698511818794875	1.0
15012942322	33	11.090338257956054	3.0	6	27	0.7921670184254325	0.2222222222222222
15012942323	2	0.04710144573764242	1.0	1	1	0.04710144573764242	1.0
15012942324	6	3.0083740684579046	1.0	1	5	0.6016748136915809	0.2
15012942325	1	0.0471159572206867	0.0	0	1	0.0471159572206867	0.0
15012942326	3	0.35561278070418534	1.0	1	2	0.17780639035209267	0.5
15012942327	2	0.7841316225854837	0.0	0	2	0.3920658112927419	0.0
15012942328	10	1.8679393764782732	1.0	2	8	0.3113232294130455	0.25
15012942329	12	0.4858852932247165	5.0	6	6	0.0971770586449433	1.0
15012942330	6	2.9357168236605995	0.0	0	6	0.9785722745535331	0.0
15012942331	2	0.047220231148733374	1.0	1	1	0.047220231148733374	1.0
15012942332	47	13.049737114888892	5.0	10	37	0.6214160530899472	0.2702702702702703
15012942333	9	1.9980325997941388	4.0	4	5	0.3996065199588278	0.8
15012942334	13	5.142689729307644	4.0	4	9	0.6428362161634555	0.4444444444444444
15012942335	4	2.9481123910658154	0.0	0	4	0.7370280977664538	0.0
15012942336	10	6.478125791124137	0.5	1	9	0.8097657238905172	0.1111111111111111
15012942337	14	4.084995338649025	4.5	5	9	0.5106244173311282	0.5555555555555556
15012942338	2	0.44439309122770076	0.0	0	2	0.44439309122770076	0.0
15012942339	2	0.6140546171145199	0.0	0	2	0.6140546171145199	0.0
15012942340	3	1.4764697649210454	0.0	0	3	0.7382348824605227	0.0
15012942341	3	1.1692582346016582	0.0	0	3	0.5846291173008291	0.0
15012942342	4	0.0948352352410726	2.0	2	2	0.0474176176205363	1.0
15012942343	5	0.1423040807536086	2.0	2	3	0.0474346935845362	0.6666666666666666
15012942344	6	2.9364008161850643	0.0	0	6	0.9788002720616881	0.0
15012942345	2	0.04746015882430995	1.0	1	1	0.04746015882430995	1.0
15012942346	47	12.705777459101272	5.0	10	37	0.6050370218619653	0.2702702702702703
15012942347	10	0.41394143428064134	5.0	5	5	0.08278828685612827	1.0
15012942348	6	2.9369339027536028	0.0	0	6	0.9789779675845343	0.0
15012942349	2	0.04761934743645225	1.0	1	1	0.04761934743645225	1.0
15012942350	33	9.221054397624131	3.5	7	26	0.658646742687438	0.2692307692307692
15012942351	17	4.413100104957415	7.0	7	10	0.44131001049574153	0.7
15012942352	5	1.9173625921643311	0.0	0	5	0.3834725184328662	0.0
15012942353	9	2.1627138251033644	4.0	4	5	0.4325427650206729	0.8
15012942354	2	0.76930364779964	0.0	0	2	0.76930364779964	0.0
15012942355	8	4.516047225550904	0.5	1	7	0.7526745375918172	0.14285714285714285
15012942356	1	0.047734799583456465	0.0	0	1	0.047734799583456465	0.0
15012942357	4	0.49029149798470517	0.3333333333333333	1	3	0.49029149798470517	0.3333333333333333
15012942358	13	0.8762887316448679	4.0	5	8	0.14604812194081132	0.625
15012942359	2	0.2923125132383614	0.0	0	2	0.1461562566191807	0.0
15012942360	34	8.394031342850555	4.5	9	25	0.645694718680812	0.36
15012942361	8	0.36713499924934223	4.0	4	4	0.09178374981233556	1.0
15012942362	6	2.9376808232637055	0.0	0	6	0.9792269410879019	0.0
15012942363	3	0.09574535101408836	1.0	1	2	0.04787267550704418	0.5
15012942364	1	0.04788580654738587	0.0	0	1	0.04788580654738587	0.0
15012942365	13	4.036220055630494	1.5	3	10	0.8072440111260988	0.3
15012942366	7	3.920737168524142	0.0	0	7	0.9801842921310355	0.0
15012942367	2	0.04803802560734681	1.0	1	1	0.04803802560734681	1.0
15012942368	15	3.409781621708397	1.0	2	13	0.37886462463426634	0.15384615384615385
15012942369	35	8.524715126288454	4.0	8	27	0.5327946953930284	0.2962962962962963
15012942370	11	0.4647924317531854	5.0	5	6	0.07746540529219757	0.8333333333333334
15012942371	4	1.9593214174641558	0.0	0	4	0.9796607087320779	0.0
15012942372	3	0.0963990074684307	1.0	1	2	0.04819950373421535	0.5
15012942373	9	0.24244923935418577	4.0	4	5	0.048489847870837155	0.8
15012942374	6	0.2937027537172039	0.0	0	6	0.048950458952867315	0.0
15012942375	8	0.194820632850826	4.0	4	4	0.0487051582127065	1.0
15012942376	2	0.09723723921290928	0.0	0	2	0.04861861960645464	0.0
15012942377	3	0.14857152630869588	0.0	0	3	0.049523842102898626	0.0
15012942378	12	3.8299327249666226	3.0	3	9	0.42554808055184695	0.3333333333333333
15012942379	2	0.04897881414382738	1.0	1	1	0.04897881414382738	1.0
15012942380	8	0.19670591355055014	4.0	4	4	0.049176478387637536	1.0
15012942381	27	1.1455868745083648	4.0	4	23	0.04980812497862456	0.17391304347826086
15012942382	9	3.8456813540270898	1.5	2	7	0.6409468923378483	0.2857142857142857
15012942383	4	0.35335898914153874	0.5	1	3	0.17667949457076937	0.3333333333333333
15012942384	1	0.049189718853315405	0.0	0	1	0.049189718853315405	0.0
15012942385	3	0.4381335916354869	1.0	1	2	0.21906679581774344	0.5
15012942386	9	1.1801010059824684	4.0	4	5	0.23602020119649367	0.8
15012942387	9	0.24798606035692794	4.0	4	5	0.04959721207138559	0.8
15012942388	1	0.049498331970679266	0.0	0	1	0.049498331970679266	0.0
15012942389	12	2.068027408319497	5.0	5	7	0.2954324869027853	0.7142857142857143
15012942390	2	0.09942258101910811	0.0	0	2	0.04971129050955406	0.0
15012942391	13	2.168011459155882	5.0	5	8	0.27100143239448526	0.625
15012942392	24	0.9585663826445088	5.0	5	19	0.05045086224444783	0.2631578947368421
15012942393	18	0.8245714895417829	2.0	2	16	0.051535718096361434	0.125
15012942394	3	1.9149850657984646	0.0	0	3	0.9574925328992323	0.0
15012942395	4	0.7313770282954054	0.3333333333333333	1	3	0.7313770282954054	0.3333333333333333
15012942396	4	1.0075764082611482	1.0	1	3	0.5037882041305741	0.3333333333333333
15012942397	1	0.05007158605492943	0.0	0	1	0.05007158605492943	0.0
15012942398	2	0.05008586185263424	1.0	1	1	0.05008586185263424	1.0
15012942399	3	0.7991290551304036	0.0	0	3	0.2663763517101345	0.0
15012942400	1	0.050100407005012726	0.0	0	1	0.050100407005012726	0.0
15012942401	2	0.428395814134097	0.0	0	2	0.2141979070670485	0.0
15012942402	8	0.2012420819405873	4.0	4	4	0.05031052048514682	1.0
15012942403	10	0.2526255936029881	5.0	5	5	0.05052511872059762	1.0
15012942404	1	0.050426662853502335	0.0	0	1	0.050426662853502335	0.0
15012942405	8	0.20288713194072702	4.0	4	4	0.050721782985181756	1.0
15012942406	10	0.25469528124617746	5.0	5	5	0.05093905624923549	1.0
15012942407	1	0.05085429706729661	0.0	0	1	0.05085429706729661	0.0
15012942408	8	0.21004745456971483	4.0	4	4	0.052511863642428706	1.0
15012942409	3	0.12903186489358118	0.5	1	2	0.12903186489358118	0.5
15012942410	2	0.7315087427308329	0.0	0	2	0.7315087427308329	0.0
15012942411	3	0.3980863427854041	0.5	1	2	0.3980863427854041	0.5
15012942412	2	0.7292611799950149	0.0	0	2	0.7292611799950149	0.0
15012942413	4	0.4055059192878047	1.0	2	2	0.4055059192878047	1.0
15012942414	2	0.10447203840916841	0.0	0	2	0.052236019204584205	0.0
15012942415	4	1.3786927052727558	0.5	1	3	0.6893463526363779	0.3333333333333333
15012942416	7	1.9105785916838023	0.5	1	6	0.6368595305612674	0.16666666666666666
15012942417	8	6.172791090501588	0.0	0	8	0.7715988863126985	0.0
15012942418	3	0.408200105741911	0.5	1	2	0.408200105741911	0.5
15012942419	3	0.8727970196713422	0.0	0	3	0.8727970196713422	0.0
15012942420	9	4.049416919520561	0.5	1	8	0.8098833839041122	0.125
15012942421	15	1.5510720534862963	6.5	7	8	0.22158172192661377	0.875
15012942422	7	1.0756860707641192	1.5	2	5	0.2689215176910298	0.4
15012942423	1	0.052886645418847696	0.0	0	1	0.052886645418847696	0.0
15012942424	19	2.388648963083831	3.5	7	12	0.34123556615483297	0.5833333333333334
15012942425	9	1.7321668098679566	4.0	4	5	0.3464333619735913	0.8
15012942426	4	0.4844176132771922	0.3333333333333333	1	3	0.4844176132771922	0.3333333333333333
15012942427	1	0.05292078612373608	0.0	0	1	0.05292078612373608	0.0
15012942428	2	0.05292863107860689	1.0	1	1	0.05292863107860689	1.0
15012942429	3	0.8168746124028332	1.0	1	2	0.4084373062014166	0.5
15012942430	1	0.05295990989008747	0.0	0	1	0.05295990989008747	0.0
15012942431	3	0.1059342639245508	1.0	1	2	0.0529671319622754	0.5
15012942432	1	0.05296997702101609	0.0	0	1	0.05296997702101609	0.0
15012942433	2	0.05299128970957068	1.0	1	1	0.05299128970957068	1.0
15012942434	10	0.37828513798215035	5.0	5	5	0.07565702759643007	1.0
15012942435	27	1.1733112480457897	5.0	5	22	0.053332329456626804	0.22727272727272727
15012942436	8	0.2130499174478429	4.0	4	4	0.05326247936196073	1.0
15012942437	9	0.266962198125379	4.0	4	5	0.053392439625075803	0.8
15012942438	17	0.8135095644646037	2.0	2	15	0.05423397096430691	0.13333333333333333
15012942439	8	0.21402073903043833	4.0	4	4	0.053505184757609583	1.0
15012942440	8	0.21663819307188129	4.0	4	4	0.05415954826797032	1.0
15012942441	2	0.054340823963354025	1.0	1	1	0.054340823963354025	1.0
15012942442	8	0.21784042398849826	4.0	4	4	0.054460105997124565	1.0
15012942443	10	0.2728927146530323	5.0	5	5	0.054578542930606454	1.0
15012942444	7	0.21875518612963496	3.0	3	4	0.05468879653240874	0.75
15012942445	3	1.0367639837246478	1.0	1	2	0.5183819918623239	0.5
15012942446	10	0.27405524942461634	5.0	5	5	0.05481104988492327	1.0
15012942447	13	0.40551184509062554	3.5	5	8	0.0811023690181251	0.625
15012942448	6	0.5565063176970364	0.0	0	6	0.09275105294950607	0.0
15012942449	21	0.9292741628902861	7.0	7	14	0.06637672592073472	0.5
15012942450	5	3.070363723420291	0.0	0	5	0.6140727446840583	0.0
15012942451	9	1.6599816428056022	2.5	3	6	0.33199632856112044	0.5
15012942452	3	1.5342903482442805	0.0	0	3	0.7671451741221402	0.0
15012942453	9	2.1639449106393984	4.0	4	5	0.4327889821278797	0.8
15012942454	4	1.0666240704696472	0.5	1	3	0.5333120352348236	0.3333333333333333
15012942455	12	3.2204405383228236	5.0	5	7	0.46006293404611764	0.7142857142857143
15012942456	5	0.17855201459282816	0.6666666666666666	2	3	0.17855201459282816	0.6666666666666666
15012942457	3	0.5598400531544513	0.5	1	2	0.5598400531544513	0.5
15012942458	2	0.05615842930131721	1.0	1	1	0.05615842930131721	1.0
15012942459	9	0.45732800769761783	4.0	4	5	0.09146560153952357	0.8
15012942460	2	0.11238244646567444	0.0	0	2	0.05619122323283722	0.0
15012942461	5	0.12574910480815937	1.0	2	3	0.06287455240407969	0.6666666666666666
15012942462	3	0.4530565812824697	1.0	1	2	0.22652829064123484	0.5
15012942463	45	18.692706619529147	0.0	0	45	0.4559196736470524	0.0
15012942464	36	4.666790019884099	11.0	11	25	0.18667160079536393	0.44
15012942465	8	1.9249773497971439	2.5	3	5	0.48124433744928596	0.6
15012942466	9	5.5761380310718796	0.0	0	9	0.6970172538839849	0.0
15012942467	3	0.10445527108073209	0.5	1	2	0.10445527108073209	0.5
15012942468	4	1.582686918591624	0.0	0	4	0.791343459295812	0.0
15012942469	3	0.6274076057073158	0.5	1	2	0.6274076057073158	0.5
15012942470	2	0.9042449522176593	0.0	0	2	0.9042449522176593	0.0
15012942471	16	1.9597376041043186	4.0	7	9	0.32662293401738646	0.7777777777777778
15012942472	6	1.034352485000564	2.0	2	4	0.258588121250141	0.5
15012942473	21	5.642047436253597	3.0	3	18	0.3134470797918665	0.16666666666666666
15012942474	46	16.625689863614618	8.0	8	38	0.44934296928688156	0.21052631578947367
15012942475	30	11.506200224729339	5.0	5	25	0.47942500936372245	0.2
15012942476	14	1.8278568421659387	3.0	4	10	0.22848210527074234	0.4
15012942477	3	0.3885808500207252	1.0	1	2	0.1942904250103626	0.5
15012942478	1	0.05663872235381508	0.0	0	1	0.05663872235381508	0.0
15012942479	19	3.184617511481327	6.0	7	12	0.3184617511481327	0.5833333333333334
15012942480	43	2.5121814136049765	6.0	7	36	0.07612670950318111	0.19444444444444445
15012942481	8	2.494393399302109	3.0	3	5	0.4988786798604218	0.6
15012942482	11	1.0764703979045285	5.0	5	6	0.17941173298408808	0.8333333333333334
15012942483	16	1.5104674761470447	8.0	8	8	0.18880843451838059	1.0
15012942484	10	5.565866762969941	1.0	1	9	0.6957333453712427	0.1111111111111111
15012942485	8	3.061363742039433	1.5	2	6	0.6122727484078866	0.3333333333333333
15012942486	3	0.3126702721360974	0.5	1	2	0.3126702721360974	0.5
15012942487	6	0.8970812626552505	1.0	2	4	0.4485406313276252	0.5
15012942488	2	0.6133139591005803	0.0	0	2	0.6133139591005803	0.0
15012942489	4	1.2266488268577047	1.0	1	3	0.6133244134288524	0.3333333333333333
15012942490	3	0.923098196916246	0.0	0	3	0.461549098458123	0.0
15012942491	9	0.285904397204947	4.0	4	5	0.057180879440989395	0.8
15012942492	27	8.402120838095719	4.0	4	23	0.3819145835498054	0.17391304347826086
15012942493	6	1.2654939457991732	0.0	0	6	0.21091565763319553	0.0
15012942494	3	0.6131849382118897	0.0	0	3	0.20439497940396323	0.0
15012942495	4	0.23783149016735916	1.0	1	3	0.07927716338911972	0.3333333333333333
15012942496	4	0.3969041787919759	0.0	0	4	0.09922604469799398	0.0
15012942497	2	1.0074179267050243	0.0	0	2	0.5037089633525121	0.0
15012942498	3	0.30023342612714077	0.0	0	3	0.10007780870904692	0.0
15012942499	2	0.17878099973478667	0.0	0	2	0.08939049986739334	0.0
15012942500	4	1.1418778606518512	0.0	0	4	0.2854694651629628	0.0
15012942501	1	0.05695514675671553	0.0	0	1	0.05695514675671553	0.0
15012942502	2	0.27799826515388554	0.0	0	2	0.13899913257694277	0.0
15012942503	8	2.456361361112464	0.0	0	8	0.4912722722224928	0.0
15012942504	3	1.9821339738497687	0.0	0	3	0.6607113246165895	0.0
15012942505	13	0.6636601185759878	3.5	5	8	0.13273202371519757	0.625
15012942506	5	0.15887562201148886	1.0	2	3	0.07943781100574443	0.6666666666666666
15012942507	47	5.824049042482854	12.5	15	32	0.21570552009195756	0.46875
15012942508	13	0.4831333301931068	3.5	5	8	0.09662666603862136	0.625
15012942509	62	7.122463785853339	14.5	21	41	0.22975689631784962	0.5121951219512195
15012942510	10	0.34271473215522763	3.0	4	6	0.08567868303880691	0.6666666666666666
15012942511	54	7.16848192076279	13.5	16	38	0.2240150600238372	0.42105263157894735
15012942512	20	4.973609841169292	2.5	5	15	0.4973609841169292	0.3333333333333333
15012942513	9	0.29226520782379706	3.5	4	5	0.07306630195594926	0.8
15012942514	41	5.453022642593586	9.0	11	30	0.20196380157754024	0.36666666666666664
15012942515	5	0.1646930769148668	1.5	2	3	0.0823465384574334	0.6666666666666666
15012942516	6	0.31109939567922107	1.0	2	4	0.15554969783961053	0.5
15012942517	11	0.3193762607692628	3.0	4	7	0.06387525215385256	0.5714285714285714
15012942518	48	5.828533663122218	12.5	16	32	0.22417437165854684	0.5
15012942519	11	0.5830454970009545	2.5	4	7	0.14576137425023863	0.5714285714285714
15012942520	49	6.2284754219079	14.0	15	34	0.18874167945175455	0.4411764705882353
15012942521	13	0.6179925151049892	2.0	4	9	0.12359850302099784	0.4444444444444444
15012942522	4	0.18925074856189014	0.5	1	3	0.09462537428094507	0.3333333333333333
15012942523	41	5.781216632637632	8.5	11	30	0.24088402635990133	0.36666666666666664
15012942524	9	0.6811555463645754	1.5	3	6	0.22705184878819182	0.5
15012942525	10	0.2910295432583101	5.0	5	5	0.05820590865166202	1.0
15012942526	13	3.5179339540319985	5.0	5	8	0.4397417442539998	0.625
15012942527	15	0.6548472040159974	4.0	4	11	0.05953156400145431	0.36363636363636365
15012942528	7	3.35197477547352	0.0	0	7	0.5586624625789199	0.0
15012942529	6	2.842680338930333	0.0	0	6	0.4737800564883888	0.0
15012942530	4	0.6318662672900028	0.0	0	4	0.1579665668225007	0.0
15012942531	4	2.3290219526415896	0.0	0	4	0.5822554881603974	0.0
15012942532	3	0.3508913299679936	0.0	0	3	0.11696377665599787	0.0
15012942533	1	0.05841107610660075	0.0	0	1	0.05841107610660075	0.0
15012942534	4	1.0265644986432436	0.0	0	4	0.2566411246608109	0.0
15012942535	3	1.6815108925178222	0.0	0	3	0.560503630839274	0.0
15012942536	1	0.05844053677403402	0.0	0	1	0.05844053677403402	0.0
15012942537	11	2.5711568887609304	4.0	4	7	0.3673081269658472	0.5714285714285714
15012942538	3	1.4811007461562162	0.0	0	3	0.49370024871873874	0.0
15012942539	1	0.058472960342877724	0.0	0	1	0.058472960342877724	0.0
15012942540	1	0.05848120932975904	0.0	0	1	0.05848120932975904	0.0
15012942541	3	0.18967972954905282	0.0	0	3	0.06322657651635094	0.0
15012942542	7	4.235323394123428	0.0	0	7	0.6050461991604897	0.0
15012942543	1	0.05851848128272891	0.0	0	1	0.05851848128272891	0.0
15012942544	2	0.11709531152164279	0.0	0	2	0.058547655760821396	0.0
15012942545	4	0.49997331705263903	1.0	1	3	0.16665777235087967	0.3333333333333333
15012942546	5	0.9735524686238	1.0	1	4	0.24338811715595	0.25
15012942547	2	0.520900121367849	0.0	0	2	0.2604500606839245	0.0
15012942548	2	0.11722534249035971	0.0	0	2	0.058612671245179854	0.0
15012942549	2	0.117346754109519	0.0	0	2	0.0586733770547595	0.0
15012942550	6	1.7325115501809272	0.5	1	5	0.577503850060309	0.2
15012942551	2	0.18066951269059495	0.0	0	2	0.09033475634529747	0.0
15012942552	4	0.7063080878084116	0.0	0	4	0.1765770219521029	0.0
15012942553	7	2.954641750371718	0.0	0	7	0.4220916786245312	0.0
15012942554	1	0.05876817306522622	0.0	0	1	0.05876817306522622	0.0
15012942555	1	0.05878817264974664	0.0	0	1	0.05878817264974664	0.0
15012942556	3	0.5425420286723337	0.0	0	3	0.1808473428907779	0.0
15012942557	2	0.117620990836655	0.0	0	2	0.0588104954183275	0.0
15012942558	3	0.32487941243779545	1.0	1	2	0.16243970621889772	0.5
15012942559	2	0.11768031620353207	0.0	0	2	0.05884015810176604	0.0
15012942560	2	0.4947579371835945	0.0	0	2	0.24737896859179725	0.0
15012942561	1	0.05888392823623832	0.0	0	1	0.05888392823623832	0.0
15012942562	1	0.05889514012453007	0.0	0	1	0.05889514012453007	0.0
15012942563	4	1.502163338896293	0.0	0	4	0.500721112965431	0.0
15012942564	3	0.5728089083132515	0.0	0	3	0.19093630277108384	0.0
15012942565	5	1.3074513906562952	0.0	0	5	0.3268628476640738	0.0
15012942566	1	0.05895520621675974	0.0	0	1	0.05895520621675974	0.0
15012942567	4	0.9284251232895263	0.0	0	4	0.30947504109650875	0.0
15012942568	1	0.05897766366267745	0.0	0	1	0.05897766366267745	0.0
15012942569	3	1.8322240241675787	0.0	0	3	0.6107413413891929	0.0
15012942570	5	1.6013860924168681	1.0	1	4	0.40034652310421703	0.25
15012942571	2	0.5053991302604925	0.0	0	2	0.2526995651302463	0.0
15012942572	6	0.46972253135347325	2.0	2	4	0.11743063283836831	0.5
15012942573	2	0.1816105705817492	0.0	0	2	0.0908052852908746	0.0
15012942574	7	2.801800952485263	1.0	1	6	0.46696682541421053	0.16666666666666666
15012942575	3	0.9948167406757913	0.0	0	3	0.33160558022526376	0.0
15012942576	3	0.6575953287435072	0.0	0	3	0.2191984429145024	0.0
15012942577	3	0.2404491125554732	0.0	0	3	0.08014970418515772	0.0
15012942578	9	2.716287274436083	3.0	3	6	0.45271454573934716	0.5
15012942579	5	2.316797021422148	0.0	0	5	0.579199255355537	0.0
15012942580	5	1.5463787839828378	0.0	0	5	0.30927575679656755	0.0
15012942581	1	0.05921792803159611	0.0	0	1	0.05921792803159611	0.0
15012942582	3	0.663036293151755	0.0	0	3	0.2210120977172517	0.0
15012942583	3	0.24102711401584687	0.0	0	3	0.08034237133861562	0.0
15012942584	3	1.3168719356907637	0.0	0	3	0.4389573118969212	0.0
15012942585	1	0.05934058541612115	0.0	0	1	0.05934058541612115	0.0
15012942586	1	0.059368867656857095	0.0	0	1	0.059368867656857095	0.0
15012942587	2	0.11878483871227322	0.0	0	2	0.05939241935613661	0.0
15012942588	2	0.11881426571037228	0.0	0	2	0.05940713285518614	0.0
15012942589	2	0.18183329322754474	0.0	0	2	0.09091664661377237	0.0
15012942590	5	1.8507041453044564	0.0	0	5	0.3701408290608913	0.0
15012942591	2	0.11891268117426651	0.0	0	2	0.059456340587133255	0.0
15012942592	9	3.952066585014042	0.0	0	9	0.49400832312675524	0.0
15012942593	2	0.11897483476521717	0.0	0	2	0.059487417382608584	0.0
15012942594	3	0.6849674873757673	0.0	0	3	0.34248374368788365	0.0
15012942595	1	0.05951977361278387	0.0	0	1	0.05951977361278387	0.0
15012942596	1	0.05953138953308613	0.0	0	1	0.05953138953308613	0.0
15012942597	3	1.843860954134387	0.0	0	3	0.6146203180447957	0.0
15012942598	1	0.05956977257408491	0.0	0	1	0.05956977257408491	0.0
15012942599	1	0.05957802156096623	0.0	0	1	0.05957802156096623	0.0
15012942600	2	0.429646596230644	0.0	0	2	0.214823298115322	0.0
15012942601	3	1.2231795386607625	0.0	0	3	0.4077265128869208	0.0
15012942602	17	3.101291868785083	7.0	7	10	0.31012918687850827	0.7
15012942603	4	0.12615906262149368	1.0	2	2	0.12615906262149368	1.0
15012942604	12	1.7628224019723227	6.0	6	6	0.29380373366205376	1.0
15012942605	2	0.059851551232083834	1.0	1	1	0.059851551232083834	1.0
15012942606	6	1.0979801530722408	2.0	2	4	0.2744950382680602	0.5
15012942607	2	0.05996329975232501	1.0	1	1	0.05996329975232501	1.0
15012942608	3	0.4061170513730405	1.0	1	2	0.20305852568652025	0.5
15012942609	7	0.7733086151038545	2.0	3	4	0.2577695383679515	0.75
15012942610	5	0.45317051830943444	1.0	2	3	0.22658525915471722	0.6666666666666666
15012942611	8	1.172597559168552	2.0	3	5	0.293149389792138	0.6
15012942612	4	0.10865781003808776	1.0	2	2	0.10865781003808776	1.0
15012942613	18	1.9901048856998493	8.0	9	9	0.24876311071248117	1.0
15012942614	5	0.4158616974186092	1.5	2	3	0.2079308487093046	0.6666666666666666
15012942615	3	0.4075015343957333	1.0	1	2	0.20375076719786664	0.5
15012942616	18	1.9870507067243752	7.0	8	10	0.2483813383405469	0.8
15012942617	2	0.060630693295024816	1.0	1	1	0.060630693295024816	1.0
15012942618	5	0.7556870283199841	2.0	2	3	0.25189567610666136	0.6666666666666666
15012942619	2	0.06072917609758747	1.0	1	1	0.06072917609758747	1.0
15012942620	8	1.177657285705546	2.0	3	5	0.2944143214263865	0.6
15012942621	16	6.322864201777358	2.0	2	14	0.5269053501481132	0.14285714285714285
15012942622	2	0.06099570254718951	1.0	1	1	0.06099570254718951	1.0
15012942623	2	0.06106553274633992	1.0	1	1	0.06106553274633992	1.0
15012942624	62	6.766829557783262	17.0	21	41	0.20505544114494734	0.5121951219512195
15012942625	8	1.4227755268518496	2.0	2	6	0.23712925447530828	0.3333333333333333
15026492956	2	0.43983177184500916	1.0	1	1	0.43983177184500916	1.0
15026492958	2	0.6704734113772788	1.0	1	1	0.3352367056886394	1.0
15026492959	1	0.0	1.0	1	0	0.0	inf
15026492960	21	14.798118638410777	0.0	0	21	0.704672316114799	0.0
15026492961	22	7.986920339062316	10.0	10	12	0.38032953995534835	0.8333333333333334
15026492962	2	0.477578563435231	1.0	1	1	0.477578563435231	1.0
15026492963	1	0.9577283192467012	0.0	0	1	0.9577283192467012	0.0
15026492964	2	0.7617049841085793	1.0	1	1	0.7617049841085793	1.0
15026492965	1	0.7978068940453324	0.0	0	1	0.7978068940453324	0.0
15026492966	2	0.0	2.0	2	0	0.0	inf
15026492967	3	0.6494139835546178	1.0	1	2	0.3247069917773089	0.5
15026492968	1	0.0	1.0	1	0	0.0	inf
15026492969	6	0.16384514840213588	5.0	5	1	0.03276902968042718	5.0
15049944681	11	1.7993465253600622	5.0	5	6	0.29989108756001037	0.8333333333333334
15049944682	6	0.5689930616592915	2.0	3	3	0.28449653082964577	1.0
15049944683	31	5.57481236837605	11.0	11	20	0.2787406184188025	0.55
15049944684	1	0.27321853280017716	0.0	0	1	0.27321853280017716	0.0
15049944685	2	0.27322977835780315	1.0	1	1	0.27322977835780315	1.0
15049944686	11	1.8003558983303274	5.0	5	6	0.3000593163883879	0.8333333333333334
15049944687	2	0.2732876896126434	1.0	1	1	0.2732876896126434	1.0
15049944688	2	0.2734245554562048	1.0	1	1	0.2734245554562048	1.0
15049944689	5	2.3463068124140314	1.0	1	4	0.5865767031035078	0.25
15049944690	10	1.5280620264555447	5.0	5	5	0.30561240529110895	1.0
15049944691	2	0.5469382673093963	0.0	0	2	0.27346913365469816	0.0
15049944692	4	0.5470068854125152	2.0	2	2	0.2735034427062576	1.0
15049944693	12	3.306063540700182	2.0	2	10	0.3306063540700182	0.2
15049944694	24	4.206209790187187	9.0	9	15	0.28041398601247913	0.6
15049944695	8	1.0946287075450318	4.0	4	4	0.27365717688625796	1.0
15049944696	3	0.821007725193049	0.0	0	3	0.2736692417310163	0.0
15049944697	4	0.5474006146067605	2.0	2	2	0.27370030730338024	1.0
15049944698	1	0.27371518914910087	0.0	0	1	0.27371518914910087	0.0
15049944699	27	5.411688619128687	8.0	8	19	0.2848257167962467	0.42105263157894735
15049944700	15	3.509768568107525	7.0	7	8	0.4387210710134406	0.875
15049944701	1	0.2738212138825264	0.0	0	1	0.2738212138825264	0.0
15049944702	2	0.2738290588373972	1.0	1	1	0.2738290588373972	1.0
15049944703	2	0.2738531660806912	1.0	1	1	0.2738531660806912	1.0
15049944704	1	0.27385343543536483	0.0	0	1	0.27385343543536483	0.0
15049944705	2	1.1815843085010658	0.0	0	2	0.5907921542505329	0.0
15049944706	3	2.16099763180004	0.0	0	3	0.7203325439333467	0.0
15049944707	11	1.8040103341960876	5.0	5	6	0.3006683890326813	0.8333333333333334
15049944708	3	0.8218158902220786	0.0	0	3	0.2739386300740262	0.0
15049944709	7	1.5215735753907065	3.0	3	4	0.3803933938476766	0.75
15049944710	27	4.710364737540638	10.0	10	17	0.27708027867886104	0.5882352941176471
15049944711	9	1.5309226740979824	4.0	4	5	0.3061845348195965	0.8
15049944712	3	0.8223464179212169	0.0	0	3	0.27411547264040564	0.0
15049944713	4	0.548282549147043	2.0	2	2	0.2741412745735215	1.0
15049944714	16	3.5495616471536597	4.0	4	12	0.29579680392947166	0.3333333333333333
15049944715	2	0.822159822471028	0.0	0	2	0.411079911235514	0.0
15049944716	3	0.3014256235821633	0.5	1	2	0.3014256235821633	0.5
15049944717	3	0.5485361129029744	1.0	1	2	0.2742680564514872	0.5
15049944718	1	0.2742674335688043	0.0	0	1	0.2742674335688043	0.0
15049944719	2	0.27429531177752975	1.0	1	1	0.27429531177752975	1.0
15049944720	18	3.4490940710086933	6.0	6	12	0.2874245059173911	0.5
15049944721	9	1.5320653102930488	4.0	4	5	0.30641306205860974	0.8
15049944722	4	0.9891961503695361	0.5	1	3	0.49459807518476806	0.3333333333333333
15049944723	28	5.7502984870651	8.0	8	20	0.287514924353255	0.4
15049944724	3	0.7925142093849431	0.0	0	3	0.7925142093849431	0.0
15049944725	9	3.558528497909656	3.0	3	6	0.5930880829849426	0.5
15049944726	5	2.272255118471108	0.5	1	4	0.7574183728237026	0.25
15049944727	1	0.2745198862367068	0.0	0	1	0.2745198862367068	0.0
15049944728	2	0.8609713730862898	0.0	0	2	0.8609713730862898	0.0
15049944729	5	1.3152043272367036	0.5	1	4	0.6576021636183518	0.25
15049944730	9	1.5331186890831257	4.0	4	5	0.3066237378166251	0.8
15049944731	3	0.8238583057045583	0.0	0	3	0.27461943523485277	0.0
15049944732	8	1.399479714512328	2.5	3	5	0.349869928628082	0.6
15049944733	31	6.409730477989733	9.0	9	22	0.2913513853631697	0.4090909090909091
15049944734	8	1.259068995098654	4.0	4	4	0.3147672487746635	1.0
15049944735	3	0.8243256697327197	0.0	0	3	0.2747752232442399	0.0
15049944736	3	0.8254253775266689	1.0	1	2	0.41271268876333445	0.5
15049944737	2	0.27481408887902903	1.0	1	1	0.27481408887902903	1.0
15049944738	22	3.9001391789268216	8.0	8	14	0.2785813699233444	0.5714285714285714
15049944739	9	2.1328628964172696	2.0	2	7	0.30469469948818134	0.2857142857142857
15049944740	11	1.8096573212603633	5.0	5	6	0.30160955354339386	0.8333333333333334
15049944741	2	0.5498851084474103	0.0	0	2	0.27494255422370517	0.0
15049944742	32	6.3675027693869115	10.0	10	22	0.28943194406304146	0.45454545454545453
15049944743	12	4.177266586751379	5.0	5	7	0.5967523695359114	0.7142857142857143
15049944744	4	2.3005245311907156	0.0	0	4	0.5751311327976789	0.0
15049944745	2	0.27508623810744404	1.0	1	1	0.27508623810744404	1.0
15049944746	11	5.487688117724963	1.5	2	9	0.6859610147156203	0.2222222222222222
15049944747	1	0.2750968776170542	0.0	0	1	0.2750968776170542	0.0
15049944748	4	1.195787380443982	1.0	1	3	0.39859579348132734	0.3333333333333333
15049944749	9	1.3759024602081498	4.0	4	5	0.27518049204163	0.8
15049944750	2	0.550346075302072	0.0	0	2	0.275173037651036	0.0
15049944751	7	2.091946204349896	1.5	2	5	0.522986551087474	0.4
15049944752	30	5.716264513966158	10.0	10	20	0.2858132256983079	0.5
15049944753	1	0.27530963413992376	0.0	0	1	0.27530963413992376	0.0
15049944754	2	0.8899139368047472	0.0	0	2	0.8899139368047472	0.0
15049944755	3	1.7798677717705327	0.0	0	3	0.8899338858852663	0.0
15049944756	3	0.6914480934857347	0.5	1	2	0.6914480934857347	0.5
15049944757	11	1.8121532963439784	5.0	5	6	0.30202554939066306	0.8333333333333334
15049944758	2	0.5508468729791034	0.0	0	2	0.2754234364895517	0.0
15049944759	3	1.7876880470193597	0.0	0	3	0.5958960156731199	0.0
15049944760	32	6.036288707402948	10.5	11	21	0.3018144353701474	0.5238095238095238
15049944761	3	0.551508441726985	1.0	1	2	0.2757542208634925	0.5
15049944762	11	1.8134898342347565	5.0	5	6	0.30224830570579275	0.8333333333333334
15049944763	2	0.5513153480952938	0.0	0	2	0.2756576740476469	0.0
15049944764	5	0.5593198956102494	1.5	2	3	0.2796599478051247	0.6666666666666666
15049944765	17	3.463708683223652	5.0	5	12	0.28864239026863764	0.4166666666666667
15049944766	3	0.5516261833887155	1.0	1	2	0.27581309169435775	0.5
15049944767	2	0.2757916106591321	1.0	1	1	0.2757916106591321	1.0
15049944768	3	0.5516303583861575	1.0	1	2	0.27581517919307874	0.5
15049944769	1	0.2758125193156762	0.0	0	1	0.2758125193156762	0.0
15049944770	1	0.2758173340304681	0.0	0	1	0.2758173340304681	0.0
15049944771	1	0.2758166943131181	0.0	0	1	0.2758166943131181	0.0
15049944772	2	0.6333599062942026	0.0	0	2	0.3166799531471013	0.0
15049944773	4	0.5517912978036786	2.0	2	2	0.2758956489018393	1.0
15049944774	15	2.915933699289816	5.0	5	10	0.2915933699289816	0.5
15049944775	8	1.2643379092090914	4.0	4	4	0.31608447730227285	1.0
15049944776	4	0.5518983662864647	2.0	2	2	0.27594918314323236	1.0
15049944777	1	0.27596662385835286	0.0	0	1	0.27596662385835286	0.0
15049944778	28	5.782688016211919	8.0	8	20	0.28913440081059594	0.4
15049944779	7	3.880930217712312	0.5	1	6	0.7761860435424623	0.16666666666666666
15049944780	8	6.226890673685332	0.0	0	8	0.7783613342106664	0.0
15049944781	4	0.5523756290988837	2.0	2	2	0.27618781454944186	1.0
15049944782	11	3.161085306746321	4.0	4	7	0.45158361524947443	0.5714285714285714
15049944783	9	3.5467453083550424	2.0	2	7	0.5066779011935775	0.2857142857142857
15049944784	30	7.2084376563624915	4.0	4	26	0.27724760216778815	0.15384615384615385
15049944785	2	0.276378803847745	1.0	1	1	0.276378803847745	1.0
15049944786	10	1.5457992337330904	3.5	4	6	0.30915984674661806	0.6666666666666666
15049944787	4	1.1065653955943069	0.0	0	4	0.2766413488985767	0.0
15049944788	6	2.2743983736095448	2.0	2	4	0.5685995934023862	0.5
15049944789	1	0.2764418665107193	0.0	0	1	0.2764418665107193	0.0
15049944790	6	1.3001364921139518	2.0	2	4	0.32503412302848794	0.5
15049944791	1	0.2764841888638206	0.0	0	1	0.2764841888638206	0.0
15049944792	2	0.5550324425920176	0.0	0	2	0.2775162212960088	0.0
15049944793	5	1.848878695011622	0.0	0	5	0.3697757390023244	0.0
15049944794	1	0.2765202150514247	0.0	0	1	0.2765202150514247	0.0
15049944795	2	1.1582275883359594	0.0	0	2	0.5791137941679797	0.0
15049944796	3	0.5544722522094406	1.0	1	2	0.2772361261047203	0.5
15049944797	15	6.04701296272734	3.0	3	12	0.503917746893945	0.25
15049944798	56	12.175143432205463	14.0	18	38	0.419832532145016	0.47368421052631576
15049944799	52	12.949827675297119	12.0	15	37	0.40468211485303496	0.40540540540540543
15049944800	40	10.35936633908986	11.0	11	29	0.3572195289341331	0.3793103448275862
15049944801	21	9.101764215874708	4.0	4	17	0.5353978950514534	0.23529411764705882
15049944802	38	10.148062984684797	11.5	12	26	0.4059225193873919	0.46153846153846156
15049944803	46	12.48250058239531	13.0	13	33	0.3782575934059185	0.3939393939393939
15049944804	45	12.004464991417517	12.0	12	33	0.3751395309817974	0.36363636363636365
15049944805	38	10.769509906141005	9.0	10	28	0.41421191946696173	0.35714285714285715
15049944806	21	6.81988842184659	7.0	7	14	0.48713488727475646	0.5
15049944807	14	3.34609052061107	3.0	3	11	0.3041900473282791	0.2727272727272727
15049944808	2	0.5557827637048751	0.0	0	2	0.27789138185243756	0.0
15049944809	2	0.5557863999929699	0.0	0	2	0.27789319999648493	0.0
15175877903	1	0.18421509559885574	0.0	0	1	0.18421509559885574	0.0
15175877904	2	0.3684872943885307	0.0	0	2	0.18424364719426534	0.0
15175877905	6	3.0871622633294113	0.0	0	6	0.5145270438882352	0.0
15175877906	1	0.1842654985921673	0.0	0	1	0.1842654985921673	0.0
15175877907	1	0.18427509435241698	0.0	0	1	0.18427509435241698	0.0
15175877908	1	0.18431815743087088	0.0	0	1	0.18431815743087088	0.0
15175877909	4	1.9965647514999434	1.0	1	3	0.6655215838333145	0.3333333333333333
15175877910	4	1.288213743169039	1.0	1	3	0.4294045810563463	0.3333333333333333
15175877911	3	0.3717842966023231	1.0	1	2	0.18589214830116155	0.5
15175877912	2	0.18588937058108929	1.0	1	1	0.18588937058108929	1.0
15175877913	1	0.1858916600958155	0.0	0	1	0.1858916600958155	0.0
15175877914	1	0.18590058246938101	0.0	0	1	0.18590058246938101	0.0
15175877915	19	2.5004537447824737	6.0	6	13	0.19234259575249799	0.46153846153846156
15175877916	4	0.6353684840958018	1.0	1	3	0.21178949469860062	0.3333333333333333
15175877917	2	0.18594950401198737	1.0	1	1	0.18594950401198737	1.0
15175877918	11	1.230484807773522	4.5	5	6	0.2460969615547044	0.8333333333333334
15175877919	2	0.371960622905578	0.0	0	2	0.185980311452789	0.0
15175877920	9	1.6066924131576124	3.0	4	5	0.4016731032894031	0.8
15175877921	13	4.045674640361849	1.0	2	11	0.4045674640361849	0.18181818181818182
15175877922	3	0.558577655137602	0.0	0	3	0.18619255171253402	0.0
15175877923	2	0.18636282875874263	1.0	1	1	0.18636282875874263	1.0
15175877924	26	5.635720968355642	0.0	0	26	0.21675849878290931	0.0
15175877925	43	7.77859766347615	4.0	4	39	0.1994512221404141	0.10256410256410256
15175877926	5	0.5713279626480486	2.0	2	3	0.19044265421601622	0.6666666666666666
15175877927	39	4.9342144306295035	13.0	13	26	0.18977747810113474	0.5
15175877928	6	0.6421451109921387	3.0	3	3	0.2140483703307129	1.0
15175877929	10	1.0828538679853015	5.0	5	5	0.21657077359706028	1.0
15175877930	3	0.37325167352583954	1.0	1	2	0.18662583676291977	0.5
15175877931	3	1.9010486549824872	0.0	0	3	0.6336828849941624	0.0
15175877932	1	0.18672793901890994	0.0	0	1	0.18672793901890994	0.0
15175877933	1	0.18672649123753893	0.0	0	1	0.18672649123753893	0.0
15175877934	3	0.3734754062516614	1.0	1	2	0.1867377031258307	0.5
15175877935	2	0.6108489261351036	0.0	0	2	0.3054244630675518	0.0
15175877936	2	0.18673824183517804	1.0	1	1	0.18673824183517804	1.0
15175877937	3	1.4972187951516294	0.0	0	3	0.4990729317172098	0.0
15175877938	2	0.5470536857870663	0.0	0	2	0.27352684289353313	0.0
15175877939	6	0.7589616404265271	2.0	2	4	0.18974041010663178	0.5
15175877940	10	1.0840504761231056	5.0	5	5	0.2168100952246211	1.0
15175877941	4	0.8206847352699778	0.5	1	3	0.4103423676349889	0.3333333333333333
15175877942	49	6.790214223495764	14.0	14	35	0.19400612067130754	0.4
15175877943	4	0.28046528461008063	1.0	2	2	0.28046528461008063	1.0
15175877944	4	0.957188162117979	1.0	1	3	0.4785940810589895	0.3333333333333333
15175877945	4	0.22908921387054013	1.0	2	2	0.22908921387054013	1.0
15175877946	2	0.6324653794229258	0.0	0	2	0.6324653794229258	0.0
15175877947	3	0.2739518845685933	0.5	1	2	0.2739518845685933	0.5
15175877948	2	0.639481260608155	0.0	0	2	0.3197406303040775	0.0
15175877949	4	0.8790014699021236	0.5	1	3	0.4395007349510618	0.3333333333333333
15175877950	10	1.0852138526280446	5.0	5	5	0.2170427705256089	1.0
15175877951	42	5.817780620517074	12.0	12	30	0.19392602068390247	0.4
15175877952	3	0.758835582439247	1.0	1	2	0.3794177912196235	0.5
15175877953	11	1.2733841522551537	5.0	5	6	0.21223069204252562	0.8333333333333334
15175877954	2	0.3744817489818477	0.0	0	2	0.18724087449092386	0.0
15175877955	6	0.4536778141679683	1.0	2	4	0.22683890708398416	0.5
15175877956	5	1.185630689086358	0.5	1	4	0.592815344543179	0.25
15175877957	2	0.7375187862258888	0.0	0	2	0.7375187862258888	0.0
15175877958	2	0.7375114799803654	0.0	0	2	0.7375114799803654	0.0
15175877959	3	0.3537250084737297	0.5	1	2	0.3537250084737297	0.5
15175877960	4	0.8031329450159234	0.5	1	3	0.4015664725079617	0.3333333333333333
15175877961	11	1.2747223399433083	5.0	5	6	0.2124537233238847	0.8333333333333334
15175877962	6	0.5740878379731977	1.0	2	4	0.28704391898659887	0.5
15175877963	1	0.1876099072285266	0.0	0	1	0.1876099072285266	0.0
15175877964	11	1.8541567335116305	5.0	5	6	0.30902612225193843	0.8333333333333334
15175877965	1	0.18762862737834707	0.0	0	1	0.18762862737834707	0.0
15175877966	10	1.719122838424535	5.0	5	5	0.343824567684907	1.0
15175877967	2	0.18765044510691478	1.0	1	1	0.18765044510691478	1.0
15910042512	2	1.4878587875800693	0.0	0	2	0.7439293937900346	0.0
15910042513	1	0.7440058231786902	0.0	0	1	0.7440058231786902	0.0
15910042514	1	0.7440316812273631	0.0	0	1	0.7440316812273631	0.0
15910042515	2	1.488285041351161	0.0	0	2	0.7441425206755805	0.0
15910042516	1	0.7441246422591153	0.0	0	1	0.7441246422591153	0.0
15910042517	1	0.744135517454065	0.0	0	1	0.744135517454065	0.0
15910042518	1	0.7442153811148098	0.0	0	1	0.7442153811148098	0.0
15910042519	1	0.7442782754311131	0.0	0	1	0.7442782754311131	0.0
15910042520	2	1.4886406568590815	0.0	0	2	0.7443203284295408	0.0
15910042521	2	1.4886338556535712	0.0	0	2	0.7443169278267856	0.0
15910042522	1	0.7443414727714243	0.0	0	1	0.7443414727714243	0.0
15910042523	1	0.7443639975560103	0.0	0	1	0.7443639975560103	0.0
15910042524	1	0.7444072626504695	0.0	0	1	0.7444072626504695	0.0
15910042525	1	0.7444291477177056	0.0	0	1	0.7444291477177056	0.0
15910042526	2	1.4888829077187185	0.0	0	2	0.7444414538593592	0.0
15910042527	1	0.7444578339904521	0.0	0	1	0.7444578339904521	0.0
15910042528	2	1.4891880528946588	0.0	0	2	0.7445940264473294	0.0
15910042529	1	0.7444858468765144	0.0	0	1	0.7444858468765144	0.0
15910042530	1	0.7445165196399792	0.0	0	1	0.7445165196399792	0.0
15910042531	1	0.744530155720334	0.0	0	1	0.744530155720334	0.0
15910042532	1	0.7445447682113809	0.0	0	1	0.7445447682113809	0.0
15910042533	2	1.4891886589426746	0.0	0	2	0.7445943294713373	0.0
15910042534	1	0.7446381669444779	0.0	0	1	0.7446381669444779	0.0
15910042535	1	0.7446497828647802	0.0	0	1	0.7446497828647802	0.0
15910042536	1	0.7446656411211928	0.0	0	1	0.7446656411211928	0.0
15910042537	1	0.7461544654106007	0.0	0	1	0.7461544654106007	0.0
15910042538	19	10.44907484581886	5.0	5	14	0.7463624889870614	0.35714285714285715
15910042539	2	1.4926275774001598	0.0	0	2	0.7463137887000799	0.0
15910042540	1	0.7463102197506537	0.0	0	1	0.7463102197506537	0.0
15910042541	1	0.7463104891053274	0.0	0	1	0.7463104891053274	0.0
15910042542	2	1.4927079797702518	0.0	0	2	0.7463539898851259	0.0
15910042543	5	3.9089002427121295	0.0	0	5	0.7817800485424259	0.0
15910042544	2	1.4927781129934101	0.0	0	2	0.7463890564967051	0.0
16016148106	2	1.1261367398529127	0.0	0	2	0.5630683699264564	0.0
16016148107	2	1.126300743179847	0.0	0	2	0.5631503715899235	0.0
16016148108	4	2.9126758208423746	0.0	0	4	0.7281689552105937	0.0
16016148109	2	1.1855255734249561	0.0	0	2	0.5927627867124781	0.0
16016148110	1	0.5632062795193783	0.0	0	1	0.5632062795193783	0.0
16016148111	2	1.2327631442808074	0.0	0	2	0.6163815721404037	0.0
16016148112	1	0.563239342805572	0.0	0	1	0.563239342805572	0.0
16016148113	2	1.1266041375504083	0.0	0	2	0.5633020687752042	0.0
16016148114	2	1.1267626191065325	0.0	0	2	0.5633813095532663	0.0
16016148115	1	0.5633821344519543	0.0	0	1	0.5633821344519543	0.0
16016148116	2	1.1268385771245089	0.0	0	2	0.5634192885622544	0.0
16016148117	3	1.8813124656635922	0.0	0	3	0.6271041552211974	0.0
16016148118	1	0.5634864420493352	0.0	0	1	0.5634864420493352	0.0
16016148119	1	0.5635072160285425	0.0	0	1	0.5635072160285425	0.0
16016148120	1	0.5635506831390068	0.0	0	1	0.5635506831390068	0.0
16016148121	4	2.5328418598172555	0.0	0	4	0.6332104649543139	0.0
16016148122	1	0.5635697399821694	0.0	0	1	0.5635697399821694	0.0
16016148123	1	0.5635833760625242	0.0	0	1	0.5635833760625242	0.0
16016148124	1	0.563671421371482	0.0	0	1	0.563671421371482	0.0
16016148125	1	0.5636830372917843	0.0	0	1	0.5636830372917843	0.0
16016148126	5	3.2581111025403953	0.0	0	5	0.8145277756350988	0.0
16016148127	1	0.5637131713459017	0.0	0	1	0.5637131713459017	0.0
16016148128	1	0.5637400394746008	0.0	0	1	0.5637400394746008	0.0
16016148129	2	1.3572031853749031	0.0	0	2	0.6786015926874516	0.0
16016148130	2	1.2672003749955767	0.0	0	2	0.6336001874977883	0.0
16016148131	4	2.616053498147867	0.0	0	4	0.6540133745369667	0.0
16016148132	1	0.5638265023248507	0.0	0	1	0.5638265023248507	0.0
16016148133	1	0.563834751311732	0.0	0	1	0.563834751311732	0.0
16016148134	1	0.5639315843169184	0.0	0	1	0.5639315843169184	0.0
16016148135	2	1.127906433728296	0.0	0	2	0.563953216864148	0.0
16016148136	2	1.3357173017651451	0.0	0	2	0.6678586508825726	0.0
16016148137	1	0.5640430971518201	0.0	0	1	0.5640430971518201	0.0
16016148138	1	0.5640694265711719	0.0	0	1	0.5640694265711719	0.0
16355949806	10	0.6562449527563686	8.0	8	2	0.08203061909454608	4.0
16355949807	7	0.0	7.0	7	0	0.0	inf
16355949808	6	0.4065850214492177	5.0	5	1	0.08131700428984354	5.0
16355949809	7	0.5827570518147822	6.0	6	1	0.0971261753024637	6.0
16355949810	10	0.45802661271312983	7.0	8	2	0.06543237324473283	4.0
16355949811	1	0.0	1.0	1	0	0.0	inf
16355949813	5	1.4717714786867895	0.0	0	5	0.36794286967169737	0.0
16355949814	12	4.950674728407158	0.0	0	12	0.4500613389461053	0.0
16355949815	1	0.507316598843721	0.0	0	1	0.507316598843721	0.0
16355949816	2	0.0	2.0	2	0	0.0	inf
16355949817	1	0.7615226309945009	0.0	0	1	0.7615226309945009	0.0
16355949818	1	0.5088228975175836	0.0	0	1	0.5088228975175836	0.0
16355949820	15	7.455123070338909	0.0	0	15	0.4970082046892606	0.0
16355949822	2	1.0361943995978264	0.0	0	2	0.5180971997989132	0.0
16355949823	2	0.8641364588486495	0.0	0	2	0.43206822942432477	0.0
16355949824	1	0.7528795782255971	0.0	0	1	0.7528795782255971	0.0
16355949826	10	1.9994464761455966	3.0	6	4	0.33324107935759945	1.5
16355949827	4	0.0	4.0	4	0	0.0	inf
16355949828	8	0.5625227920349265	4.0	4	4	0.14063069800873162	1.0
16355949830	1	0.4146142485861489	0.0	0	1	0.4146142485861489	0.0
16355949831	1	0.8831244818920765	0.0	0	1	0.8831244818920765	0.0
16355949832	14	1.14515371852376	9.0	9	5	0.14314421481547	1.8
16355949833	1	0.8131750259598984	0.0	0	1	0.8131750259598984	0.0
16355949835	1	0.0	1.0	1	0	0.0	inf
16355949836	2	0.0	1.0	2	0	0.0	inf
16355949837	8	2.3481212865039134	4.0	4	4	0.2935151608129892	1.0
16355949838	1	0.0	1.0	1	0	0.0	inf
16355949839	3	1.2582590792642456	0.0	0	3	0.6291295396321228	0.0
16355949840	1	0.5072711789118725	0.0	0	1	0.5072711789118725	0.0
16355949841	3	1.2136261681028377	0.0	0	3	0.6068130840514189	0.0
16355949842	1	0.15207175662377653	0.0	0	1	0.15207175662377653	0.0
16355949843	3	0.21005253863918047	2.0	2	1	0.21005253863918047	2.0
16355949845	3	0.0	3.0	3	0	0.0	inf
16355949848	4	0.0	4.0	4	0	0.0	inf
16355949850	3	1.5503905188232285	0.0	0	3	0.7751952594116143	0.0
16355949851	7	0.5224042988736564	6.0	6	1	0.0870673831456094	6.0
16355949852	8	0.0	8.0	8	0	0.0	inf
16355949853	1	0.0	1.0	1	0	0.0	inf
16355949854	4	0.5802546458883329	3.0	3	1	0.19341821529611095	3.0
16355949855	6	0.0	6.0	6	0	0.0	inf
16355949856	7	0.7634327259935374	6.0	6	1	0.12723878766558958	6.0
16355949857	6	0.0	6.0	6	0	0.0	inf
16355949858	5	0.5491250232276319	4.0	4	1	0.13728125580690798	4.0
16355949859	5	0.02876421725514995	4.0	4	1	0.00575284345102999	4.0
16355949860	5	0.0	5.0	5	0	0.0	inf
16355949861	4	0.0	4.0	4	0	0.0	inf
16355949862	10	0.24550658324707528	5.0	5	5	0.04091776387451255	1.0
16355949863	13	1.0181328556238411	6.0	6	7	0.12726660695298014	0.8571428571428571
16355949864	6	0.2743008672176743	4.0	4	2	0.06857521680441858	2.0
16355949865	138	12.345810762113125	41.5	58	80	0.2204609064663058	0.725
16355949866	140	19.26236481888575	47.333333333333336	62	78	0.32103941364809585	0.7948717948717948
16355949867	10	1.1381760857021925	5.0	5	5	0.18969601428369876	1.0
16355949868	10	2.9331348234280794	4.0	4	6	0.41901926048972565	0.6666666666666666
16355949869	11	1.3593428042252458	6.0	6	5	0.2718685608450492	1.2
16355949870	8	4.627273130386483	0.5	1	7	0.7712121883977471	0.14285714285714285
16355949871	1	0.0	1.0	1	0	0.0	inf
16355949872	1	0.8265998985812315	0.0	0	1	0.8265998985812315	0.0
16355949873	1	0.0	1.0	1	0	0.0	inf
16355949875	3	0.0	3.0	3	0	0.0	inf
16355949878	4	0.0	4.0	4	0	0.0	inf
16355949880	2	0.0	2.0	2	0	0.0	inf
16355949882	4	0.0	4.0	4	0	0.0	inf
16355949883	2	0.9432969692178449	1.0	1	1	0.47164848460892245	1.0
16355949884	12	1.408006877432883	5.0	6	6	0.201143839633269	1.0
16355949885	4	0.541700733018442	2.0	2	2	0.270850366509221	1.0
16355949886	1	0.0	1.0	1	0	0.0	inf
16355949889	4	0.0	4.0	4	0	0.0	inf
16355949891	1	0.0	1.0	1	0	0.0	inf
16355949892	3	0.0	3.0	3	0	0.0	inf
16355949893	2	0.0	2.0	2	0	0.0	inf
16355949894	6	0.02084714267047045	5.0	5	1	0.0041694285340940895	5.0
16355949895	8	0.7646539800839828	7.0	7	1	0.09558174751049785	7.0
16355949896	6	0.6785523681208373	5.0	5	1	0.13571047362416747	5.0
16355949897	5	0.0	5.0	5	0	0.0	inf
16355949898	4	0.17927459217429725	3.0	3	1	0.05975819739143242	3.0
16355949899	8	1.489331147565049	5.0	5	3	0.18616639344563113	1.6666666666666667
16355949900	5	0.0	5.0	5	0	0.0	inf
16355949901	2	0.0	2.0	2	0	0.0	inf
16355949902	5	0.0	5.0	5	0	0.0	inf
16355949903	7	0.8214863347788365	5.0	5	2	0.1642972669557673	2.5
16355949904	12	1.0159180868195432	6.0	6	6	0.14513115525993475	1.0
16355949905	6	0.0	6.0	6	0	0.0	inf
16355949906	3	0.0	3.0	3	0	0.0	inf
16355949907	11	0.5470479620002507	6.0	6	5	0.09117466033337512	1.2
16355949908	5	0.06177393553810683	3.0	4	1	0.02059131184603561	4.0
16355949909	9	0.6344745632725408	4.0	4	5	0.12689491265450817	0.8
16355949910	73	2.524592266887924	27.0	32	41	0.06643663860231379	0.7804878048780488
16355949911	126	10.802697028145914	33.0	48	78	0.1929053040740342	0.6153846153846154
16355949912	13	1.2292634863444083	6.0	6	7	0.15365793579305104	0.8571428571428571
16355949913	139	22.302026015149785	42.33333333333333	57	82	0.3656069838549145	0.6951219512195121
16355949914	6	1.0601738004298025	3.0	3	3	0.2650434501074506	1.0
16355949915	1	0.6155149571471865	0.0	0	1	0.6155149571471865	0.0
16355949916	10	1.5991551286628154	5.0	5	5	0.2665258547771359	1.0
16355949917	2	0.6155447208386277	0.0	0	2	0.6155447208386277	0.0
16355949918	77	22.15541640094547	16.5	22	55	0.5538854100236368	0.4
16355949919	2	0.11618886570605587	1.0	1	1	0.11618886570605587	1.0
16355949920	2	0.12540847215396234	1.0	1	1	0.12540847215396234	1.0
16355949921	1	0.6155449901933013	0.0	0	1	0.6155449901933013	0.0
16355949922	3	0.0	3.0	3	0	0.0	inf
16355949925	8	0.9114108302867917	6.0	6	2	0.1302015471838274	3.0
16355949927	1	0.0	1.0	1	0	0.0	inf
16355949928	1	0.0	1.0	1	0	0.0	inf
16355949929	3	0.0	3.0	3	0	0.0	inf
16355949930	8	0.5933873360273964	7.0	7	1	0.08476961943248519	7.0
16355949931	5	0.0	5.0	5	0	0.0	inf
16355949932	7	0.0	7.0	7	0	0.0	inf
16355949933	9	0.23925314413501914	8.0	8	1	0.029906643016877392	8.0
16355949934	4	0.04467927383461428	3.0	3	1	0.01116981845865357	3.0
16673904465	4	0.1416071928741413	2.0	2	2	0.07080359643707065	1.0
16673904466	8	0.2835317192232067	4.0	4	4	0.07088292980580167	1.0
16673904467	8	0.2839592524289984	4.0	4	4	0.0709898131072496	1.0
16673904468	17	2.019896960389745	1.0	1	16	0.12624356002435907	0.0625
16673904469	8	0.2843856408774269	4.0	4	4	0.07109641021935673	1.0
16673904470	12	2.2646080046081196	5.0	5	7	0.32351542922973137	0.7142857142857143
16673904471	9	0.3564790926733946	4.0	4	5	0.07129581853467892	0.8
16673904472	8	0.2855723502309733	4.0	4	4	0.07139308755774333	1.0
16673904473	30	2.7093119984679115	5.0	5	25	0.10837247993871646	0.2
16673904474	8	0.2859166865119334	4.0	4	4	0.07147917162798335	1.0
16673904475	18	2.422184023988458	5.5	7	11	0.26913155822093976	0.6363636363636364
16673904476	10	0.35837167961864225	5.0	5	5	0.07167433592372845	1.0
16673904477	10	1.1439774803331528	4.0	4	6	0.1906629133888588	0.6666666666666666
16673904478	14	1.5698540202043614	7.0	7	7	0.2242648600291945	1.0
16673904479	22	1.5418499891769926	8.0	8	14	0.11013214208407089	0.5714285714285714
16673904480	1	0.0719077990871368	0.0	0	1	0.0719077990871368	0.0
16673904481	1	0.07191901097542856	0.0	0	1	0.07191901097542856	0.0
16673904482	4	2.140554521140083	0.0	0	4	0.5351386302850207	0.0
16673904483	1	0.07194224281603308	0.0	0	1	0.07194224281603308	0.0
16673904484	6	2.1702531297582137	0.0	0	6	0.3617088549597023	0.0
16673904485	2	0.39554319696456136	0.0	0	2	0.19777159848228068	0.0
16673904486	2	0.14401545934214094	0.0	0	2	0.07200772967107047	0.0
16673904487	2	0.35023269045218824	0.0	0	2	0.17511634522609412	0.0
16673904488	3	0.43509284672436266	0.0	0	3	0.14503094890812088	0.0
16673904489	6	2.29183195083119	1.0	1	5	0.458366390166238	0.2
16673904490	1	0.0720149685779255	0.0	0	1	0.0720149685779255	0.0
16673904491	2	0.2780413619016736	0.0	0	2	0.1390206809508368	0.0
16673904492	1	0.07203584356513536	0.0	0	1	0.07203584356513536	0.0
16673904493	1	0.07205722359235837	0.0	0	1	0.07205722359235837	0.0
16673904494	5	2.0638108965884445	0.0	0	5	0.4127621793176889	0.0
16673904495	1	0.07207331753411049	0.0	0	1	0.07207331753411049	0.0
16673904496	5	1.141712779906222	0.0	0	5	0.22834255598124442	0.0
16673904497	1	0.07209628002004133	0.0	0	1	0.07209628002004133	0.0
16673904498	5	2.333821751918487	0.0	0	5	0.4667643503836974	0.0
16673904499	1	0.07213510076238483	0.0	0	1	0.07213510076238483	0.0
16673904500	6	3.042842173952144	0.0	0	6	0.5071403623253573	0.0
16673904501	2	0.5194879284831019	0.0	0	2	0.25974396424155094	0.0
16673904502	1	0.07216792836323906	0.0	0	1	0.07216792836323906	0.0
16673904503	2	0.952255806672299	0.0	0	2	0.4761279033361495	0.0
16673904504	1	0.07220291080148268	0.0	0	1	0.07220291080148268	0.0
16673904505	4	0.28569211205275635	1.0	1	3	0.09523070401758545	0.3333333333333333
16673904506	1	0.07223099102621336	0.0	0	1	0.07223099102621336	0.0
16673904507	4	1.6929071877530355	0.0	0	4	0.4232267969382589	0.0
16673904508	2	0.14455187917476597	0.0	0	2	0.07227593958738299	0.0
16673904509	5	2.151697286288699	0.0	0	5	0.4303394572577398	0.0
16673904510	3	1.0980064151529243	0.0	0	3	0.3660021383843081	0.0
16673904511	2	0.14472625265663674	0.0	0	2	0.07236312632831837	0.0
16673904512	2	0.1447336262408286	0.0	0	2	0.0723668131204143	0.0
16673904513	7	3.6045055225620395	0.0	0	7	0.5149293603660057	0.0
16673904514	1	0.07245522879204833	0.0	0	1	0.07245522879204833	0.0
16673904515	6	1.3061481854063839	2.0	2	4	0.32653704635159597	0.5
16673904516	1	0.0724750936992319	0.0	0	1	0.0724750936992319	0.0
16673904517	2	0.14497554040712352	0.0	0	2	0.07248777020356176	0.0
16673904518	7	4.208275370171603	0.0	0	7	0.6011821957388005	0.0
16673904519	3	0.7980428824088066	0.0	0	3	0.26601429413626887	0.0
16673904520	1	0.07252906564196966	0.0	0	1	0.07252906564196966	0.0
16673904521	3	1.8904173270205127	0.0	0	3	0.6301391090068376	0.0
16673904522	1	0.07255118639454528	0.0	0	1	0.07255118639454528	0.0
16673904523	1	0.07256219626683176	0.0	0	1	0.07256219626683176	0.0
16673904524	2	0.7886056373845701	0.0	0	2	0.39430281869228506	0.0
16673904525	1	0.07258482205942052	0.0	0	1	0.07258482205942052	0.0
16673904526	6	2.627790729061285	0.0	0	6	0.4379651215102142	0.0
16673904527	3	0.4233372660238001	0.0	0	3	0.14111242200793336	0.0
16673904528	2	0.5352656815176601	0.0	0	2	0.26763284075883004	0.0
16673904529	3	0.513433374128221	0.0	0	3	0.17114445804274034	0.0
16673904530	2	0.9545720885192385	0.0	0	2	0.47728604425961924	0.0
16673904531	2	0.14578107922808473	0.0	0	2	0.07289053961404236	0.0
16673904532	1	0.07271660383351632	0.0	0	1	0.07271660383351632	0.0
16673904533	2	0.7760903081575713	0.0	0	2	0.38804515407878565	0.0
16673904534	4	0.2916248507564675	1.0	1	3	0.09720828358548916	0.3333333333333333
16673904535	2	0.1454936777912728	0.0	0	2	0.0727468388956364	0.0
16673904536	3	0.2728482374625416	0.0	0	3	0.09094941248751387	0.0
16673904537	4	2.495429337377065	0.0	0	4	0.6238573343442663	0.0
16673904538	2	0.14560263175677463	0.0	0	2	0.07280131587838731	0.0
16673904539	1	0.0728147836120711	0.0	0	1	0.0728147836120711	0.0
16673904540	6	1.3381717288903459	0.0	0	6	0.26763434577806916	0.0
16673904541	1	0.07284919367163316	0.0	0	1	0.07284919367163316	0.0
16673904542	1	0.07285703862650396	0.0	0	1	0.07285703862650396	0.0
16673904543	1	0.07286730777343783	0.0	0	1	0.07286730777343783	0.0
16673904544	4	0.929039285614841	0.0	0	4	0.23225982140371024	0.0
16673904545	3	0.6246094820185049	0.0	0	3	0.20820316067283495	0.0
16673904546	2	0.14581501791696785	0.0	0	2	0.07290750895848393	0.0
16673904547	1	0.07292360290023604	0.0	0	1	0.07292360290023604	0.0
16673904548	7	4.403243070674256	0.0	0	7	0.6290347243820366	0.0
16673904549	2	0.14590659850601756	0.0	0	2	0.07295329925300878	0.0
16673904550	7	2.001225866789232	2.0	2	5	0.40024517335784643	0.4
16673904551	1	0.07299158128600493	0.0	0	1	0.07299158128600493	0.0
16673904552	1	0.07299983027288626	0.0	0	1	0.07299983027288626	0.0
16673904553	1	0.07300807925976757	0.0	0	1	0.07300807925976757	0.0
16673904554	2	1.035403574275915	0.0	0	2	0.5177017871379574	0.0
16673904555	2	0.6955296248559415	0.0	0	2	0.34776481242797075	0.0
16673904556	5	0.3661159631801588	0.0	0	5	0.07322319263603176	0.0
16673904557	8	0.29799125048479636	4.0	4	4	0.07449781262119909	1.0
16673904558	3	0.7757777893974391	0.0	0	3	0.25859259646581306	0.0
16673904559	5	0.6434902008938064	1.0	2	3	0.3217451004469032	0.6666666666666666
16673904560	24	1.5674641371928404	3.0	3	21	0.07464114939013526	0.14285714285714285
16673904561	16	1.0453463980226403	2.0	2	14	0.07466759985876002	0.14285714285714285
16673904562	2	0.074538148483582	1.0	1	1	0.074538148483582	1.0
16673904563	7	2.091969166835827	0.5	1	6	0.4183938333671654	0.16666666666666666
16673904564	11	2.7887551628977945	2.0	3	8	0.46479252714963243	0.375
16673904565	13	1.2651709222067675	5.0	6	7	0.21086182036779458	0.8571428571428571
16673904566	10	2.9322245393083923	2.5	3	7	0.4887040898847321	0.42857142857142855
16673904567	1	0.07485635736119556	0.0	0	1	0.07485635736119556	0.0
16673904568	3	0.38023933980900126	0.5	1	2	0.38023933980900126	0.5
16673904569	8	3.8167206088681596	0.5	1	7	0.6361201014780266	0.14285714285714285
16673904570	7	1.1996531250512406	2.0	2	5	0.23993062501024812	0.4
16673904571	3	0.14998146334805096	1.0	1	2	0.07499073167402548	0.5
16673904572	20	1.2769857609355386	3.0	3	17	0.07511680946679639	0.17647058823529413
16673904573	8	0.8173167917690061	4.0	4	4	0.20432919794225152	1.0
16673904574	4	0.1502636123687262	2.0	2	2	0.0751318061843631	1.0
16673904575	8	0.30116067959126913	4.0	4	4	0.07529016989781728	1.0
16673904576	19	3.2150341523208086	3.1666666666666665	6	13	0.4592905931886869	0.46153846153846156
16673904577	6	3.37334301842955	1.0	1	5	0.67466860368591	0.2
16673904578	2	0.7149520496493389	0.0	0	2	0.7149520496493389	0.0
16673904579	2	0.7149663254470437	0.0	0	2	0.7149663254470437	0.0
16673904580	9	6.08024170002933	0.5	1	8	0.8686059571470471	0.125
16673904581	3	0.4962631584387624	0.5	1	2	0.4962631584387624	0.5
16673904582	2	0.7149884125302851	0.0	0	2	0.7149884125302851	0.0
16673904583	18	3.9992989034537563	2.333333333333333	5	13	0.6665498172422927	0.38461538461538464
16673904584	14	2.2098435867510764	3.0	5	9	0.44196871735021526	0.5555555555555556
16673904585	4	1.2733887649539402	0.5	1	3	0.6366943824769701	0.3333333333333333
16673904586	5	0.9606974158146278	1.0	2	3	0.4803487079073139	0.6666666666666666
16673904587	15	7.778761666803085	0.0	0	15	0.7778761666803085	0.0
16673904588	4	1.365599677609391	0.0	0	4	0.6827998388046955	0.0
16673904589	45	12.520989277764835	2.5	5	40	0.6260494638882418	0.125
16673904590	7	3.9872669985273372	0.0	0	7	0.7974533997054675	0.0
16673904591	22	5.962808685085565	1.0	2	20	0.5962808685085565	0.1
16673904592	9	4.224074031862705	0.0	0	9	0.844814806372541	0.0
16673904593	15	3.401767478433192	2.0	4	11	0.48596678263331317	0.36363636363636365
16673904594	3	1.6896850324691908	0.0	0	3	0.8448425162345954	0.0
16673904595	4	1.4063113907700975	0.5	1	3	0.7031556953850487	0.3333333333333333
16673904596	45	17.78474884882021	1.5	3	42	0.8468928023247719	0.07142857142857142
16673904597	48	19.214367533172798	2.0	4	44	0.8005986472155332	0.09090909090909091
16673904598	4	0.3949488322077619	1.0	2	2	0.3949488322077619	1.0
16673904599	7	1.5537411562864165	1.0	2	5	0.5179137187621389	0.4
16673904600	2	0.6832263114264596	0.0	0	2	0.6832263114264596	0.0
16673904601	7	1.295847793330354	1.0	2	5	0.43194926444345133	0.4
16673904602	5	0.9906577024982344	0.5	1	4	0.4953288512491172	0.25
16673904603	4	1.367971210833768	0.0	0	4	0.683985605416884	0.0
16673904604	9	1.557490708021318	1.5	3	6	0.5191635693404394	0.5
16673904605	14	2.3687513629767354	2.0	4	10	0.3947918938294559	0.4
16673904606	32	5.537542267219567	10.0	13	19	0.3955387333728262	0.6842105263157895
16673904607	7	1.7737656426464135	0.5	1	6	0.5912552142154711	0.16666666666666666
16673904608	3	0.55006187245201	0.5	1	2	0.55006187245201	0.5
16673904609	6	2.697706785013928	0.0	0	6	0.8992355950046426	0.0
16673904610	15	2.5790066583465254	3.0	5	10	0.42983444305775426	0.5
16673904611	27	10.05164545908255	1.5	3	24	0.8376371215902125	0.125
16673904612	21	5.178854432552698	6.0	8	13	0.5754282702836331	0.6153846153846154
16673904613	15	3.1102007409475703	3.0	5	10	0.5183667901579284	0.5
16673904614	19	6.964085695593462	3.0	5	14	0.6964085695593462	0.35714285714285715
16673904615	4	0.6869218575492892	0.3333333333333333	1	3	0.6869218575492892	0.3333333333333333
16673904616	3	1.1238420063798675	0.0	0	3	0.5619210031899338	0.0
16673904617	2	0.9003781638610403	0.0	0	2	0.9003781638610403	0.0
16673904618	13	3.2902819156921894	2.0	4	9	0.6580563831384378	0.4444444444444444
16673904619	19	8.714087286469503	0.0	0	19	0.8714087286469503	0.0
16673904620	12	2.574566750582993	2.5	4	8	0.5149133501165986	0.5
16673904621	15	3.192566437256169	3.0	5	10	0.5320944062093614	0.5
16673904622	15	2.848449107976444	3.0	5	10	0.47474151799607395	0.5
16673904623	13	3.2835186555215334	2.0	4	9	0.6567037311043067	0.4444444444444444
16673904624	9	0.4047584600683548	4.0	4	5	0.08095169201367096	0.8
16673904625	10	5.440256443157393	0.0	0	10	0.6800320553946742	0.0
16673904626	14	2.656985105730296	6.0	6	8	0.332123138216287	0.75
16673904627	4	1.4467656345321043	0.0	0	4	0.7233828172660521	0.0
16673904628	2	0.8400571611020741	0.0	0	2	0.42002858055103703	0.0
16673904629	14	4.707464124398493	4.5	5	9	0.5884330155498116	0.5555555555555556
16673904630	4	1.3887858289273924	1.0	1	3	0.6943929144636962	0.3333333333333333
16673904631	5	1.1395008056566636	0.5	1	4	0.5697504028283318	0.25
16673904632	8	0.32542670746537017	4.0	4	4	0.08135667686634254	1.0
16673904633	4	0.16280318351635592	2.0	2	2	0.08140159175817796	1.0
16673904634	8	0.3260790171463442	4.0	4	4	0.08151975428658605	1.0
16673904635	12	2.0747754836204244	5.0	5	7	0.29639649766006065	0.7142857142857143
16673904636	8	0.3271434058087076	4.0	4	4	0.0817858514521769	1.0
16673904637	10	0.4413651406635761	5.0	5	5	0.08827302813271523	1.0
16673904638	52	3.386800516635731	14.0	14	38	0.08912632938515082	0.3684210526315789
16673904639	3	0.24553425943979548	0.5	1	2	0.24553425943979548	0.5
16673904640	1	0.08271063863757443	0.0	0	1	0.08271063863757443	0.0
16673904641	1	0.0827109079922481	0.0	0	1	0.0827109079922481	0.0
16673904642	2	0.19734950287396386	0.0	0	2	0.09867475143698193	0.0
16673904643	6	0.34162916548164635	2.0	2	4	0.08540729137041159	0.5
16673904644	2	0.08275838175348343	1.0	1	1	0.08275838175348343	1.0
16673904645	13	1.1708980995243297	2.0	4	9	0.19514968325405493	0.4444444444444444
16673904646	6	0.8822602237522541	1.0	2	4	0.44113011187612705	0.5
16673904647	2	0.08284343049169651	1.0	1	1	0.08284343049169651	1.0
16673904648	4	0.17552995616219016	1.0	2	2	0.17552995616219016	1.0
16673904649	2	0.5960754956706792	0.0	0	2	0.5960754956706792	0.0
16673904650	4	0.2754454562341247	1.0	2	2	0.2754454562341247	1.0
16673904651	4	1.6333010522980045	0.0	0	4	0.5444336840993348	0.0
16673904652	4	0.34671714059004227	1.0	2	2	0.34671714059004227	1.0
16673904653	2	0.5960909498950813	0.0	0	2	0.5960909498950813	0.0
16673904654	6	0.34232635638512154	2.0	2	4	0.08558158909628039	0.5
16673904655	44	2.867593222053265	13.0	13	31	0.09250300716300855	0.41935483870967744
16673904656	4	0.16601587771728782	2.0	2	2	0.08300793885864391	1.0
16673904657	8	0.65054507116805	1.5	2	6	0.13010901423361002	0.3333333333333333
16673904658	3	0.16616799576924612	1.0	1	2	0.08308399788462306	0.5
16673904659	2	0.08318520790325669	1.0	1	1	0.08318520790325669	1.0
16673904660	15	1.1793672501820416	3.6666666666666665	6	9	0.2358734500364083	0.6666666666666666
16673904661	4	0.1665168774103245	2.0	2	2	0.08325843870516225	1.0
16673904662	10	1.9628768318180057	4.0	4	6	0.3271461386363343	0.6666666666666666
16673904663	8	1.1534084628612262	3.0	3	5	0.23068169257224524	0.6
16673904664	14	3.088546510666765	6.0	6	8	0.3860683138333456	0.75
16673904665	16	2.4294437721613664	6.5	7	9	0.3036804715201708	0.7777777777777778
16673904666	5	1.0937465036500758	2.0	2	3	0.36458216788335857	0.6666666666666666
16673904667	11	1.848379075761288	5.0	5	6	0.308063179293548	0.8333333333333334
16673904668	4	1.1861114871788692	1.0	1	3	0.5930557435894346	0.3333333333333333
16673904669	16	2.918184527951052	8.0	8	8	0.3647730659938815	1.0
16673904670	5	1.61912430977444	0.0	0	5	0.5397081032581467	0.0
16673904671	1	0.08340607873567071	0.0	0	1	0.08340607873567071	0.0
16673904672	3	1.5155168661984364	0.0	0	3	0.5051722887328122	0.0
16673904673	38	2.445635725345369	11.0	11	27	0.09057910093871736	0.4074074074074074
16673904674	4	0.16695861907515255	2.0	2	2	0.08347930953757628	1.0
16673904675	8	0.836123000407702	2.0	2	6	0.16722460008154041	0.3333333333333333
16673904676	2	0.16702851661297136	0.0	0	2	0.08351425830648568	0.0
16673904677	4	0.2923497178526628	2.0	2	2	0.1461748589263314	1.0
16673904678	5	0.260784009975281	2.0	2	3	0.08692800332509366	0.6666666666666666
16673904679	3	0.1672797571848423	1.0	1	2	0.08363987859242115	0.5
16673904680	9	0.5962606770088311	4.0	4	5	0.11925213540176623	0.8
16673904681	4	0.16741827282578	2.0	2	2	0.08370913641289	1.0
16673904682	45	2.7410562884939402	14.0	14	31	0.08842117059657871	0.45161290322580644
16673904683	14	3.806678224900176	6.0	6	8	0.475834778112522	0.75
16673904684	2	0.5478349826873967	0.0	0	2	0.5478349826873967	0.0
16673904685	10	3.598676485407693	3.0	3	7	0.5140966407725276	0.42857142857142855
16673904686	2	0.08380940369016576	1.0	1	1	0.08380940369016576	1.0
16673904687	3	0.09909454069590541	0.5	1	2	0.09909454069590541	0.5
16673904688	1	0.08385731515274582	0.0	0	1	0.08385731515274582	0.0
16673904689	2	0.08386852704103756	1.0	1	1	0.08386852704103756	1.0
16673904690	6	0.3455923828114413	2.0	2	4	0.08639809570286032	0.5
16673904691	3	0.1678074903292413	1.0	1	2	0.08390374516462065	0.5
16673904692	11	0.6314743562398047	4.0	5	6	0.12629487124796096	0.8333333333333334
16673904693	3	0.1679570495117997	1.0	1	2	0.08397852475589986	0.5
16673904694	9	1.4117036356517443	3.0	3	6	0.28234072713034886	0.5
16673904695	17	2.8597436881530105	7.0	8	9	0.3574679610191263	0.8888888888888888
16673904696	15	3.9955220458888108	7.0	7	8	0.49944025573610135	0.875
16673904697	2	0.08408562690802013	1.0	1	1	0.08408562690802013	1.0
16673904698	2	0.08408899384144107	1.0	1	1	0.08408899384144107	1.0
16673904699	8	3.7739743925185123	2.0	2	6	0.6289957320864187	0.3333333333333333
16673904700	7	2.207901472215207	2.0	2	5	0.5519753680538018	0.4
16673904701	1	0.08410044141507228	0.0	0	1	0.08410044141507228	0.0
16673904702	1	0.08410114847109068	0.0	0	1	0.08410114847109068	0.0
16673904703	1	0.08410151883376699	0.0	0	1	0.08410151883376699	0.0
16673904704	45	2.968285237980073	13.0	13	32	0.09275891368687728	0.40625
16673904705	3	0.16828902914710492	1.0	1	2	0.08414451457355246	0.5
16673904706	11	0.6828330536028931	5.0	5	6	0.11380550893381552	0.8333333333333334
16673904707	4	0.16844370606846315	2.0	2	2	0.08422185303423158	1.0
16673904708	3	0.1687027915952049	1.0	1	2	0.08435139579760245	0.5
16673904709	1	0.08435424085634315	0.0	0	1	0.08435424085634315	0.0
16673904710	1	0.08437427411019778	0.0	0	1	0.08437427411019778	0.0
16673904711	1	0.08438548599848952	0.0	0	1	0.08438548599848952	0.0
16673904712	4	0.1688388830440795	2.0	2	2	0.08441944152203976	1.0
16673904713	10	0.5997619510732723	5.0	5	5	0.11995239021465447	1.0
16673904714	2	0.16890450457645376	0.0	0	2	0.08445225228822688	0.0
16673904715	2	0.08447881739291814	1.0	1	1	0.08447881739291814	1.0
16673904716	8	0.9748921714319941	3.0	3	5	0.19497843428639883	0.6
16673904717	9	2.4374526293511005	4.0	4	5	0.4874905258702201	0.8
16673904718	1	0.0845916096625198	0.0	0	1	0.0845916096625198	0.0
16673904719	3	0.24880089191413093	0.5	1	2	0.24880089191413093	0.5
16673904720	3	0.15599345966449116	0.5	1	2	0.15599345966449116	0.5
16673904721	5	1.3245801257260077	0.5	1	4	0.6622900628630038	0.25
18951525538	3	1.0078133393659803	1.0	1	2	0.5039066696829901	0.5
18951525539	1	0.5039241103981106	0.0	0	1	0.5039241103981106	0.0
18951525540	26	9.147962212367508	8.0	8	18	0.508220122909306	0.4444444444444444
18951525541	9	3.441083732368253	3.0	3	6	0.5735139553947088	0.5
18951525542	3	1.5121639055511875	0.0	0	3	0.5040546351837292	0.0
19513636832	4	2.6720872499046067	0.0	0	4	0.6680218124761517	0.0
19513636833	3	1.2137635726557465	1.0	1	2	0.6068817863278733	0.5
19513636835	1	0.6701279640082898	0.0	0	1	0.6701279640082898	0.0
19513636836	5	4.3602979695674335	0.0	0	5	0.8720595939134868	0.0
19513636839	3	1.805811407890954	0.0	0	3	0.6019371359636513	0.0
19513636840	2	0.6256228953088753	0.0	0	2	0.6256228953088753	0.0
19513636841	3	0.920744373761663	1.0	1	2	0.4603721868808315	0.5
19513636847	2	1.0725598730827715	0.0	0	2	0.5362799365413857	0.0
19513636849	2	1.4015654287586012	0.0	0	2	0.7007827143793006	0.0
19513636850	4	1.206841662582296	2.0	2	2	0.603420831291148	1.0
19513636851	5	1.2180354031029053	0.0	0	5	0.24360708062058106	0.0
19513636852	10	3.0468365354160825	2.0	3	7	0.5078060892360138	0.42857142857142855
19513636857	2	1.11298869649745	0.0	0	2	0.556494348248725	0.0
19513636858	3	1.4224728732066407	1.0	1	2	0.7112364366033204	0.5
19513636859	2	1.0951650937083226	0.0	0	2	0.5475825468541613	0.0
19513636861	3	1.1495965555193686	0.0	0	3	0.3831988518397895	0.0
19513636863	2	1.4417510585722848	0.0	0	2	0.7208755292861424	0.0
19513636864	2	0.8651477846402988	0.0	0	2	0.4325738923201494	0.0
19513636865	1	0.880176125634023	0.0	0	1	0.880176125634023	0.0
19513636866	4	1.2607995652076855	0.0	0	4	0.3151998913019214	0.0
19513636868	5	0.0	5.0	5	0	0.0	inf
19513636869	3	0.9824433613618195	0.0	0	3	0.32748112045393984	0.0
19513636870	1	0.0	1.0	1	0	0.0	inf
19513636871	1	0.0	1.0	1	0	0.0	inf
19513636873	22	7.6075965694584715	4.0	4	18	0.422644253858804	0.2222222222222222
19513636874	4	0.0	4.0	4	0	0.0	inf
19513636875	17	1.142451047397433	3.0	3	14	0.07616340315982886	0.21428571428571427
19513636877	6	0.9662127894514784	5.0	5	1	0.16103546490857973	5.0
19513636879	6	0.35575079130510995	5.0	5	1	0.07115015826102199	5.0
19513636881	4	0.0	4.0	4	0	0.0	inf
19513636882	4	0.0	4.0	4	0	0.0	inf
19513636884	4	0.0	4.0	4	0	0.0	inf
19513636885	1	0.08148605128304237	0.0	0	1	0.08148605128304237	0.0
19513636886	5	0.0	5.0	5	0	0.0	inf
19513636887	1	0.0	1.0	1	0	0.0	inf
19513636888	3	0.0	3.0	3	0	0.0	inf
19513636889	5	0.0	5.0	5	0	0.0	inf
19513636890	5	0.8824189073243832	4.0	4	1	0.17648378146487664	4.0
19513636891	4	0.0	4.0	4	0	0.0	inf
19513636892	18	2.3503186145930908	4.0	4	14	0.14689491341206817	0.2857142857142857
19513636893	4	0.0	4.0	4	0	0.0	inf
19513636894	17	0.41598512919782105	5.0	5	12	0.034665427433151756	0.4166666666666667
19513636895	7	0.38656634641630505	3.0	3	4	0.07731326928326102	0.75
19513636896	6	4.087732655520254	0.0	0	6	0.8175465311040508	0.0
19513636897	12	3.7000074106204597	5.0	5	7	0.46250092632755746	0.7142857142857143
19513636898	5	2.5866656911538235	1.0	1	4	0.6466664227884559	0.25
19513636899	7	1.8960695328315906	3.0	3	4	0.47401738320789766	0.75
19513636900	10	5.972893458745318	0.5	1	9	0.7466116823431648	0.1111111111111111
19513636901	5	2.6170592011607035	1.0	1	4	0.6542648002901759	0.25
19513636902	1	0.7367366475922033	0.0	0	1	0.7367366475922033	0.0
19513636903	2	0.38168412460926315	1.0	1	1	0.38168412460926315	1.0
19513636904	2	1.4735668622641744	0.0	0	2	0.7367834311320872	0.0
19513636905	14	6.267587841693659	2.0	3	11	0.6963986490770732	0.2727272727272727
19513636906	7	3.8559204005761902	0.5	1	6	0.7711840801152381	0.16666666666666666
19513636907	4	1.7216380050286495	1.0	1	3	0.5738793350095498	0.3333333333333333
19513636908	2	0.05873005937890112	1.0	1	1	0.05873005937890112	1.0
19513636909	1	0.49547304017286914	0.0	0	1	0.49547304017286914	0.0
19513636910	1	0.8695755714435158	0.0	0	1	0.8695755714435158	0.0
19513636911	10	2.5678898185852503	5.0	5	5	0.42798163643087506	1.0
19513636912	7	0.5704597988654578	0.6666666666666666	2	5	0.19015326628848594	0.4
19513636914	3	1.8962329974491776	0.0	0	3	0.9481164987245888	0.0
19513636915	3	0.6765379318550857	0.5	1	2	0.6765379318550857	0.5
19513636917	3	0.49432104390289267	1.0	1	2	0.24716052195144633	0.5
19513636918	1	0.047774495728489415	0.0	0	1	0.047774495728489415	0.0
19513636919	7	0.26779026173092635	4.0	4	3	0.05355805234618527	1.3333333333333333
19513636920	6	1.3702795803871686	3.0	3	3	0.34256989509679214	1.0
19513636921	9	0.8254309329668135	5.0	5	4	0.1650861865933627	1.25
19513636922	16	2.1690672958073565	7.5	8	8	0.27113341197591956	1.0
19513636923	8	1.0944105639286887	5.0	5	3	0.21888211278573774	1.6666666666666667
19513636924	13	2.2294348969248685	7.0	7	6	0.27867936211560856	1.1666666666666667
19513636925	6	2.1804858801418168	2.0	2	4	0.43609717602836334	0.5
19513636926	2	0.07974921867784766	1.0	1	1	0.07974921867784766	1.0
19513636927	5	0.36838100030043147	0.6666666666666666	2	3	0.36838100030043147	0.6666666666666666
19513636928	1	0.354083687891063	0.0	0	1	0.354083687891063	0.0
19513636929	1	0.6022766126373739	0.0	0	1	0.6022766126373739	0.0
19513636930	1	0.28478071684504064	0.0	0	1	0.28478071684504064	0.0
19513636931	10	0.14650099693215127	8.0	8	2	0.014650099693215127	4.0
19513636932	9	0.5552908884014093	4.0	4	5	0.09254848140023487	0.8
19513636933	9	0.42312817945835945	5.0	5	4	0.10578204486458986	1.25
19513636934	11	2.2667966460090714	5.0	5	6	0.3238280922870102	0.8333333333333334
19513636935	10	3.468270642323693	4.0	4	6	0.4954672346176704	0.6666666666666666
19513636936	3	1.0497258019925984	1.0	1	2	0.5248629009962992	0.5
19513636938	3	0.6137945215077518	1.0	1	2	0.3068972607538759	0.5
19513636939	1	0.4736838968698866	0.0	0	1	0.4736838968698866	0.0
19513636940	1	0.13844005328239478	0.0	0	1	0.13844005328239478	0.0
19513636941	1	0.22775095884371696	0.0	0	1	0.22775095884371696	0.0
19513636942	2	0.0	2.0	2	0	0.0	inf
19513636943	3	0.7229608731697392	1.0	1	2	0.2409869577232464	0.5
19513636944	1	0.0	1.0	1	0	0.0	inf
19513636945	4	0.0	4.0	4	0	0.0	inf
19513636947	3	0.010519478433730856	2.0	2	1	0.010519478433730856	2.0
19513636948	9	1.6632284103727542	4.0	4	5	0.2772047350621257	0.8
19513636949	9	0.0750203270187956	8.0	8	1	0.008335591890977288	8.0
19513636950	16	2.2010581126984667	7.0	8	8	0.3144368732426381	1.0
19513636951	17	2.2765926041199753	6.5	8	9	0.2845740755149969	0.8888888888888888
19513636952	10	4.889188059628526	3.0	3	7	0.6111485074535657	0.42857142857142855
19513636953	15	3.815401747377841	8.0	8	7	0.4769252184222301	1.1428571428571428
19513636954	2	0.033584554825914895	1.0	1	1	0.033584554825914895	1.0
19513636955	4	1.0042544907400408	2.0	2	2	0.5021272453700204	1.0
19513636956	1	0.5364391924921964	0.0	0	1	0.5364391924921964	0.0
19513636957	7	0.30056934507454847	3.0	3	4	0.04293847786779264	0.75
19513636958	5	0.2780159752236797	4.0	4	1	0.055603195044735945	4.0
19513636960	13	4.120619480733346	5.0	5	8	0.5150774350916683	0.625
19513636961	1	0.8184608757454432	0.0	0	1	0.8184608757454432	0.0
19513636962	2	0.17012286310415706	1.0	1	1	0.17012286310415706	1.0
19513636963	9	7.621118477100998	0.0	0	9	0.8467909419001108	0.0
19513636964	2	0.670689164470893	1.0	1	1	0.670689164470893	1.0
19513636965	2	1.0435413850156716	0.0	0	2	0.5217706925078358	0.0
19513636966	5	1.7252899830330124	2.0	2	3	0.5750966610110041	0.6666666666666666
19513636967	2	0.8184925585889343	1.0	1	1	0.8184925585889343	1.0
19513636968	14	0.37680520239697374	9.0	9	5	0.026914657314069553	1.8
19513636969	4	0.0	4.0	4	0	0.0	inf
19513636971	15	0.45218713806517896	9.0	9	6	0.030145809204345266	1.5
19513636972	9	0.3643094687224848	5.0	5	4	0.07286189374449696	1.25
19513636973	7	0.5982943384644164	4.0	4	3	0.11965886769288328	1.3333333333333333
19513636974	5	0.38857657401528056	3.0	3	2	0.09714414350382014	1.5
19513636975	11	1.5758571951552387	4.5	5	6	0.3151714390310477	0.8333333333333334
19513636976	8	1.7959731274269488	4.0	4	4	0.3591946254853898	1.0
19513636977	1	0.947858692632547	0.0	0	1	0.947858692632547	0.0
19513636978	10	2.909894228796661	5.0	5	5	0.4849823714661102	1.0
19513636979	4	0.1617544174250656	1.0	2	2	0.1617544174250656	1.0
19513636980	2	0.1531527779372395	1.0	1	1	0.1531527779372395	1.0
19513636981	3	0.682311885978665	0.5	1	2	0.682311885978665	0.5
19513636982	4	0.0	4.0	4	0	0.0	inf
19513636984	1	0.0	1.0	1	0	0.0	inf
19513636985	14	0.3021045993758311	10.0	10	4	0.02157889995541651	2.5
19513636986	7	0.7417029080574319	3.0	3	4	0.1483405816114864	0.75
19513636987	10	1.4754579004200488	2.0	3	7	0.29509158008400976	0.42857142857142855
19513636988	7	0.6745129234183923	4.0	4	3	0.16862823085459808	1.3333333333333333
19513636989	6	2.1133695976753613	0.5	1	5	0.5283423994188403	0.2
19513636990	13	1.803426070239551	6.0	6	7	0.22542825877994388	0.8571428571428571
19513636991	9	1.1923003148385773	5.0	5	4	0.23846006296771546	1.25
19513636992	2	0.4856084639588464	1.0	1	1	0.4856084639588464	1.0
19513636994	2	0.6313036190460286	0.0	0	2	0.3156518095230143	0.0
19513636995	2	1.7548738802294914	0.0	0	2	0.8774369401147457	0.0
19513636996	6	0.19566505975279908	5.0	5	1	0.039133011950559814	5.0
19513636998	1	0.0	1.0	1	0	0.0	inf
19513636999	8	0.1508604686562572	6.0	6	2	0.01885755858203215	3.0
19513637000	7	1.2149312251661304	3.0	3	4	0.3037328062915326	0.75
19513637001	8	1.5318936303579147	2.0	2	6	0.25531560505965245	0.3333333333333333
19513637002	13	2.9782672528318184	6.0	6	7	0.3722834066039773	0.8571428571428571
19513637003	15	2.2457444234239308	8.0	8	7	0.28071805292799135	1.1428571428571428
19513637004	7	1.3177088206618737	3.0	3	4	0.26354176413237473	0.75
19513637005	10	1.8586182906570592	5.0	5	5	0.30976971510950985	1.0
19513637006	11	2.1673019789454204	6.0	6	5	0.27091274736817755	1.2
19513637007	8	2.0125936777677045	4.0	4	4	0.4025187355535409	1.0
19513637008	1	0.0	1.0	1	0	0.0	inf
19513637009	8	0.30243442417374694	4.0	4	4	0.03780430302171837	1.0
19513637010	6	0.1957573810672014	5.0	5	1	0.03915147621344028	5.0
19513637011	2	0.36726829614347745	0.0	0	2	0.18363414807173872	0.0
19513637012	1	0.0	1.0	1	0	0.0	inf
19513637013	4	0.42324767192546875	1.0	2	2	0.42324767192546875	1.0
19513637015	8	2.5501593451745466	4.0	4	4	0.3187699181468183	1.0
19513637017	2	0.0	2.0	2	0	0.0	inf
19513637018	2	0.667610373212112	1.0	1	1	0.333805186606056	1.0
19513637019	4	0.0	4.0	4	0	0.0	inf
19513637020	4	0.0	4.0	4	0	0.0	inf
19513637021	3	0.0	3.0	3	0	0.0	inf
19513637022	1	0.0	1.0	1	0	0.0	inf
19513637023	9	0.08003237777854919	5.0	5	4	0.01600647555570984	1.25
19513637024	28	7.450181994535669	10.0	10	18	0.4656363746584793	0.5555555555555556
19513637025	9	1.003469422874279	5.0	5	4	0.20069388457485582	1.25
19513637026	6	1.7995745677606627	2.0	2	4	0.35991491355213256	0.5
19513637028	2	0.01659665858120052	1.0	1	1	0.01659665858120052	1.0
19513637029	17	4.146353727264319	8.0	8	9	0.4146353727264319	0.8888888888888888
19513637030	7	4.066292023495674	0.5	1	6	0.8132584046991347	0.16666666666666666
19513637031	3	0.9937242044500287	1.0	1	2	0.49686210222501437	0.5
19513637032	1	0.0	1.0	1	0	0.0	inf
19513637033	2	0.0	2.0	2	0	0.0	inf
19513637034	3	1.122140896938269	1.0	1	2	0.5610704484691345	0.5
19513637035	5	0.1958580860458219	4.0	4	1	0.04896452151145547	4.0
19513637036	2	1.2732872519112988	0.0	0	2	0.6366436259556494	0.0
19513637037	42	10.109633412666142	18.0	18	24	0.5054816706333071	0.75
19513637038	7	2.8502321012388396	2.0	2	5	0.570046420247768	0.4
19513637039	8	1.7514406518894878	4.0	4	4	0.3502881303778976	1.0
19513637040	10	3.2304136308010034	4.0	4	6	0.5384022718001672	0.6666666666666666
19513637041	7	4.3448915892892055	1.0	1	6	0.7241485982148675	0.16666666666666666
19513637042	5	3.9204297338334753	0.0	0	5	0.7840859467666951	0.0
19513637043	1	0.36213123114580414	0.0	0	1	0.36213123114580414	0.0
19513637044	2	0.07615010152819385	1.0	1	1	0.07615010152819385	1.0
19513637045	4	0.184802187779466	1.0	2	2	0.184802187779466	1.0
19513637046	1	0.3621318035244857	0.0	0	1	0.3621318035244857	0.0
19513637048	4	0.19596512085927373	3.0	3	1	0.06532170695309124	3.0
19513637049	2	0.0	2.0	2	0	0.0	inf
19513637050	3	1.910822222986142	0.0	0	3	0.6369407409953807	0.0
19513637051	1	0.0	1.0	1	0	0.0	inf
19513637052	38	9.684522311438851	15.0	15	23	0.5097117006020447	0.6521739130434783
19513637053	5	0.1960764653475044	4.0	4	1	0.0490191163368761	4.0
19513637054	3	1.9116253039457058	0.0	0	3	0.6372084346485686	0.0
19513637055	5	0.7668925531075668	3.0	3	2	0.2556308510358556	1.5
19513637056	41	10.338642257835922	14.0	14	27	0.49231629799218674	0.5185185185185185
19513637057	6	0.19618339915295363	5.0	5	1	0.039236679830590725	5.0
19513637058	3	1.912369429901069	0.0	0	3	0.6374564766336897	0.0
19513637059	1	0.0	1.0	1	0	0.0	inf
19513637060	22	6.35532928491014	8.0	8	14	0.48887148345462617	0.5714285714285714
19513637061	9	2.106162441002488	4.0	4	5	0.42123248820049763	0.8
19513637062	3	0.5251537367052004	0.5	1	2	0.5251537367052004	0.5
19513637063	15	3.832128504266427	7.0	7	8	0.47901606303330335	0.875
19513637064	17	3.4611082995346525	7.0	8	9	0.43263853744183156	0.8888888888888888
19513637065	8	2.724496935535043	2.0	2	6	0.4540828225891738	0.3333333333333333
19513637066	5	1.5212060409384762	0.5	1	4	0.7606030204692381	0.25
19513637067	17	4.013559280603497	5.0	5	12	0.5016949100754371	0.4166666666666667
19513637068	8	3.819339712706978	4.0	4	4	0.47741746408837227	1.0
19513637069	3	1.9131708610632567	0.0	0	3	0.6377236203544189	0.0
19513637070	1	0.0	1.0	1	0	0.0	inf
19513637071	38	9.197822220326266	14.0	14	24	0.4598911110163133	0.5833333333333334
19513637072	4	1.6210027219299856	1.0	1	3	0.5403342406433286	0.3333333333333333
19513637073	2	0.5083111573069341	1.0	1	1	0.5083111573069341	1.0
19513637074	3	1.9266683584384796	0.0	0	3	0.6422227861461599	0.0
19513637075	2	0.6461896060947151	1.0	1	1	0.6461896060947151	1.0
19513637076	2	1.8855551047979913	0.0	0	2	0.9427775523989956	0.0
19513637078	1	0.7819884011163808	0.0	0	1	0.7819884011163808	0.0
19513637079	1	0.8530366894398187	0.0	0	1	0.8530366894398187	0.0
19513637080	5	0.19637682947798693	4.0	4	1	0.04909420736949673	4.0
19513637081	3	1.9138620924945768	0.0	0	3	0.6379540308315256	0.0
19513637082	11	2.080727582191306	6.0	6	5	0.2972467974559008	1.2
19513637083	15	8.070248338611956	0.0	0	15	0.6207883337393812	0.0
19513637084	26	10.307847409365266	8.0	8	18	0.6871898272910177	0.4444444444444444
19513637085	1	0.0	1.0	1	0	0.0	inf
19513637086	6	3.3954041089449425	1.0	1	5	0.6790808217889885	0.2
19513637087	4	0.0	4.0	4	0	0.0	inf
19513637088	2	1.689598603288275	0.0	0	2	0.8447993016441375	0.0
19513637089	3	0.30646649529200015	2.0	2	1	0.30646649529200015	2.0
19513637090	1	0.0	1.0	1	0	0.0	inf
19513637091	33	13.02376044915161	8.0	8	25	0.6854610762711374	0.32
19513637092	9	1.8775731830756244	4.0	4	5	0.37551463661512485	0.8
19513637093	8	1.8855477312137994	3.0	3	5	0.3142579552022999	0.6
19513637094	12	3.363864292785567	5.0	5	7	0.48055204182650957	0.7142857142857143
19513637096	2	0.3626233421346095	1.0	1	1	0.18131167106730475	1.0
19513637097	1	0.0	1.0	1	0	0.0	inf
19513637100	4	0.0	4.0	4	0	0.0	inf
19513637101	1	0.0	1.0	1	0	0.0	inf
19513637102	38	17.989894486030376	0.0	0	38	0.5451483177584963	0.0
19513637103	25	11.082351117486885	6.0	6	19	0.738823407832459	0.3157894736842105
19513637104	7	0.16685144958436385	4.0	4	3	0.03337028991687277	1.3333333333333333
19513637105	9	0.8410864999875255	5.0	5	4	0.1682172999975051	1.25
19513637106	8	0.42390146305714793	4.0	4	4	0.08478029261142958	1.0
19513637107	14	1.8262479530307398	7.0	7	7	0.22828099412884248	1.0
19513637108	8	0.7006167919003164	4.0	4	4	0.1401233583800633	1.0
19513637109	14	1.516650074979924	6.0	6	8	0.1895812593724905	0.75
19513637110	8	1.720782029545043	3.0	3	5	0.3441564059090086	0.6
19513637111	2	0.06092210138260764	1.0	1	1	0.06092210138260764	1.0
19513637112	9	2.334108210613941	2.0	2	7	0.3890180351023235	0.2857142857142857
19513637113	4	1.4932961157002227	1.0	1	3	0.7466480578501113	0.3333333333333333
19513637114	4	0.31749417865628854	1.0	2	2	0.31749417865628854	1.0
19513637115	2	0.7839451281432975	0.0	0	2	0.7839451281432975	0.0
19513637117	1	0.6980975513067624	0.0	0	1	0.6980975513067624	0.0
19513637118	13	5.319850695357608	3.0	3	10	0.7599786707653725	0.3
19513637119	1	0.0	1.0	1	0	0.0	inf
19513637120	3	0.0	3.0	3	0	0.0	inf
19513637121	3	2.5361681543518104	0.0	0	3	0.8453893847839368	0.0
19513637122	1	0.0	1.0	1	0	0.0	inf
19513637123	32	12.800147687167573	10.0	10	22	0.6736919835351355	0.45454545454545453
19513637124	5	3.73680876730608	0.0	0	5	0.747361753461216	0.0
19513637125	5	3.805445792590773	0.0	0	5	0.7610891585181546	0.0
19513637126	7	5.965450818748984	0.0	0	7	0.8522072598212834	0.0
19513637127	3	0.3967115565309636	0.5	1	2	0.3967115565309636	0.5
19513637128	2	0.18161225404845965	1.0	1	1	0.18161225404845965	1.0
19513637129	1	0.9403903966035453	0.0	0	1	0.9403903966035453	0.0
19513637130	7	0.4776314242899399	5.0	5	2	0.07960523738165665	2.5
19513637131	3	2.537103488456149	0.0	0	3	0.8457011628187163	0.0
19513637132	2	0.0	2.0	2	0	0.0	inf
19513637133	38	15.734449186695345	10.0	10	28	0.7152022357588793	0.35714285714285715
19513637134	11	1.5799804764998653	5.0	5	6	0.2633300794166442	0.8333333333333334
19513637135	7	3.7161630682621847	1.0	1	6	0.6193605113770307	0.16666666666666666
19513637136	2	0.9549746390790468	0.0	0	2	0.9549746390790468	0.0
19513637137	14	3.913493076591641	7.0	7	7	0.4891866345739551	1.0
19513637138	8	3.477496578606431	2.0	3	5	0.5795827631010718	0.6
19513637139	4	0.12189935313465036	1.0	2	2	0.12189935313465036	1.0
19513637140	2	0.9550010695064012	0.0	0	2	0.9550010695064012	0.0
19513637141	6	1.4944062273184426	1.0	2	4	0.7472031136592213	0.5
19513637142	2	1.4681106119781955	0.0	0	2	0.7340553059890977	0.0
19513637143	5	2.288422661387809	0.5	1	4	0.7628075537959363	0.25
19513637144	6	0.19989194163878818	5.0	5	1	0.03997838832775764	5.0
19513637145	3	2.5377283912990762	0.0	0	3	0.8459094637663588	0.0
19513637146	1	0.0	1.0	1	0	0.0	inf
19513637147	31	12.455379024617573	10.0	10	21	0.6919655013676429	0.47619047619047616
19513637148	17	2.4077385328392333	7.0	8	9	0.30096731660490417	0.8888888888888888
19513637149	14	2.8369865514915062	7.0	7	7	0.3546233189364383	1.0
19513637150	17	3.026834526703604	7.0	8	9	0.3783543158379505	0.8888888888888888
19513637151	5	1.4005265614515685	1.0	1	4	0.46684218715052284	0.25
19513637152	14	3.2369492862724027	7.0	7	7	0.40461866078405034	1.0
19513637153	6	4.445769459940849	0.0	0	6	0.7409615766568082	0.0
19513637154	1	0.0	1.0	1	0	0.0	inf
19513637155	1	0.0	1.0	1	0	0.0	inf
19513637156	1	0.8956216970172707	0.0	0	1	0.8956216970172707	0.0
19513637158	6	0.20008870522790823	5.0	5	1	0.040017741045581645	5.0
19513637159	3	2.5385941982282727	0.0	0	3	0.8461980660760909	0.0
19513637160	1	0.0	1.0	1	0	0.0	inf
19513637161	21	8.228451853373956	4.0	4	17	0.7480410775794506	0.23529411764705882
19513637162	16	1.1255409273147425	7.0	8	8	0.14069261591434282	1.0
19513637163	14	0.902846058719925	7.0	7	7	0.12897800838856072	1.0
19513637164	6	0.4902076950118579	3.0	3	3	0.12255192375296448	1.0
19513637165	9	1.4285052058009435	5.0	5	4	0.2857010411601887	1.25
19513637166	7	3.7515832751891987	0.5	1	6	0.7503166550378397	0.16666666666666666
19513637168	2	0.5390408556158951	1.0	1	1	0.26952042780794755	1.0
19513637169	7	5.0869685299803695	0.0	0	7	0.7267097899971956	0.0
19513637170	1	0.5390520675041869	0.0	0	1	0.5390520675041869	0.0
19513637172	2	0.4548573856226623	1.0	1	1	0.4548573856226623	1.0
19513637173	18	7.547283445323711	5.0	5	13	0.6289402871103092	0.38461538461538464
19513637174	8	0.40902820301679255	6.0	6	2	0.06817136716946542	3.0
19513637175	1	0.8464398231188262	0.0	0	1	0.8464398231188262	0.0
19513637176	4	0.1747441812404099	3.0	3	1	0.05824806041346997	3.0
19513637177	38	14.544683566674724	12.0	12	26	0.692603979365463	0.46153846153846156
19513637178	6	0.7941300007336547	3.0	3	3	0.15882600014673093	1.0
19513637179	15	2.8492278123380403	7.0	7	8	0.31658086803756	0.875
19513637180	10	0.7239204155253744	5.0	6	4	0.1809801038813436	1.5
19513637181	2	0.5901442047483391	0.0	0	2	0.5901442047483391	0.0
19513637182	7	4.121326637759748	1.0	1	6	0.5887609482513926	0.16666666666666666
19513637183	4	1.5305526817843549	1.0	1	3	0.7652763408921774	0.3333333333333333
19513637184	2	1.061554377809727	0.0	0	2	0.5307771889048635	0.0
19513637185	2	1.161956702784996	0.0	0	2	0.580978351392498	0.0
19513637186	2	0.5874605904651745	1.0	1	1	0.5874605904651745	1.0
19513637187	11	5.898494465620024	0.5	1	10	0.737311808202503	0.1
19513637188	2	0.4806512268751858	1.0	1	1	0.4806512268751858	1.0
19513637189	6	0.2004736130565907	5.0	5	1	0.04009472261131814	5.0
19513637190	4	1.2807157171179306	1.0	1	3	0.32017892927948266	0.3333333333333333
19513637191	35	13.435469370888828	10.0	10	25	0.6717734685444414	0.4
19513637192	8	0.9410217639586409	4.0	4	4	0.18820435279172817	1.0
19513637193	9	0.6315095406940536	4.0	4	5	0.1052515901156756	0.8
19513637194	4	1.431068384875641	0.5	1	3	0.7155341924378205	0.3333333333333333
19513637195	8	2.2332807766249436	3.0	3	5	0.4466561553249887	0.6
19513637196	4	0.08009564245752875	1.0	2	2	0.08009564245752875	1.0
19513637197	5	1.2915292635166469	1.0	1	4	0.43050975450554896	0.25
19513637199	6	1.258693144320874	2.0	2	4	0.41956438144029135	0.5
19513637200	2	0.6383896671237503	0.0	0	2	0.6383896671237503	0.0
19513637201	3	1.59065907620707	0.0	0	3	0.5302196920690233	0.0
19513637202	4	2.2050242255910035	1.0	1	3	0.7350080751970012	0.3333333333333333
19513637203	6	0.2006801407526315	5.0	5	1	0.0401360281505263	5.0
19513637204	4	2.954821679293733	0.0	0	4	0.7387054198234333	0.0
19513637205	7	4.534748251189529	2.0	2	5	0.6478211787413614	0.4
19513637206	24	10.62716336835696	7.0	7	17	0.7084775578904641	0.4117647058823529
19513637207	7	0.4346215770534329	4.0	5	2	0.10865539426335823	2.5
19513637208	5	2.874550619604973	1.0	1	4	0.7186376549012432	0.25
19513637209	2	1.556621971860046	0.0	0	2	0.778310985930023	0.0
19513637210	5	3.1167401337150675	1.0	1	4	0.7791850334287669	0.25
19513637211	3	0.727799998228993	0.5	1	2	0.727799998228993	0.5
19513637212	2	0.3227744393323546	1.0	1	1	0.3227744393323546	1.0
19513637213	1	0.4432554717634317	0.0	0	1	0.4432554717634317	0.0
19513637214	7	0.9072911515609254	3.0	4	3	0.22682278789023136	1.3333333333333333
19513637215	2	0.22898164034774093	1.0	1	1	0.22898164034774093	1.0
19513637216	2	0.9752698066844874	0.0	0	2	0.9752698066844874	0.0
19513637217	10	3.8367323480182245	2.0	2	8	0.7673464696036449	0.25
19513637218	6	0.20087875615513306	5.0	5	1	0.04017575123102661	5.0
19513637219	1	0.0	1.0	1	0	0.0	inf
19513637220	34	15.472883240102387	8.0	8	26	0.7368039638143994	0.3076923076923077
19513637221	8	3.5023946135529775	2.0	2	6	0.5837324355921629	0.3333333333333333
19513637222	3	0.9561551869444328	0.0	0	3	0.31871839564814425	0.0
19513637223	3	0.16392858101230692	2.0	2	1	0.16392858101230692	2.0
19513637224	2	0.16711454176187654	1.0	1	1	0.16711454176187654	1.0
19513637225	4	0.7822710215077351	2.0	2	2	0.39113551075386754	1.0
19513637226	1	0.5747868133513859	0.0	0	1	0.5747868133513859	0.0
19513637227	4	0.7870850292436686	2.0	2	2	0.3935425146218343	1.0
19513637228	6	1.5991062407895433	2.0	2	4	0.39977656019738583	0.5
19513637229	3	1.3795426539455393	1.0	1	2	0.6897713269727697	0.5
19513637230	4	0.0	4.0	4	0	0.0	inf
19513637231	2	1.694799235988936	0.0	0	2	0.847399617994468	0.0
19513637232	1	0.0	1.0	1	0	0.0	inf
19513637233	36	14.634053662925588	10.0	10	26	0.6968596982345518	0.38461538461538464
19513637234	1	0.875390972517507	0.0	0	1	0.875390972517507	0.0
19513637235	3	0.619933989923509	0.5	1	2	0.619933989923509	0.5
19513637236	2	1.1394211440119242	0.0	0	2	0.5697105720059621	0.0
19513637237	2	0.6274496923750776	1.0	1	1	0.6274496923750776	1.0
19513637238	3	1.4975917166973334	1.0	1	2	0.7487958583486667	0.5
19513637239	1	0.8753931273548964	0.0	0	1	0.8753931273548964	0.0
19513637240	2	0.5331273757713518	1.0	1	1	0.5331273757713518	1.0
19513637241	2	0.6953713453158229	0.0	0	2	0.6953713453158229	0.0
19513637242	3	1.3639163792455893	1.0	1	2	0.6819581896227946	0.5
19513637243	7	0.2788344767383115	5.0	5	2	0.06970861918457788	2.5
19513637244	3	1.949750235828434	1.0	1	2	0.6499167452761446	0.5
19513637245	30	11.339387494879313	10.0	10	20	0.6299659719377396	0.5
19513637246	15	1.8260528055696619	8.0	8	7	0.22825660069620773	1.1428571428571428
19513637247	10	0.7666424909623931	5.0	5	5	0.1277737484937322	1.0
19513637248	9	0.8857681980142028	3.0	3	6	0.12653831400202897	0.5
19513637249	6	1.1872198143223758	2.5	3	3	0.29680495358059394	1.0
19513637250	9	5.293150273612161	0.0	0	9	0.7561643248017373	0.0
19513637251	9	5.078766646497613	1.0	1	8	0.6348458308122016	0.125
19513637252	3	1.906891765918533	0.0	0	3	0.9534458829592665	0.0
19513637253	1	0.4551126328453042	0.0	0	1	0.4551126328453042	0.0
19513637254	4	0.291067623275301	1.0	2	2	0.291067623275301	1.0
19513637255	18	1.7415145618018644	8.0	9	9	0.21768932022523305	1.0
19513637256	1	0.0	1.0	1	0	0.0	inf
19513637257	2	0.4551414201260533	1.0	1	1	0.4551414201260533	1.0
19513637258	15	2.1993796627187914	4.0	6	9	0.31419709467411305	0.6666666666666666
19513637259	6	0.03521718084173134	5.0	5	1	0.008804295210432835	5.0
19513637260	4	0.5750078861998053	2.0	2	2	0.19166929539993507	1.0
19513637261	15	2.550681152516124	8.0	8	7	0.3188351440645155	1.1428571428571428
19513637262	10	2.121109807247439	5.0	5	5	0.35351830120790645	1.0
19513637263	13	3.7869571867816756	5.0	5	8	0.47336964834770945	0.625
19513637264	18	2.7898449382381516	8.0	9	9	0.34873061727976895	1.0
19513637265	12	3.181794674501207	6.0	6	6	0.4545420963573153	1.0
19513637266	5	2.3498131705479386	0.5	1	4	0.7832710568493129	0.25
19513637267	2	1.6364033447520636	0.0	0	2	0.8182016723760318	0.0
19513637268	3	0.5903436618841958	0.5	1	2	0.5903436618841958	0.5
19513637269	4	0.756333243851466	1.0	1	3	0.25211108128382204	0.3333333333333333
19513637271	9	0.31176375898184205	4.0	4	5	0.062352751796368414	0.8
19513637273	1	0.0	1.0	1	0	0.0	inf
19513637274	14	0.2960118639959567	5.0	5	9	0.03289020711066185	0.5555555555555556
19513637275	14	0.6929362443884584	3.5	5	9	0.11548937406474306	0.5555555555555556
19513637276	3	0.057073157773119665	0.0	0	3	0.01902438592437322	0.0
19513637277	13	2.300931694449311	6.0	6	7	0.328704527778473	0.8571428571428571
19513637278	31	0.7775650249959455	10.0	10	21	0.03702690595218788	0.47619047619047616
19513637279	8	0.3614129969084481	2.0	2	6	0.06023549948474135	0.3333333333333333
19513637280	9	0.42588889651686357	3.5	4	5	0.10647222412921589	0.8
19513637281	27	2.566485470655374	9.0	11	16	0.21387378922128117	0.6875
19513637282	3	0.057551531673567594	0.0	0	3	0.019183843891189198	0.0
19513637283	2	0.019201924323659674	1.0	1	1	0.019201924323659674	1.0
19513637284	31	0.7196817157030778	10.0	10	21	0.034270557890622756	0.47619047619047616
19513637285	2	0.9254909081518408	0.0	0	2	0.4627454540759204	0.0
19513637286	3	0.6889958548672575	0.5	1	2	0.6889958548672575	0.5
19513637287	3	0.9913789669756692	0.0	0	3	0.3304596556585564	0.0
19513637288	2	0.054816268631725736	0.0	0	2	0.027408134315862868	0.0
19513637289	15	0.6465092964230339	3.6666666666666665	6	9	0.12930185928460677	0.6666666666666666
19513637290	3	0.05828060743653911	0.0	0	3	0.019426869145513035	0.0
19513637291	3	0.19613390523166574	1.0	1	2	0.09806695261583287	0.5
19513637292	1	0.019473400165390505	0.0	0	1	0.019473400165390505	0.0
19513637293	24	0.5825310295742341	7.0	7	17	0.034266531151425535	0.4117647058823529
19513637294	9	0.24243311174309948	3.0	3	6	0.04040551862384991	0.5
19513637295	17	0.9423605913641457	4.0	6	11	0.1346229416234494	0.5454545454545454
19513637296	3	0.05876514282514737	0.0	0	3	0.01958838094171579	0.0
19513637297	6	0.41446388133956946	3.0	3	3	0.13815462711318982	1.0
19513637298	7	0.4518301757838903	3.0	3	4	0.11295754394597257	0.75
19513637299	6	3.3089620326742706	1.0	1	5	0.6617924065348542	0.2
19513637300	11	0.6818316602648355	5.0	5	6	0.11363861004413926	0.8333333333333334
19513637301	6	1.0752062490823002	0.5	1	5	0.5376031245411501	0.2
19513637302	8	0.9464455233371079	4.0	4	4	0.23661138083427696	1.0
19513637303	3	0.03959523803832089	1.0	1	2	0.019797619019160446	0.5
19513637304	2	0.12471481653057914	0.0	0	2	0.06235740826528957	0.0
19513637305	2	0.019794268920406602	1.0	1	1	0.019794268920406602	1.0
19513637306	1	0.01980548080869835	0.0	0	1	0.01980548080869835	0.0
19513637307	2	0.019827399545268708	1.0	1	1	0.019827399545268708	1.0
19513637308	26	0.5245140866938892	9.0	9	17	0.030853769805522895	0.5294117647058824
19513637309	12	0.5115230097745107	2.5	4	8	0.10230460195490214	0.5
19513637310	10	2.8604587574729505	2.0	3	7	0.47674312624549176	0.42857142857142855
19513637311	4	0.08009039004139207	0.0	0	4	0.020022597510348017	0.0
19513637312	8	0.08091023832939229	4.0	4	4	0.02022755958234807	1.0
19513637313	5	0.0806456983705086	1.0	1	4	0.02016142459262715	0.25
19513637314	3	0.06091257296102637	0.0	0	3	0.02030419098700879	0.0
19513637315	3	0.07403438790514015	0.5	1	2	0.07403438790514015	0.5
19513637316	3	0.23838232047502583	0.5	1	2	0.23838232047502583	0.5
19513637317	2	0.6491530798838286	0.0	0	2	0.6491530798838286	0.0
19513637318	2	0.6491465817023262	0.0	0	2	0.6491465817023262	0.0
19513637319	5	0.10166236613872365	0.0	0	5	0.02033247322774473	0.0
19513637320	10	0.5783180194539392	4.0	4	6	0.09638633657565654	0.6666666666666666
19513637321	29	0.5256236596027619	4.0	4	25	0.021024946384110475	0.16
19513637322	1	0.020398195768121585	0.0	0	1	0.020398195768121585	0.0
19513637323	18	1.0503506374968574	8.0	9	9	0.13129382968710718	1.0
19513637324	10	2.3477710244201324	4.0	4	6	0.39129517073668874	0.6666666666666666
19513637325	7	1.3974500933768481	2.0	2	5	0.2794900186753696	0.4
19513637326	4	0.49394566449579147	0.3333333333333333	1	3	0.49394566449579147	0.3333333333333333
19513637327	7	3.556791597965793	0.0	0	7	0.5081130854236847	0.0
19513637328	3	0.22470284034840085	0.5	1	2	0.22470284034840085	0.5
19513637329	4	0.4781484842553944	1.0	1	3	0.2390742421276972	0.3333333333333333
19513637330	2	0.020577215618113254	1.0	1	1	0.020577215618113254	1.0
19513637331	1	0.020577754327460604	0.0	0	1	0.020577754327460604	0.0
19513637332	1	0.020588326498402372	0.0	0	1	0.020588326498402372	0.0
19513637333	2	0.8208271228843494	0.0	0	2	0.4104135614421747	0.0
19513637334	1	0.020590043634447056	0.0	0	1	0.020590043634447056	0.0
19513637335	8	0.08342372146679647	4.0	4	4	0.020855930366699117	1.0
19513637336	1	0.020647954889287317	0.0	0	1	0.020647954889287317	0.0
19513637337	11	1.4312077422499336	5.0	5	6	0.23853462370832226	0.8333333333333334
19513637338	9	0.9286436372685456	3.5	4	5	0.2321609093171364	0.8
19513637339	2	0.7179099006596394	0.0	0	2	0.7179099006596394	0.0
19513637340	6	3.213575462085518	0.0	0	6	0.6427150924171036	0.0
19513637341	11	6.110464674858438	0.5	1	10	0.7638080843573047	0.1
19513637342	5	1.3630428957081935	0.5	1	4	0.6815214478540967	0.25
19513637343	4	0.08376671097438816	0.0	0	4	0.02094167774359704	0.0
19553634545	4	3.4106426812614696	0.0	0	4	0.8526606703153674	0.0
19553634546	25	21.549262326772535	0.0	0	25	0.8619704930709013	0.0
19553634547	2	1.70114816133281	0.0	0	2	0.850574080666405	0.0
19553634548	5	4.253153596102061	0.0	0	5	0.8506307192204122	0.0
19553634549	2	1.701286239272403	0.0	0	2	0.8506431196362015	0.0
19553634550	1	0.8508074428218108	0.0	0	1	0.8508074428218108	0.0
19553634551	5	4.254269599853767	0.0	0	5	0.8508539199707534	0.0
19553634552	1	0.8508767343116138	0.0	0	1	0.8508767343116138	0.0
19553634553	28	23.972217412183717	0.0	0	28	0.8561506218637042	0.0
19712750895	2	0.29851167738367185	1.0	1	1	0.29851167738367185	1.0
19712750896	1	0.378780346549703	0.0	0	1	0.378780346549703	0.0
19712750897	1	0.0	1.0	1	0	0.0	inf
19712750899	6	0.16357111369100513	5.0	5	1	0.03271422273820103	5.0
19712750901	2	0.02528186535653451	1.0	1	1	0.012640932678267255	1.0
19712750902	10	0.028284462911999438	9.0	9	1	0.0028284462911999436	9.0
19712750903	1	0.25814635433331234	0.0	0	1	0.25814635433331234	0.0
19712750904	9	4.334269251039465	2.0	2	7	0.6191813215770664	0.2857142857142857
19712750905	5	0.11786112052823683	1.0	1	4	0.023572224105647365	0.25
19712750906	6	0.16365104469041838	5.0	5	1	0.03273020893808368	5.0
19712750908	1	0.0	1.0	1	0	0.0	inf
19712750909	2	0.32834583874132983	1.0	1	1	0.32834583874132983	1.0
19712750910	3	0.5453993430506848	0.5	1	2	0.5453993430506848	0.5
19712750911	1	0.8756266915263073	0.0	0	1	0.8756266915263073	0.0
19712750912	1	0.36586876292839304	0.0	0	1	0.36586876292839304	0.0
19712750913	5	0.7257753264856417	1.5	2	3	0.36288766324282085	0.6666666666666666
19712750915	1	0.0	1.0	1	0	0.0	inf
19712750916	5	0.0	5.0	5	0	0.0	inf
19712750917	7	0.13767437895313756	2.0	2	5	0.02753487579062751	0.4
19712750918	11	7.729287778769041	0.5	1	10	0.85880975319656	0.1
19712750919	1	0.6027739087036474	0.0	0	1	0.6027739087036474	0.0
19712750921	1	0.0	1.0	1	0	0.0	inf
19712750924	3	1.606977255725024	0.0	0	3	0.5356590852416746	0.0
19712750925	4	2.394655471298795	0.0	0	4	0.5986638678246987	0.0
19712750927	5	0.9357894147451549	1.0	1	4	0.3119298049150516	0.25
19712750928	6	0.5559173400337104	5.0	5	1	0.11118346800674209	5.0
19712750929	2	0.18419415327297747	1.0	1	1	0.09209707663648874	1.0
19712750930	1	0.0	1.0	1	0	0.0	inf
19712750932	5	0.0	5.0	5	0	0.0	inf
19712750933	4	0.0	4.0	4	0	0.0	inf
19712750934	4	0.0	4.0	4	0	0.0	inf
19712750935	4	0.0	4.0	4	0	0.0	inf
19712750936	10	1.7484474480782672	5.0	5	5	0.2185559310097834	1.0
19712750937	4	0.0	4.0	4	0	0.0	inf
19712750938	4	0.0	4.0	4	0	0.0	inf
19712750939	3	0.0	3.0	3	0	0.0	inf
19712750940	4	0.0	4.0	4	0	0.0	inf
19712750941	4	0.0	4.0	4	0	0.0	inf
19712750942	5	0.0	5.0	5	0	0.0	inf
19712750943	4	0.0	4.0	4	0	0.0	inf
19712750946	1	0.9662412400388853	0.0	0	1	0.9662412400388853	0.0
19712750948	11	1.824783235984626	5.0	5	6	0.304130539330771	0.8333333333333334
19712750949	3	1.0468820226865994	1.0	1	2	0.5234410113432997	0.5
19712750955	1	0.8925852954502596	0.0	0	1	0.8925852954502596	0.0
19712750958	2	1.8211962061259537	0.0	0	2	0.9105981030629768	0.0
19712750959	4	1.564747661639487	0.0	0	4	0.521582553879829	0.0
19712750963	3	1.8373110228652827	0.0	0	3	0.6124370076217609	0.0
19712750965	2	0.5562091184839696	1.0	1	1	0.5562091184839696	1.0
19712750969	1	0.7222911564429789	0.0	0	1	0.7222911564429789	0.0
19712750971	8	6.538491170065591	0.0	0	8	0.8173113962581989	0.0
19712750972	14	1.6151789371917762	7.0	7	7	0.20189736714897202	1.0
19712750973	4	0.08262124655524833	0.0	0	4	0.020655311638812082	0.0
19712750975	4	0.7168983391826507	0.0	0	4	0.17922458479566267	0.0
19712750976	2	0.5007070391837314	0.0	0	2	0.2503535195918657	0.0
19712750980	1	0.24223207214853482	0.0	0	1	0.24223207214853482	0.0
19712750981	2	0.4112097401882257	0.0	0	2	0.20560487009411285	0.0
19712750983	7	5.089595175750053	0.0	0	7	0.7270850251071505	0.0
19712750984	6	2.4134223541551343	1.0	1	5	0.6033555885387836	0.2
19712750986	2	1.7570319162056465	0.0	0	2	0.8785159581028232	0.0
19712750988	5	0.9231001834069643	0.0	0	5	0.23077504585174108	0.0
19712750989	4	2.8871408967699224	0.0	0	4	0.7217852241924806	0.0
19712750992	2	0.8649702799103467	0.0	0	2	0.43248513995517335	0.0
19712750998	6	4.137283545321635	0.0	0	6	0.6895472575536058	0.0
19712750999	2	0.8942552607577142	0.0	0	2	0.4471276303788571	0.0
19712751005	4	0.7667358560261559	2.0	2	2	0.38336792801307795	1.0
19712751006	2	1.4419749259754435	0.0	0	2	0.7209874629877218	0.0
19712751009	1	0.18430694554257912	0.0	0	1	0.18430694554257912	0.0
19712751012	2	1.3738486644907073	0.0	0	2	0.6869243322453537	0.0
19712751014	6	4.315972089064682	0.0	0	6	0.7193286815107803	0.0
19712751015	3	1.8431419791716785	0.0	0	3	0.6143806597238929	0.0
19712751017	8	3.8817413119734185	0.0	0	8	0.646956885328903	0.0
20036030882	1	0.03895097532822298	0.0	0	1	0.03895097532822298	0.0
20036030883	2	0.07796275747402823	0.0	0	2	0.038981378737014113	0.0
20619954327	6	1.8947532638800062	2.0	2	4	0.47368831597000155	0.5
20619954328	3	0.5319001285394173	0.5	1	2	0.5319001285394173	0.5
20619954329	2	0.8457896346059074	0.0	0	2	0.8457896346059074	0.0
20619954330	3	0.5482283751882999	0.5	1	2	0.5482283751882999	0.5
20619954331	4	1.151077299168566	0.5	1	3	0.575538649584283	0.3333333333333333
20619954332	11	2.2883724267411685	5.0	5	6	0.38139540445686143	0.8333333333333334
20619954333	3	1.0638872923077658	0.0	0	3	0.3546290974359219	0.0
20619954334	2	0.3546521272605212	1.0	1	1	0.3546521272605212	1.0
20619954335	5	1.8258588702046157	0.0	0	5	0.36517177404092316	0.0
20619954336	23	5.471604175765101	8.0	8	15	0.3647736117176734	0.5333333333333333
20619954337	4	0.7097560296474649	2.0	2	2	0.35487801482373244	1.0
20619954338	3	0.7096610821249942	1.0	1	2	0.3548305410624971	0.5
20619954339	2	0.3548416519427862	1.0	1	1	0.3548416519427862	1.0
20619954340	9	1.7744240464768797	4.0	4	5	0.3548848092953759	0.8
20619954341	2	0.35491612851005755	1.0	1	1	0.35491612851005755	1.0
20619954342	29	6.8967197550138435	10.0	10	19	0.3629852502638865	0.5263157894736842
20619954343	2	0.3550579100764136	1.0	1	1	0.3550579100764136	1.0
20740330425	1	0.8876281593746016	0.0	0	1	0.8876281593746016	0.0
20740330426	2	0.8876446910176984	1.0	1	1	0.8876446910176984	1.0
20740330427	1	0.88764526339638	0.0	0	1	0.88764526339638	0.0
20740330428	1	0.8876592025007427	0.0	0	1	0.8876592025007427	0.0
20740330429	1	0.8876564079460033	0.0	0	1	0.8876564079460033	0.0
20740330430	5	4.439561743784649	0.0	0	5	0.8879123487569298	0.0
20740330431	9	8.154161612198157	0.0	0	9	0.9060179569109064	0.0
20740330432	5	4.438743679971362	0.0	0	5	0.8877487359942725	0.0
20740330433	2	1.7755567838876882	0.0	0	2	0.8877783919438441	0.0
20740330434	19	16.99408598144611	0.0	0	19	0.8944255779708478	0.0
20740330435	17	15.139235996343109	0.0	0	17	0.8905432939025358	0.0
20740330436	4	3.552880568104023	0.0	0	4	0.8882201420260057	0.0
20740330437	3	2.66466154558338	0.0	0	3	0.88822051519446	0.0
20740330438	2	1.7764960236347953	0.0	0	2	0.8882480118173977	0.0
20740330439	16	14.579219886240072	0.0	0	16	0.9112012428900045	0.0
20740330440	1	0.8883257543100872	0.0	0	1	0.8883257543100872	0.0
20740330441	1	0.8883374038997237	0.0	0	1	0.8883374038997237	0.0
20740330442	1	0.8883540365508231	0.0	0	1	0.8883540365508231	0.0
20740330443	2	1.776735984979706	0.0	0	2	0.888367992489853	0.0
20740330444	10	8.924292515539323	0.0	0	10	0.8924292515539323	0.0
20740330445	3	2.6654079947228033	0.0	0	3	0.8884693315742678	0.0
20740330446	20	17.975481620466	0.0	0	20	0.8987740810232999	0.0
20740330447	1	0.8886304281153485	0.0	0	1	0.8886304281153485	0.0
20740330448	1	0.8886416400036403	0.0	0	1	0.8886416400036403	0.0
20740330449	1	0.8886616732574949	0.0	0	1	0.8886616732574949	0.0
20740330450	1	0.8886728851457867	0.0	0	1	0.8886728851457867	0.0
20740330451	5	4.443723778532951	0.0	0	5	0.8887447557065903	0.0
20740330452	3	2.666245115379253	0.0	0	3	0.8887483717930843	0.0
20740330453	2	1.7775535100836457	0.0	0	2	0.8887767550418229	0.0
20740330454	19	17.051546908941322	0.0	0	19	0.8974498373127012	0.0
20740330455	4	3.5559882139822214	0.0	0	4	0.8889970534955554	0.0
20740330456	3	2.666994864113429	0.0	0	3	0.8889982880378097	0.0
20740330457	2	1.7780472372004932	0.0	0	2	0.8890236186002466	0.0
20748601587	2	1.5407119656807131	0.0	0	2	0.7703559828403566	0.0
20748601588	8	1.920509328139547	3.0	3	5	0.3200848880232578	0.6
20748601589	8	0.8717708457033064	1.0	3	5	0.4358854228516532	0.6
20748601590	6	1.1297804688703943	0.6666666666666666	2	4	0.5648902344351971	0.5
20748601591	2	0.9306900257324621	0.0	0	2	0.9306900257324621	0.0
21211260459	4	1.0961108989756003	2.0	2	2	0.5480554494878002	1.0
21211260460	24	11.1224583314212	4.0	4	20	0.5561229165710599	0.2
21211260461	5	4.165594438660989	0.0	0	5	0.8331188877321978	0.0
21212189692	2	0.6035513336305438	0.0	0	2	0.3017756668152719	0.0
21212189693	2	1.268229208841015	0.0	0	2	0.6341146044205075	0.0
21212189694	1	0.3017818451380993	0.0	0	1	0.3017818451380993	0.0
21212189695	12	7.526467615134056	0.0	0	12	0.6272056345945046	0.0
21212189696	1	0.3018125852402326	0.0	0	1	0.3018125852402326	0.0
21212189697	1	0.3018242011605348	0.0	0	1	0.3018242011605348	0.0
21212189698	2	0.7643959046372673	0.0	0	2	0.3821979523186336	0.0
21212189699	1	0.30187558056453845	0.0	0	1	0.30187558056453845	0.0
21212189700	3	1.224042551035219	0.0	0	3	0.40801418367840636	0.0
21212189701	2	0.7641923735119711	0.0	0	2	0.38209618675598556	0.0
21212189702	2	0.6038409235740794	0.0	0	2	0.3019204617870397	0.0
21212189703	2	1.2841177003157882	0.0	0	2	0.6420588501578941	0.0
21212189704	11	1.8140824145168433	5.0	5	6	0.30234706908614056	0.8333333333333334
21212189705	1	0.3020537586811749	0.0	0	1	0.3020537586811749	0.0
21212189706	2	0.6763735918348094	0.0	0	2	0.6763735918348094	0.0
21212189707	2	0.6763859821497984	0.0	0	2	0.6763859821497984	0.0
21212189708	1	0.3020951382929183	0.0	0	1	0.3020951382929183	0.0
21212189709	2	0.676431402081647	0.0	0	2	0.676431402081647	0.0
21212189710	2	0.6764426813086072	0.0	0	2	0.6764426813086072	0.0
21212189711	4	0.6043871411829593	2.0	2	2	0.30219357059147967	1.0
21212189712	4	1.0604983054729131	0.0	0	4	0.5302491527364566	0.0
21212189713	44	11.975250918187996	10.0	10	34	0.37422659119337487	0.29411764705882354
21212189714	29	8.115952843673245	5.0	5	24	0.352867514942315	0.20833333333333334
21212189715	23	6.806882833444167	3.0	3	20	0.35825699123390353	0.15
21212189716	2	0.6777903974183432	0.0	0	2	0.6777903974183432	0.0
21212189717	2	0.6778016093066349	0.0	0	2	0.6778016093066349	0.0
21212189718	5	2.4017529669501476	0.0	0	5	0.6004382417375369	0.0
21212189719	2	0.6778323494087681	0.0	0	2	0.6778323494087681	0.0
21212189720	2	0.6778435612970599	0.0	0	2	0.6778435612970599	0.0
21212189721	3	1.051409235033737	0.0	0	3	0.5257046175168685	0.0
21212189722	2	0.6076682178016706	0.0	0	2	0.3038341089008353	0.0
21212189723	2	0.6779113039974893	0.0	0	2	0.6779113039974893	0.0
21212189724	2	0.6779195529843707	0.0	0	2	0.6779195529843707	0.0
21212189725	3	1.5708638308759713	0.0	0	3	0.7854319154379856	0.0
21212189726	2	0.6779423807929646	0.0	0	2	0.6779423807929646	0.0
21212189727	4	1.3559287337364068	0.0	0	4	0.6779643668682034	0.0
21212189728	2	0.6779656463029035	0.0	0	2	0.6779656463029035	0.0
21212189729	3	0.9817599075467018	0.0	0	3	0.4908799537733509	0.0
21212189730	1	0.30379079330237485	0.0	0	1	0.30379079330237485	0.0
21212189731	2	0.6771590974019159	0.0	0	2	0.33857954870095797	0.0
21212189732	1	0.30382641545796846	0.0	0	1	0.30382641545796846	0.0
21212189733	4	1.3560784949349705	0.0	0	4	0.6780392474674852	0.0
21212189734	2	0.6780550383852295	0.0	0	2	0.6780550383852295	0.0
21212189735	6	2.8845488967451423	0.0	0	6	0.7211372241862856	0.0
21212189736	5	1.9823953825605711	0.0	0	5	0.6607984608535237	0.0
21212189737	3	0.9820000709076179	0.0	0	3	0.49100003545380894	0.0
21212189738	4	1.3562616224437356	0.0	0	4	0.6781308112218678	0.0
21212189739	2	0.678131467773885	0.0	0	2	0.678131467773885	0.0
21212189740	3	1.6449070064773401	0.0	0	3	0.8224535032386701	0.0
21212189741	2	0.6781911635034383	0.0	0	2	0.6781911635034383	0.0
21212189742	8	4.014621312412466	0.0	0	8	0.5735173303446379	0.0
21212189743	2	0.6782143953440428	0.0	0	2	0.6782143953440428	0.0
21212189744	5	2.096338200650848	1.0	1	4	0.6987794002169494	0.25
21212189745	2	0.6782514652810074	0.0	0	2	0.6782514652810074	0.0
21212189746	3	1.0675114931114056	0.0	0	3	0.5337557465557028	0.0
21212189747	5	1.6805710803920335	0.0	0	5	0.5601903601306778	0.0
21212189748	3	0.982432991206883	0.0	0	3	0.4912164956034415	0.0
21212189749	2	0.6082892823404982	0.0	0	2	0.3041446411702491	0.0
21212189750	2	0.6783596448518224	0.0	0	2	0.6783596448518224	0.0
21212189751	5	2.078595404263824	0.0	0	5	0.6928651347546081	0.0
21212189752	4	1.356937938360001	0.0	0	4	0.6784689691800005	0.0
21212189753	6	0.9923843669644978	1.0	2	4	0.33079478898816594	0.5
21212189754	4	1.3569714730168738	0.0	0	4	0.6784857365084369	0.0
21212189755	2	0.6785063084716388	0.0	0	2	0.6785063084716388	0.0
21212189756	4	1.3572718708166904	0.0	0	4	0.6786359354083452	0.0
21212189757	3	0.9829958414668625	0.0	0	3	0.49149792073343124	0.0
21212189758	4	1.357125005180869	0.0	0	4	0.6785625025904345	0.0
21212189759	2	0.6785637820251343	0.0	0	2	0.6785637820251343	0.0
21212189760	2	0.678585094713689	0.0	0	2	0.678585094713689	0.0
21212189761	2	1.1841326393993767	0.0	0	2	0.5920663196996884	0.0
21212189762	4	1.255845526710775	0.0	0	4	0.3139613816776938	0.0
21212189763	4	2.3097019499628577	0.0	0	4	0.7699006499876192	0.0
21212189764	2	0.6786356997230057	0.0	0	2	0.6786356997230057	0.0
21212189765	5	2.2337077037827195	0.0	0	5	0.7445692345942398	0.0
21212189766	1	0.3045383198604931	0.0	0	1	0.3045383198604931	0.0
21212189767	2	0.6091002755936012	0.0	0	2	0.3045501377968006	0.0
21212189768	3	0.9832895390691715	0.0	0	3	0.49164476953458575	0.0
21212189769	4	1.3573724747873084	0.0	0	4	0.6786862373936542	0.0
21212189770	6	2.8139202630032907	0.0	0	6	0.7034800657508227	0.0
21212189771	3	1.0019004992387868	0.0	0	3	0.5009502496193934	0.0
21212189772	1	0.3046948822645671	0.0	0	1	0.3046948822645671	0.0
21212189773	2	0.6788106119142239	0.0	0	2	0.6788106119142239	0.0
21212189774	2	0.6788222278345262	0.0	0	2	0.6788222278345262	0.0
21212189775	2	0.6094855874542944	0.0	0	2	0.3047427937271472	0.0
21212189776	2	0.6788641461556169	0.0	0	2	0.6788641461556169	0.0
21212189777	1	0.3047881799896615	0.0	0	1	0.3047881799896615	0.0
21212189778	3	1.2420334904153676	0.0	0	3	0.6210167452076838	0.0
21212189779	3	0.9837553206386251	0.0	0	3	0.49187766031931257	0.0
21212189780	2	0.6789196332183941	0.0	0	2	0.6789196332183941	0.0
21212189781	2	0.6789404071976013	0.0	0	2	0.6789404071976013	0.0
21212189782	2	0.6789533025526036	0.0	0	2	0.6789533025526036	0.0
21212189783	4	1.2202937400256701	0.0	0	4	0.30507343500641754	0.0
21212189784	3	0.9672756293244682	1.0	1	2	0.4836378146622341	0.5
21212189785	3	0.7710378205274322	1.0	1	2	0.3855189102637161	0.5
21212189786	3	0.610290890589916	1.0	1	2	0.305145445294958	0.5
21212189787	1	0.30515706121526026	0.0	0	1	0.30515706121526026	0.0
21212189788	3	1.5467097198687827	0.0	0	3	0.5155699066229276	0.0
21212189789	5	1.5266901694331805	0.0	0	5	0.3053380338866361	0.0
21212189790	2	0.6106526002473283	0.0	0	2	0.30532630012366413	0.0
21212189791	5	1.2215454985329093	1.0	1	4	0.3053863746332273	0.25
21212189792	3	1.13342231240516	0.0	0	3	0.37780743746838663	0.0
21212189793	2	0.308487867440599	1.0	1	1	0.308487867440599	1.0
21212189794	1	0.3084990793288907	0.0	0	1	0.3084990793288907	0.0
21212189795	2	0.3085136918199376	1.0	1	1	0.3085136918199376	1.0
21212189796	1	0.3085249037082294	0.0	0	1	0.3085249037082294	0.0
21212189797	2	0.6751910238093707	0.0	0	2	0.33759551190468534	0.0
21212189798	39	13.514280629254266	6.0	8	31	0.5197800242020871	0.25806451612903225
21212189799	2	0.308727391084165	1.0	1	1	0.308727391084165	1.0
21212189800	2	0.30873860297245675	1.0	1	1	0.30873860297245675	1.0
21212189801	5	0.7063209494940795	1.5	2	3	0.35316047474703977	0.6666666666666666
21212189802	2	0.3087802519388739	1.0	1	1	0.3087802519388739	1.0
21212189803	2	0.3087919015285103	1.0	1	1	0.3087919015285103	1.0
21212189804	11	2.0226037391748464	5.0	5	6	0.33710062319580775	0.8333333333333334
21212189805	3	0.6177114435030087	1.0	1	2	0.30885572175150433	0.5
21212189806	3	0.6177209045859215	1.0	1	2	0.3088604522929608	0.5
21212189807	23	4.677668447089837	8.0	8	15	0.31184456313932246	0.5333333333333333
21212189808	2	0.30897758790667545	1.0	1	1	0.30897758790667545	1.0
21212189809	9	2.375765358679249	2.0	2	7	0.3393950512398927	0.2857142857142857
21212189810	10	1.7148454188678977	5.0	5	5	0.34296908377357954	1.0
21212189811	3	0.6181679660055547	1.0	1	2	0.30908398300277734	0.5
21212189812	27	5.692847391015481	9.0	9	18	0.31626929950086	0.5
21212189813	4	1.0544734811401393	1.0	1	3	0.3514911603800464	0.3333333333333333
21212189814	1	0.3091840145947136	0.0	0	1	0.3091840145947136	0.0
21212189815	5	1.2369836289932967	1.0	1	4	0.3092459072483242	0.25
21212189816	9	1.5463311418749313	4.0	4	5	0.30926622837498624	0.8
21212189817	3	0.6185922669552623	1.0	1	2	0.30929613347763113	0.5
21212189818	31	6.708742111317082	10.0	10	21	0.3194639100627182	0.47619047619047616
21212189819	9	1.5471827066757569	4.0	4	5	0.30943654133515136	0.8
21212189820	3	0.9283028025983434	0.0	0	3	0.30943426753278114	0.0
21212189821	9	1.7177900041605199	4.0	4	5	0.34355800083210397	0.8
21212189822	3	0.9287878766962989	0.0	0	3	0.3095959588987663	0.0
21212189823	17	4.27989866338467	4.0	4	13	0.3292229741065131	0.3076923076923077
21212189824	17	3.4911838026799242	6.0	6	11	0.3173803456981749	0.5454545454545454
21212189825	10	1.8726283699762873	4.0	4	6	0.31210472832938124	0.6666666666666666
21212189826	5	0.98047781296934	2.0	2	3	0.3268259376564467	0.6666666666666666
21212189827	1	0.3099097570935984	0.0	0	1	0.3099097570935984	0.0
21212189828	7	2.873441484397445	2.0	2	5	0.574688296879489	0.4
21212189829	3	0.3237583582859575	0.5	1	2	0.3237583582859575	0.5
21212189830	4	1.5211543248411303	0.0	0	4	0.7605771624205652	0.0
21212189831	1	0.309972213708557	0.0	0	1	0.309972213708557	0.0
21212189832	2	1.2200150926157527	0.0	0	2	0.6100075463078763	0.0
21212189833	5	1.5503183654400177	0.0	0	5	0.31006367308800353	0.0
21212189834	3	1.1554893623927072	0.0	0	3	0.38516312079756904	0.0
21212189835	2	0.3100884065809138	1.0	1	1	0.3100884065809138	1.0
21212189836	14	5.014147180848129	2.0	2	12	0.41784559840401075	0.16666666666666666
21212189837	27	7.143054570213136	4.0	4	23	0.31056759000926676	0.17391304347826086
21212189838	14	7.0531436434468695	2.0	2	12	0.5877619702872391	0.16666666666666666
21212189839	18	4.65569129422463	3.0	3	15	0.3103794196149753	0.2
21212189840	2	0.3102690425589475	1.0	1	1	0.3102690425589475	1.0
21212189841	5	1.552997771056406	0.0	0	5	0.3105995542112812	0.0
21212189842	3	0.9328194427745389	0.0	0	3	0.3109398142581796	0.0
21212189843	2	0.7372575795310919	0.0	0	2	0.7372575795310919	0.0
21212189844	6	2.0579248572512823	0.5	1	5	0.685974952417094	0.2
21212189845	3	0.4267054788794455	0.5	1	2	0.4267054788794455	0.5
21212189846	1	0.31158322401181093	0.0	0	1	0.31158322401181093	0.0
21212189847	2	0.3115849411478556	1.0	1	1	0.3115849411478556	1.0
21212189848	2	0.8704909396326681	0.0	0	2	0.43524546981633405	0.0
21212189849	4	1.285846048248762	1.0	1	3	0.642923024124381	0.3333333333333333
21212189850	1	0.3116106645191916	0.0	0	1	0.3116106645191916	0.0
21212189851	4	1.2467131575078054	0.0	0	4	0.31167828937695136	0.0
21212189852	2	0.6233443231162504	0.0	0	2	0.3116721615581252	0.0
21212189853	5	1.379708677432526	0.5	1	4	0.689854338716263	0.25
21212189854	13	6.860400442186099	1.0	1	12	0.5717000368488415	0.08333333333333333
21212189855	6	3.645039394299452	0.0	0	6	0.6075065657165754	0.0
21212189856	17	3.432500139643564	6.0	6	11	0.312045467240324	0.5454545454545454
21212189857	6	1.7624526116747004	2.0	2	4	0.4406131529186751	0.5
21212189858	24	10.092070747217134	5.0	5	19	0.531161618274586	0.2631578947368421
21212189859	4	2.2239624180198008	1.0	1	3	0.7413208060066002	0.3333333333333333
21212189860	2	0.31204806283990666	1.0	1	1	0.31204806283990666	1.0
21212189861	8	1.5604504781836686	3.0	3	5	0.31209009563673373	0.6
21212189862	1	0.3120709579871691	0.0	0	1	0.3120709579871691	0.0
21212189863	3	0.6242330925313774	1.0	1	2	0.3121165462656887	0.5
21212189864	3	1.0116905315468698	0.0	0	3	0.5058452657734349	0.0
21212189865	35	14.285976079217479	7.0	7	28	0.5291102251562029	0.25
21212189866	6	2.1200060928027185	2.0	2	4	0.5300015232006796	0.5
21212189867	2	0.31232502678311364	1.0	1	1	0.31232502678311364	1.0
21212189868	3	1.0120413323399982	1.0	1	2	0.5060206661699991	0.5
21212189869	11	2.043979557731073	5.0	5	6	0.3406632596218455	0.8333333333333334
21212189870	5	1.133502748444586	0.5	1	4	0.566751374222293	0.25
21212189871	4	0.6247962458153647	2.0	2	2	0.3123981229076824	1.0
21212189872	40	12.025829901109462	10.0	10	30	0.4008609967036488	0.3333333333333333
21212189873	11	2.0847609664135933	1.5	3	8	0.41695219328271865	0.375
21212189874	6	2.0264698204754468	2.0	2	4	0.5066174551188617	0.5
21212189875	43	21.856049084771538	2.0	4	39	0.6428249730815159	0.10256410256410256
21212189876	23	14.48986369542424	2.0	2	21	0.724493184771212	0.09523809523809523
21212189877	39	12.308835873678989	9.0	9	30	0.410294529122633	0.3
21212189878	9	2.412381433018715	1.0	2	7	0.482476286603743	0.2857142857142857
21212189879	5	2.0441027201556117	1.0	1	4	0.5110256800389029	0.25
21212189880	43	26.778132454285384	4.0	4	39	0.7046876961654048	0.10256410256410256
21212189881	20	11.58469963772133	2.5	3	17	0.7240437273575832	0.17647058823529413
21212189882	19	5.033425669237781	2.0	4	15	0.5033425669237781	0.26666666666666666
21212189883	4	1.2521559063907661	0.0	0	4	0.31303897659769153	0.0
21212189884	2	0.6260674988671111	0.0	0	2	0.31303374943355555	0.0
21212189885	8	3.4967196472719744	1.0	1	7	0.4995313781817106	0.14285714285714285
21212189886	1	0.31310632368344404	0.0	0	1	0.31310632368344404	0.0
21212189887	12	8.080632331644829	0.0	0	12	0.673386027637069	0.0
21212189888	8	1.014657001906728	2.0	4	4	0.507328500953364	1.0
21212189889	10	3.335961370768829	2.0	2	8	0.47656591010983274	0.25
21212189890	3	1.195450451416548	1.0	1	2	0.597725225708274	0.5
21212189891	8	1.5669474475900618	3.0	3	5	0.3133894895180124	0.6
21212189892	4	1.9988094860116878	0.0	0	4	0.6662698286705626	0.0
21212189893	4	0.6893636250048274	0.5	1	3	0.3446818125024137	0.3333333333333333
21212189894	1	0.3136375584386008	0.0	0	1	0.3136375584386008	0.0
21212189895	2	0.7169012347453927	0.0	0	2	0.7169012347453927	0.0
21212189896	3	1.6061386536178692	0.0	0	3	0.8030693268089346	0.0
21212189897	3	0.3647489208725866	0.5	1	2	0.3647489208725866	0.5
21212189898	8	2.1971840180963245	1.0	1	7	0.31388343115661776	0.14285714285714285
21212189899	2	0.6275474007829535	0.0	0	2	0.31377370039147673	0.0
21212189900	13	4.102249862351344	0.0	0	13	0.3155576817193341	0.0
21212189901	24	5.997892737379831	5.0	5	19	0.3156785651252543	0.2631578947368421
21212189902	7	3.863934745867401	1.0	1	6	0.6439891243112336	0.16666666666666666
21212189903	7	2.296694307731048	2.0	2	5	0.4593388615462096	0.4
21212189904	8	6.91617857635752	0.0	0	8	0.86452232204469	0.0
21212189905	7	6.129939051434521	0.0	0	7	0.8757055787763601	0.0
21212189906	4	1.25022493640452	0.5	1	3	0.62511246820226	0.3333333333333333
21212189907	2	0.8968310995020743	0.0	0	2	0.8968310995020743	0.0
21212189908	4	1.2121241454344198	1.0	1	3	0.6060620727172099	0.3333333333333333
21212189909	5	1.2650274908430355	1.0	1	4	0.31625687271075886	0.25
21212189910	6	4.311442856557491	0.0	0	6	0.7185738094262485	0.0
21212189911	1	0.3172947551897659	0.0	0	1	0.3172947551897659	0.0
21212189912	4	1.147518147518619	1.0	1	3	0.5737590737593095	0.3333333333333333
21212189913	2	0.317582661666591	1.0	1	1	0.317582661666591	1.0
21212189914	1	0.31759050662146177	0.0	0	1	0.31759050662146177	0.0
21212189915	2	0.3176044793951587	1.0	1	1	0.3176044793951587	1.0
21212189916	2	0.7749393893062895	0.0	0	2	0.38746969465314474	0.0
21212189917	1	0.3179154830352514	0.0	0	1	0.3179154830352514	0.0
21212189918	5	0.49417781455516563	0.6666666666666666	2	3	0.49417781455516563	0.6666666666666666
21212189919	5	0.9767338840132513	1.0	2	3	0.48836694200662567	0.6666666666666666
21212189920	2	0.673832769198027	0.0	0	2	0.3369163845990135	0.0
21212189921	1	0.31813063008084985	0.0	0	1	0.31813063008084985	0.0
21212189922	1	0.3181418419691416	0.0	0	1	0.3181418419691416	0.0
21212189923	4	1.2728674963217095	0.0	0	4	0.31821687408042737	0.0
21212189924	2	0.6364162401070658	0.0	0	2	0.3182081200535329	0.0
21212189925	35	22.24687359188531	6.0	6	29	0.7671335721339763	0.20689655172413793
21212189926	29	9.633580777126618	5.0	5	24	0.4013991990469424	0.20833333333333334
21212189927	10	2.547138162146598	2.0	2	8	0.31839227026832473	0.25
21212189928	5	1.501606347100466	2.0	2	3	0.5005354490334887	0.6666666666666666
21212189929	11	4.142605960004131	1.0	1	10	0.4142605960004131	0.1
21212189930	9	3.8731430394190123	0.0	0	9	0.48414287992737653	0.0
21212189931	4	1.2765720658261075	0.0	0	4	0.3191430164565269	0.0
21212189932	14	3.516632869950143	3.0	3	11	0.3516632869950143	0.2727272727272727
21212189933	9	2.426591743868486	2.5	3	6	0.48531834877369723	0.5
21212189934	11	2.5979288915109073	5.0	5	6	0.4329881485851512	0.8333333333333334
21212189935	4	2.6090473137308896	0.0	0	4	0.6522618284327224	0.0
21212189936	1	0.3197438288908274	0.0	0	1	0.3197438288908274	0.0
21212189937	8	5.121752992538842	1.0	1	7	0.7316789989341203	0.14285714285714285
21212189938	2	0.7581146209858198	0.0	0	2	0.3790573104929099	0.0
21212189939	5	1.1099928328088269	2.0	2	3	0.36999761093627564	0.6666666666666666
21212189940	14	2.80065498302611	2.5	4	10	0.4667758305043517	0.4
21212189941	2	0.3198298540397326	1.0	1	1	0.3198298540397326	1.0
21212189942	13	2.1133646482832322	5.0	6	7	0.3522274413805387	0.8571428571428571
21212189943	3	0.9580795914105084	0.0	0	3	0.4790397957052542	0.0
21212189944	2	0.31991490277794565	1.0	1	1	0.31991490277794565	1.0
21212189945	38	8.384385852994232	7.0	10	28	0.4657992140552351	0.35714285714285715
21212189946	3	0.5084374846488879	0.5	1	2	0.5084374846488879	0.5
21212189947	4	0.6403753161087529	2.0	2	2	0.32018765805437643	1.0
21212189948	5	0.9606150942924856	2.0	2	3	0.3202050314308285	0.6666666666666666
21212189949	5	1.5971566516614788	0.0	0	5	0.5323855505538263	0.0
21212189950	37	6.544903865128458	8.0	13	24	0.40905649157052865	0.5416666666666666
21212189951	3	0.7719235597024803	0.5	1	2	0.7719235597024803	0.5
21212189952	3	0.48995716149600527	0.5	1	2	0.48995716149600527	0.5
21212189953	1	0.32036226722158667	0.0	0	1	0.32036226722158667	0.0
21212189954	10	1.764400214312046	5.0	5	5	0.3528800428624092	1.0
21212189955	4	1.2795975248595006	0.0	0	4	0.4265325082865002	0.0
21212189956	4	0.640980084689823	2.0	2	2	0.3204900423449115	1.0
21212189957	37	8.696489806928927	5.5	8	29	0.4348244903464463	0.27586206896551724
21212189958	2	0.3206134741241234	1.0	1	1	0.3206134741241234	1.0
21212189959	6	1.3815992442177212	2.0	2	4	0.3453998110544303	0.5
21212189960	5	0.962073616181105	2.0	2	3	0.32069120539370166	0.6666666666666666
21212189961	5	1.598418847662323	0.0	0	5	0.5328062825541077	0.0
21212189962	2	0.32070805128391777	1.0	1	1	0.32070805128391777	1.0
21212189963	36	7.577632646486772	6.0	9	27	0.42097959147148734	0.3333333333333333
21212189964	2	0.320817072588088	1.0	1	1	0.320817072588088	1.0
21212189965	1	0.3208375772126215	0.0	0	1	0.3208375772126215	0.0
21212189966	2	0.32084293063676084	1.0	1	1	0.32084293063676084	1.0
21212189967	10	1.766711277412183	5.0	5	5	0.3533422554824366	1.0
21212189968	4	1.2809321772675633	0.0	0	4	0.4269773924225211	0.0
21212189969	8	4.831988406166781	1.0	1	7	0.6902840580238259	0.14285714285714285
21212189970	30	5.683281596473233	4.5	9	21	0.4371755074210179	0.42857142857142855
21212189971	1	0.3210769661788508	0.0	0	1	0.3210769661788508	0.0
21212189972	4	1.415823078692271	0.5	1	3	0.7079115393461355	0.3333333333333333
21212189973	1	0.32108231960299005	0.0	0	1	0.32108231960299005	0.0
21212189974	3	0.6421785446410087	1.0	1	2	0.3210892723205043	0.5
21212189975	1	0.3210887504458241	0.0	0	1	0.3210887504458241	0.0
21212189976	27	6.0943380401828025	3.0	6	21	0.5540307309257093	0.2857142857142857
21212189977	4	1.2816199070881256	0.0	0	4	0.42720663569604184	0.0
21212189978	5	1.1818176706564714	2.0	2	3	0.3939392235521571	0.6666666666666666
21212189979	14	3.5473158688925546	3.0	3	11	0.32248326080841405	0.2727272727272727
21212189980	2	0.32133275211084	1.0	1	1	0.32133275211084	1.0
21212189981	3	0.6426967830331606	1.0	1	2	0.3213483915165803	0.5
21212189982	14	4.872649682664841	4.0	4	10	0.48726496826648413	0.4
21212189983	2	0.6429879554354039	0.0	0	2	0.32149397771770194	0.0
21212189984	30	8.722234995993519	3.0	3	27	0.3230457405923526	0.1111111111111111
21212189985	3	1.2408383300589345	0.0	0	3	0.4136127766863115	0.0
21212189986	3	0.8764474825556654	1.0	1	2	0.4382237412778327	0.5
21212189987	3	1.6410297806271164	0.0	0	3	0.5470099268757055	0.0
21212189988	2	0.6453728890547964	0.0	0	2	0.3226864445273982	0.0
21212189989	2	0.6429500774344183	0.0	0	2	0.32147503871720917	0.0
21212189990	1	0.32148719334685877	0.0	0	1	0.32148719334685877	0.0
21212189991	2	0.6429934772062142	0.0	0	2	0.3214967386031071	0.0
21212189992	1	0.32150631752868974	0.0	0	1	0.32150631752868974	0.0
21212189993	2	0.6450092265760001	0.0	0	2	0.32250461328800006	0.0
21212189994	3	1.5647599172771394	0.0	0	3	0.5215866390923798	0.0
21212189995	3	0.6431614871839195	1.0	1	2	0.32158074359195976	0.5
21212189996	27	6.495608256219053	7.0	7	20	0.32478041281095266	0.35
21212189997	28	6.826683230183401	7.0	7	21	0.3250801538182572	0.3333333333333333
21212189998	17	4.551378915798281	3.0	3	14	0.32509849398559154	0.21428571428571427
21212189999	24	5.866712095577003	6.0	6	18	0.3259284497542779	0.3333333333333333
21212190000	13	2.9259332895340187	4.0	4	9	0.3251036988371132	0.4444444444444444
21212190001	24	6.182815831738445	5.0	5	19	0.3254113595651813	0.2631578947368421
21212190002	20	4.895652571796742	5.0	5	15	0.3263768381197828	0.3333333333333333
21212190003	3	0.9746864181306402	0.0	0	3	0.3248954727102134	0.0
21212190004	2	1.3052387093507183	0.0	0	2	0.6526193546753591	0.0
21212190005	2	1.0211446785768794	0.0	0	2	0.5105723392884397	0.0
21212190006	2	0.7850157119631556	0.0	0	2	0.3925078559815778	0.0
21212190007	2	1.1382019437508655	0.0	0	2	0.5691009718754327	0.0
21212190008	4	2.359421119096617	0.0	0	4	0.5898552797741542	0.0
21212190009	3	0.812557193677155	1.0	1	2	0.4062785968385775	0.5
21212190010	1	0.3230356796964858	0.0	0	1	0.3230356796964858	0.0
21212190011	1	0.3231027153408968	0.0	0	1	0.3231027153408968	0.0
21212190012	4	2.2776413028725973	0.0	0	4	0.5694103257181493	0.0
21212190013	1	0.3231439939446376	0.0	0	1	0.3231439939446376	0.0
21212190014	2	0.6463852922651405	0.0	0	2	0.32319264613257026	0.0
21212190015	1	0.3232159789811774	0.0	0	1	0.3232159789811774	0.0
21212190016	3	1.4930131249461922	0.0	0	3	0.4976710416487307	0.0
21212190017	1	0.32326197129170753	0.0	0	1	0.32326197129170753	0.0
21212190018	1	0.32327358721200977	0.0	0	1	0.32327358721200977	0.0
21212190019	2	0.6465687227979136	0.0	0	2	0.3232843613989568	0.0
21212190020	8	3.5504440530646217	2.0	2	6	0.5917406755107703	0.3333333333333333
21212190021	1	0.32331163355966647	0.0	0	1	0.32331163355966647	0.0
21212190022	1	0.3233225760932845	0.0	0	1	0.3233225760932845	0.0
21212190023	4	2.578789524810208	0.0	0	4	0.644697381202552	0.0
21212190024	1	0.32335200309138357	0.0	0	1	0.32335200309138357	0.0
21212190025	1	0.32337321477193554	0.0	0	1	0.32337321477193554	0.0
21212190026	1	0.32338725488430087	0.0	0	1	0.32338725488430087	0.0
21212190027	1	0.3233950998391717	0.0	0	1	0.3233950998391717	0.0
21212190028	1	0.3234063117274634	0.0	0	1	0.3234063117274634	0.0
21212190029	3	1.627639284396011	0.0	0	3	0.5425464281320037	0.0
21212190030	1	0.32346338124894847	0.0	0	1	0.32346338124894847	0.0
21212190031	1	0.32348570401752935	0.0	0	1	0.32348570401752935	0.0
21212190032	3	1.5747288347578774	0.0	0	3	0.5249096115859592	0.0
21212190033	2	0.760034446422443	0.0	0	2	0.3800172232112215	0.0
21212190034	1	0.3235419318056591	0.0	0	1	0.3235419318056591	0.0
21212190035	1	0.32359078600959706	0.0	0	1	0.32359078600959706	0.0
21212190036	7	5.098977203066186	0.0	0	7	0.7284253147237408	0.0
21212190037	5	3.728441264368347	0.0	0	5	0.7456882528736694	0.0
21212190038	2	0.647299212672922	0.0	0	2	0.323649606336461	0.0
21212190039	3	2.0061264047140837	0.0	0	3	0.6687088015713613	0.0
21212190040	6	3.7162912810868542	0.0	0	6	0.6193818801811424	0.0
21212190041	7	5.353226163618082	0.0	0	7	0.7647465948025831	0.0
21212190042	2	0.6475811596775919	0.0	0	2	0.32379057983879594	0.0
21212190043	2	0.6475504532447929	0.0	0	2	0.32377522662239644	0.0
21212190044	2	1.1385212973858423	0.0	0	2	0.5692606486929211	0.0
21212190045	3	2.1364045736827624	0.0	0	3	0.7121348578942541	0.0
21212190046	2	1.286046515464645	0.0	0	2	0.6430232577323225	0.0
21212190047	1	0.32384852476297044	0.0	0	1	0.32384852476297044	0.0
21212190048	4	2.134472492608487	0.0	0	4	0.5336181231521218	0.0
21212190049	2	0.6477734789145964	0.0	0	2	0.3238867394572982	0.0
21212190050	2	1.214455814167093	0.0	0	2	0.6072279070835465	0.0
21212190051	6	4.849864634125278	0.0	0	6	0.808310772354213	0.0
21212190052	1	0.32396579505402195	0.0	0	1	0.32396579505402195	0.0
21212190053	2	0.6480068747393362	0.0	0	2	0.3240034373696681	0.0
21212190054	1	0.32401818453805187	0.0	0	1	0.32401818453805187	0.0
21212190055	2	0.6480620924474397	0.0	0	2	0.32403104622371987	0.0
21212190056	2	0.6480988593603965	0.0	0	2	0.32404942968019823	0.0
21212190057	1	0.32406444620325564	0.0	0	1	0.32406444620325564	0.0
21212190058	6	3.970583944434555	0.0	0	6	0.794116788886911	0.0
21212190059	13	5.072629972636594	1.5	3	10	0.7246614246623706	0.3
21212190060	2	1.1392368717457957	0.0	0	2	0.5696184358728978	0.0
21212190061	1	0.3241290913249378	0.0	0	1	0.3241290913249378	0.0
21212190062	2	0.6485114097124649	0.0	0	2	0.32425570485623245	0.0
21212190063	28	7.939594419873499	4.0	4	24	0.3308164341613958	0.16666666666666666
21212190064	11	3.585210670875962	0.0	0	11	0.32592824280690563	0.0
21212190065	3	0.3286260349406209	0.5	1	2	0.3286260349406209	0.5
21212190066	4	1.9367306409829803	0.0	0	4	0.6455768803276601	0.0
21212190067	4	1.2982100338184894	0.0	0	4	0.32455250845462236	0.0
21212190068	2	0.6491035859625407	0.0	0	2	0.32455179298127035	0.0
21212190069	1	0.3245754456885525	0.0	0	1	0.3245754456885525	0.0
21212190070	3	0.975078766882183	0.0	0	3	0.32502625562739434	0.0
21212190071	2	0.32477587923510143	1.0	1	1	0.32477587923510143	1.0
21212190072	4	1.2993620974271343	0.0	0	4	0.32484052435678357	0.0
21212190073	1	0.32483348746593377	0.0	0	1	0.32483348746593377	0.0
21212190074	5	3.5635203470688843	0.0	0	5	0.7127040694137768	0.0
21212190075	1	0.32503173250575906	0.0	0	1	0.32503173250575906	0.0
21212190076	1	0.3250411935886719	0.0	0	1	0.3250411935886719	0.0
21212190077	3	1.8424697035755182	0.0	0	3	0.9212348517877591	0.0
21212190078	1	0.32504563794078756	0.0	0	1	0.32504563794078756	0.0
21212190079	6	1.247638525489218	1.0	2	4	0.623819262744609	0.5
21212190080	2	0.32507240506148405	1.0	1	1	0.32507240506148405	1.0
21212190081	3	0.8203884114596003	1.0	1	2	0.41019420572980014	0.5
21212190082	4	1.3006178962544783	0.0	0	4	0.3251544740636196	0.0
21212190083	2	0.6502965914815844	0.0	0	2	0.3251482957407922	0.0
21212190084	1	0.32517775640822544	0.0	0	1	0.32517775640822544	0.0
21212190085	4	1.3015798628021769	0.0	0	4	0.3253949657005442	0.0
21212190086	1	0.3253876847070214	0.0	0	1	0.3253876847070214	0.0
21212190087	29	7.82572476524646	5.0	5	24	0.3260718652186025	0.20833333333333334
21212190088	1	0.32563040693733736	0.0	0	1	0.32563040693733736	0.0
21212190089	2	0.3256382518922082	1.0	1	1	0.3256382518922082	1.0
21212190090	1	0.32565821780739435	0.0	0	1	0.32565821780739435	0.0
21212190091	1	0.3256616184101495	0.0	0	1	0.3256616184101495	0.0
21212190092	4	1.302896098084427	0.0	0	4	0.32572402452110677	0.0
21212190093	2	0.6514394633619901	0.0	0	2	0.32571973168099505	0.0
21212190094	1	0.32579336651491114	0.0	0	1	0.32579336651491114	0.0
21212190095	5	1.6301585923282333	0.0	0	5	0.32603171846564666	0.0
21212190096	2	0.6520482722631654	0.0	0	2	0.3260241361315827	0.0
21212190097	2	0.6521986395097449	0.0	0	2	0.32609931975487244	0.0
21212190098	5	2.180773146901292	0.0	0	5	0.4361546293802584	0.0
21212190099	2	0.6525281276143186	0.0	0	2	0.3262640638071593	0.0
21212190100	2	0.9352747789717635	0.0	0	2	0.9352747789717635	0.0
21212190101	3	0.6717634182481799	0.5	1	2	0.6717634182481799	0.5
21212190102	23	6.618892058707065	4.0	6	17	0.5091455429774665	0.35294117647058826
21212190103	1	0.32654025335567943	0.0	0	1	0.32654025335567943	0.0
21212190104	6	2.6981550585295926	0.0	0	6	0.4496925097549321	0.0
21212190105	29	8.644694856002488	4.0	4	25	0.34578779424009953	0.16
21212190106	1	0.32686721626018744	0.0	0	1	0.32686721626018744	0.0
21212190107	4	1.3082238325217284	0.0	0	4	0.3270559581304321	0.0
21212190108	2	0.6540998794738844	0.0	0	2	0.3270499397369422	0.0
21212190109	4	1.3091600083594221	0.0	0	4	0.32729000208985554	0.0
21212190110	22	4.9515629591129375	7.0	7	15	0.3301041972741958	0.4666666666666667
21212190111	22	8.809031273660073	2.0	2	20	0.44045156368300364	0.1
21212190112	2	0.32747269189727607	1.0	1	1	0.32747269189727607	1.0
21212190113	6	1.8961934023121472	1.0	1	5	0.3792386804624294	0.2
21212190114	2	0.3276013087539562	1.0	1	1	0.3276013087539562	1.0
21212190115	2	0.3276685800837067	1.0	1	1	0.3276685800837067	1.0
21212190116	2	0.32772076755173135	1.0	1	1	0.32772076755173135	1.0
21212190117	2	0.3278963194602994	1.0	1	1	0.3278963194602994	1.0
21212190118	2	0.3279364196373429	1.0	1	1	0.3279364196373429	1.0
21212190119	2	0.3280055091111407	1.0	1	1	0.3280055091111407	1.0
21212190120	2	0.32805628246712853	1.0	1	1	0.32805628246712853	1.0
21212190121	2	0.3281683340113776	1.0	1	1	0.3281683340113776	1.0
21212190122	2	0.32823011723965195	1.0	1	1	0.32823011723965195	1.0
21212190123	2	0.3283381621331301	1.0	1	1	0.3283381621331301	1.0
21212190124	2	0.32838506351568386	1.0	1	1	0.32838506351568386	1.0
21212190125	2	0.32849075155576735	1.0	1	1	0.32849075155576735	1.0
21212190126	2	0.3285561710721363	1.0	1	1	0.3285561710721363	1.0
21212190127	5	2.1872039560659635	1.0	1	4	0.5468009890164909	0.25
21212190128	12	4.993920126305794	4.0	4	8	0.6242400157882243	0.5
21212190129	11	4.877160632723555	1.5	2	9	0.6096450790904444	0.2222222222222222
21212190130	5	3.7670154461774317	0.0	0	5	0.7534030892354864	0.0
21212190131	1	0.32867562986991145	0.0	0	1	0.32867562986991145	0.0
21212190132	3	1.4798739702949604	0.0	0	3	0.7399369851474802	0.0
21212190133	2	0.3287708467470558	1.0	1	1	0.3287708467470558	1.0
21212190134	2	0.3288197009509937	1.0	1	1	0.3288197009509937	1.0
21212190135	4	0.6578686227292854	2.0	2	2	0.3289343113646427	1.0
21212190136	3	1.1200102678001604	1.0	1	2	0.5600051339000802	0.5
21212190137	2	0.32892761116713504	1.0	1	1	0.32892761116713504	1.0
21212190138	2	0.32900215507307473	1.0	1	1	0.32900215507307473	1.0
21212190139	1	0.33002102279558704	0.0	0	1	0.33002102279558704	0.0
21212190140	7	3.0814050428649344	1.0	2	5	0.7703512607162336	0.4
21212190141	1	0.330063446156691	0.0	0	1	0.330063446156691	0.0
21212190142	3	0.9242317087217413	1.0	1	2	0.46211585436087066	0.5
21212190143	1	0.3302333752864461	0.0	0	1	0.3302333752864461	0.0
21212190144	8	2.1612712288098255	4.0	4	4	0.5403178072024564	1.0
21212190145	1	0.33071989716577266	0.0	0	1	0.33071989716577266	0.0
21212190146	1	0.3307344423181512	0.0	0	1	0.3307344423181512	0.0
21212190147	3	0.43172278205533576	0.5	1	2	0.43172278205533576	0.5
21212190148	2	0.33074228727302196	1.0	1	1	0.33074228727302196	1.0
21212190149	1	0.3307477753744981	0.0	0	1	0.3307477753744981	0.0
21212190150	4	0.6616954455861978	2.0	2	2	0.3308477227930989	1.0
21212190151	3	1.0905320249744306	1.0	1	2	0.5452660124872153	0.5
21212190152	2	0.33080787513606197	1.0	1	1	0.33080787513606197	1.0
21212190153	9	1.6542901448815017	4.0	4	5	0.33085802897630034	0.8
21212190154	3	0.6617677673160797	1.0	1	2	0.33088388365803983	0.5
21212190155	30	6.9353786151984655	10.0	10	20	0.34676893075992327	0.5
21212190156	8	1.3242762936541015	4.0	4	4	0.33106907341352537	1.0
21212190157	3	0.9932475476856255	0.0	0	3	0.3310825158952085	0.0
21212190158	2	0.33110440096244464	1.0	1	1	0.33110440096244464	1.0
21212190159	1	0.33111527615739433	0.0	0	1	0.33111527615739433	0.0
21212190160	29	6.481456563680141	10.0	10	19	0.3411292928252706	0.5263157894736842
21212190161	10	1.8109308301575016	5.0	5	5	0.36218616603150033	1.0
21212190162	3	0.9937656177311065	0.0	0	3	0.33125520591036883	0.0
21212190163	3	0.6625553940512414	1.0	1	2	0.3312776970256207	0.5
21212190164	22	5.0347330494851334	7.0	7	15	0.33564886996567556	0.4666666666666667
21212190165	3	0.4020920844843055	0.5	1	2	0.4020920844843055	0.5
21212190166	2	0.9599688450916694	0.0	0	2	0.9599688450916694	0.0
21212190167	3	0.7731298646085366	0.5	1	2	0.7731298646085366	0.5
21212190168	2	0.9599922116096107	0.0	0	2	0.9599922116096107	0.0
21212190169	11	3.297794722581016	2.0	2	9	0.3664216358423351	0.2222222222222222
21212190170	12	3.029930624000168	5.0	5	7	0.432847232000024	0.7142857142857143
21212190171	2	0.6629841393530647	0.0	0	2	0.33149206967653233	0.0
21212190172	2	0.3315225740933261	1.0	1	1	0.3315225740933261	1.0
21212190173	3	0.6633177687857461	1.0	1	2	0.33165888439287305	0.5
21212190174	1	0.33166172945161376	0.0	0	1	0.33166172945161376	0.0
21212190175	2	0.3316790354893974	1.0	1	1	0.3316790354893974	1.0
21212190176	1	0.3316935469724417	0.0	0	1	0.3316935469724417	0.0
21212190177	1	0.33169411935112325	0.0	0	1	0.33169411935112325	0.0
21212190178	42	18.495751956937458	10.0	10	32	0.5779922486542955	0.3125
21212190179	9	1.813475423759715	4.0	4	5	0.362695084751943	0.8
21212190180	2	0.6635587402106832	0.0	0	2	0.3317793701053416	0.0
21212190181	4	0.6636347655673281	2.0	2	2	0.33181738278366407	1.0
21212190182	32	7.678709536572927	10.0	10	22	0.34903225166240576	0.45454545454545453
21212190183	2	0.6773458948681099	0.0	0	2	0.33867294743405496	0.0
21212190184	2	0.33194152161889434	1.0	1	1	0.33194152161889434	1.0
21212190185	2	0.9520041620684176	0.0	0	2	0.4760020810342088	0.0
21212190186	10	1.6855820537330926	3.0	4	6	0.3371164107466185	0.6666666666666666
21212190187	2	0.6640687296159538	0.0	0	2	0.3320343648079769	0.0
21212190188	24	5.506604290409187	8.0	8	16	0.34416276815057417	0.5
21212190189	1	0.33228030245970985	0.0	0	1	0.33228030245970985	0.0
21212190190	12	3.30643393704582	3.0	3	9	0.36738154856064664	0.3333333333333333
21212190191	8	1.6618292811896802	3.0	3	5	0.332365856237936	0.6
21212190192	3	0.9971042015726476	0.0	0	3	0.3323680671908825	0.0
21212190193	2	0.33247016383531697	1.0	1	1	0.33247016383531697	1.0
21212190194	1	0.3324813757236087	0.0	0	1	0.3324813757236087	0.0
21212190195	1	0.3325017456708054	0.0	0	1	0.3325017456708054	0.0
21212190196	2	0.33251295755909716	1.0	1	1	0.33251295755909716	1.0
21212190197	1	0.3325408357678226	0.0	0	1	0.3325408357678226	0.0
21212190198	24	5.44701283478387	8.0	8	16	0.3404383021739919	0.5
21212190199	10	1.8263803745221858	5.0	5	5	0.36527607490443714	1.0
21212190200	3	0.9978375196717294	0.0	0	3	0.3326125065572431	0.0
21212190201	2	0.33264177643178255	1.0	1	1	0.33264177643178255	1.0
21212190202	21	13.356507576930138	0.0	0	21	0.667825378846507	0.0
21212190203	31	7.30201965164562	10.0	10	21	0.3477152215069343	0.47619047619047616
21212190204	2	0.3327277679113535	1.0	1	1	0.3327277679113535	1.0
21349765600	2	1.3361694135849098	0.0	0	2	0.6680847067924549	0.0
21349765601	26	14.568596504240972	4.0	4	22	0.6622089320109533	0.18181818181818182
21349765602	6	4.0981762096053425	0.0	0	6	0.6830293682675571	0.0
21349765603	2	1.2997591935548005	0.0	0	2	0.6498795967774003	0.0
21349765604	22	9.790176917873458	7.0	7	15	0.6526784611915638	0.4666666666666667
21349765605	12	7.0997045280237785	2.0	2	10	0.7099704528023778	0.2
21349765606	5	3.4558231904744607	0.0	0	5	0.6911646380948921	0.0
21349765607	2	1.3003065222517094	0.0	0	2	0.6501532611258547	0.0
21349765608	3	1.3003807631336413	1.0	1	2	0.6501903815668206	0.5
21349765609	4	2.669862885340059	0.0	0	4	0.6674657213350148	0.0
21349765610	2	0.6502966251509186	1.0	1	1	0.6502966251509186	1.0
21349765611	1	0.6503078370392104	0.0	0	1	0.6503078370392104	0.0
21349765612	3	1.9509990314342627	0.0	0	3	0.6503330104780876	0.0
21349765613	2	1.3036611326963343	0.0	0	2	0.6518305663481672	0.0
21349765614	2	0.650435746839872	1.0	1	1	0.650435746839872	1.0
21349765615	4	2.6428297095646194	0.0	0	4	0.6607074273911548	0.0
21349765616	4	3.056861175644937	0.0	0	4	0.7642152939112342	0.0
21349765617	1	0.6505039609109804	0.0	0	1	0.6505039609109804	0.0
21349765618	2	1.631975759964852	0.0	0	2	0.815987879982426	0.0
21349765619	18	12.581558356178254	1.0	1	17	0.7400916680104855	0.058823529411764705
21349765620	4	3.039045384141346	0.0	0	4	0.7597613460353365	0.0
21349765621	2	1.3038425430690546	0.0	0	2	0.6519212715345273	0.0
21349765622	3	1.9599438287763518	0.0	0	3	0.9799719143881759	0.0
21349765623	2	1.3038608591868648	0.0	0	2	0.6519304295934324	0.0
21349765624	1	0.6519506985326264	0.0	0	1	0.6519506985326264	0.0
21349765625	2	1.3040232127164226	0.0	0	2	0.6520116063582113	0.0
21349765626	1	0.6520349392068185	0.0	0	1	0.6520349392068185	0.0
21349765627	2	1.3041234799936983	0.0	0	2	0.6520617399968491	0.0
21349765628	1	0.6520693829357148	0.0	0	1	0.6520693829357148	0.0
21349765629	1	0.6521221764517552	0.0	0	1	0.6521221764517552	0.0
21349765630	2	1.6188988262432393	0.0	0	2	0.8094494131216197	0.0
21349765631	2	1.3043395697806548	0.0	0	2	0.6521697848903274	0.0
21349765632	2	1.6346942220089233	0.0	0	2	0.8173471110044617	0.0
21349765633	1	0.6522406925081725	0.0	0	1	0.6522406925081725	0.0
21349765634	1	0.6522523084284747	0.0	0	1	0.6522523084284747	0.0
21349765635	2	1.6339197936527716	0.0	0	2	0.8169598968263858	0.0
21349765636	1	0.6522755739384135	0.0	0	1	0.6522755739384135	0.0
21349765637	2	1.304650001042066	0.0	0	2	0.652325000521033	0.0
21349765638	2	1.634196387233302	0.0	0	2	0.817098193616651	0.0
21349765639	2	1.3047621199249835	0.0	0	2	0.6523810599624917	0.0
21349765640	2	1.6341176683299206	0.0	0	2	0.8170588341649603	0.0
21349765641	1	0.6524183319154615	0.0	0	1	0.6524183319154615	0.0
21349765642	12	5.05251857225727	3.5	4	8	0.7217883674653243	0.5
21349765643	1	0.6524636508393075	0.0	0	1	0.6524636508393075	0.0
21349765644	2	1.3051670273381863	0.0	0	2	0.6525835136690932	0.0
21349765645	1	0.6524831117144806	0.0	0	1	0.6524831117144806	0.0
21349765646	3	2.1975798347892908	0.0	0	3	0.7325266115964303	0.0
21349765647	2	1.3050202963797015	0.0	0	2	0.6525101481898508	0.0
21349765648	4	3.1224874217259524	0.0	0	4	0.7806218554314881	0.0
21349765649	2	1.3051526168631447	0.0	0	2	0.6525763084315723	0.0
21349765650	2	1.3052760823116907	0.0	0	2	0.6526380411558453	0.0
21349765651	2	1.396465198012553	0.0	0	2	0.6982325990062765	0.0
21349765652	2	1.509202182567453	0.0	0	2	0.7546010912837265	0.0
21349765653	1	0.6527043529095709	0.0	0	1	0.6527043529095709	0.0
21349765654	4	2.6157415517664164	0.0	0	4	0.8719138505888054	0.0
21349765655	2	1.3057344902969525	0.0	0	2	0.6528672451484763	0.0
21349765656	2	1.6345938200543106	0.0	0	2	0.8172969100271553	0.0
21349765657	2	1.344862229629775	0.0	0	2	0.6724311148148875	0.0
21349765658	1	0.652809670586978	0.0	0	1	0.652809670586978	0.0
21349765659	2	1.37488753179774	0.0	0	2	0.68744376589887	0.0
21349765660	1	0.6528836421142362	0.0	0	1	0.6528836421142362	0.0
21349765661	1	0.6529084564135486	0.0	0	1	0.6529084564135486	0.0
21349765662	1	0.6529440785691422	0.0	0	1	0.6529440785691422	0.0
21349765663	1	0.6529680511350994	0.0	0	1	0.6529680511350994	0.0
21349765664	1	0.653007545264127	0.0	0	1	0.653007545264127	0.0
21352204034	3	0.17609193101948017	0.5	1	2	0.17609193101948017	0.5
21352204035	2	0.9586154051951177	0.0	0	2	0.9586154051951177	0.0
21352204036	5	0.9234633071764132	2.0	2	3	0.3078211023921377	0.6666666666666666
21352204037	4	0.17066982143838966	2.0	2	2	0.08533491071919483	1.0
21352204038	10	0.6038238532216351	5.0	5	5	0.12076477064432703	1.0
21352204039	2	0.08540586884104125	1.0	1	1	0.08540586884104125	1.0
21352204040	26	1.7894593233534508	7.0	7	19	0.09418206965018162	0.3684210526315789
21352204041	5	0.14080882562136673	0.6666666666666666	2	3	0.14080882562136673	0.6666666666666666
21352204042	2	0.5242396142814137	0.0	0	2	0.5242396142814137	0.0
21352204043	3	0.2263932766110549	0.5	1	2	0.2263932766110549	0.5
21352204044	2	0.5242792094184441	0.0	0	2	0.5242792094184441	0.0
21352204045	4	0.2543092959988003	1.0	2	2	0.2543092959988003	1.0
21352204046	3	0.17137566536075666	1.0	1	2	0.08568783268037833	0.5
21352204047	8	0.6953375413042766	2.0	2	6	0.11588959021737943	0.3333333333333333
21352204048	3	0.1711073544364415	1.0	1	2	0.08555367721822076	0.5
21352204049	9	0.4280035327212226	4.0	4	5	0.08560070654424452	0.8
21352204050	2	0.1711877568065337	0.0	0	2	0.08559387840326685	0.0
21352204051	26	1.54492915079845	9.0	9	17	0.09087818534108529	0.5294117647058824
21352204052	10	1.5798760005558132	3.5	4	6	0.31597520011116265	0.6666666666666666
21352204053	9	1.6128005354232202	3.0	3	6	0.2688000892372034	0.5
21352204054	9	2.401363648438684	3.0	3	6	0.40022727473978065	0.5
21352204055	7	1.5712406580644436	3.0	3	4	0.3928101645161109	0.75
21352204056	6	2.1406530039426457	1.0	1	5	0.42813060078852916	0.2
21352204057	16	4.556427497785652	6.5	7	9	0.5695534372232065	0.7777777777777778
21352204058	4	1.9536800195093589	0.0	0	4	0.9768400097546794	0.0
21352204059	4	0.7061133107100098	0.3333333333333333	1	3	0.7061133107100098	0.3333333333333333
21352204060	4	0.1717106752361407	2.0	2	2	0.08585533761807035	1.0
21352204061	9	0.42932656920898316	4.0	4	5	0.08586531384179663	0.8
21352204062	4	0.17178774434214616	2.0	2	2	0.08589387217107308	1.0
21352204063	13	1.258079621712909	2.0	2	11	0.11437087470117356	0.18181818181818182
21352204064	16	1.8636435734651575	8.0	8	8	0.2329554466831447	1.0
21352204065	7	0.9524775192380683	2.0	2	5	0.19049550384761366	0.4
21352204066	12	2.2021689313727046	5.0	5	7	0.3145955616246721	0.7142857142857143
21352204067	7	3.5077762525943483	0.5	1	6	0.7015552505188697	0.16666666666666666
21352204068	6	2.556114271969502	1.0	1	5	0.5112228543939004	0.2
21352204069	2	0.40634798933638316	0.0	0	2	0.20317399466819158	0.0
21352204070	2	0.7719274316759144	0.0	0	2	0.7719274316759144	0.0
21352204071	1	0.08602959325727139	0.0	0	1	0.08602959325727139	0.0
21352204072	2	0.335647673582	0.0	0	2	0.167823836791	0.0
21352204073	3	0.17711601748879494	0.5	1	2	0.17711601748879494	0.5
21352204074	1	0.08607407044776208	0.0	0	1	0.08607407044776208	0.0
21352204075	1	0.08608191540263288	0.0	0	1	0.08608191540263288	0.0
21352204076	4	0.1722909998805749	2.0	2	2	0.08614549994028745	1.0
21352204077	22	1.2915416875009702	8.0	8	14	0.09225297767864073	0.5714285714285714
21352204078	10	0.6072423007239209	5.0	5	5	0.12144846014478419	1.0
21352204079	4	0.17237177261334335	2.0	2	2	0.08618588630667168	1.0
21352204080	1	0.08621208104868663	0.0	0	1	0.08621208104868663	0.0
21352204081	31	2.0357107396119076	10.0	10	21	0.09693860664818607	0.47619047619047616
21352204082	7	4.955992968092211	0.0	0	7	0.7079989954417444	0.0
21352204083	2	0.9723286219946206	0.0	0	2	0.9723286219946206	0.0
21352204084	2	0.3861497220747973	0.0	0	2	0.3861497220747973	0.0
21352204085	4	0.6818610872629346	0.3333333333333333	1	3	0.6818610872629346	0.3333333333333333
21352204086	4	1.6848172211371906	0.5	1	3	0.8424086105685953	0.3333333333333333
21352204087	2	0.9723777118838979	0.0	0	2	0.9723777118838979	0.0
21352204088	2	0.9723634360861931	0.0	0	2	0.9723634360861931	0.0
21352204089	5	1.743054294124597	0.5	1	4	0.8715271470622985	0.25
21352204090	4	0.17281048403809254	2.0	2	2	0.08640524201904627	1.0
21352204091	10	1.405799010842098	4.0	4	6	0.23429983514034966	0.6666666666666666
21352204092	24	1.427807610865458	8.0	8	16	0.08923797567909113	0.5
21352204093	9	0.6091190630820902	4.0	4	5	0.12182381261641803	0.8
21352204094	3	0.2597602938686425	0.0	0	3	0.08658676462288084	0.0
21352204095	2	0.08660749370964246	1.0	1	1	0.08660749370964246	1.0
21352204096	23	1.6053632151816912	7.0	7	16	0.1003352009488557	0.4375
21352204097	6	1.2518485390387681	2.0	2	4	0.31296213475969203	0.5
21352204098	9	2.0476237244498994	3.0	3	6	0.3412706207416499	0.5
21352204099	10	5.128167404737754	0.5	1	9	0.6410209255922192	0.1111111111111111
21352204100	6	2.7390809086558705	0.5	1	5	0.6847702271639676	0.2
21352204101	3	0.5799611503020291	0.0	0	3	0.5799611503020291	0.0
21352204102	4	2.4322871137660207	0.0	0	4	0.8107623712553402	0.0
21352204103	4	0.6919515510401686	0.5	1	3	0.3459757755200843	0.3333333333333333
21352204104	5	1.1403245932567663	0.5	1	4	0.3801081977522554	0.25
21352204105	11	0.8263806775461937	3.0	3	8	0.10329758469327421	0.375
21352204106	14	4.615078972938509	4.0	4	10	0.4615078972938509	0.4
21352204107	3	0.26047485814856974	0.0	0	3	0.08682495271618991	0.0
21352204108	3	0.21798459607758316	1.0	1	2	0.10899229803879158	0.5
21352204109	27	1.8273377620404316	8.0	8	19	0.0961756716863385	0.42105263157894735
21352204110	2	0.7910069006310543	0.0	0	2	0.7910069006310543	0.0
21352204111	5	1.241771677672555	0.5	1	4	0.6208858388362775	0.25
21352204112	9	0.6151410255214563	4.0	4	5	0.12302820510429127	0.8
21352204113	3	0.26102070539477346	0.0	0	3	0.08700690179825782	0.0
21352204114	4	0.1740627475853448	2.0	2	2	0.0870313737926724	1.0
21352204115	32	2.178810258386214	10.0	10	22	0.0990368299266461	0.45454545454545453
21352204116	8	5.016106433075111	0.5	1	7	0.8360177388458517	0.14285714285714285
21352204117	4	1.448019783562072	0.5	1	3	0.724009891781036	0.3333333333333333
21352204118	3	1.5448430246415419	0.0	0	3	0.7724215123207709	0.0
21352204119	2	0.9037829079443029	0.0	0	2	0.9037829079443029	0.0
21352204120	3	1.8075768930995608	0.0	0	3	0.9037884465497804	0.0
21352204121	5	1.645714767474359	0.5	1	4	0.8228573837371795	0.25
21352204122	3	0.4952334828599689	0.5	1	2	0.4952334828599689	0.5
21352204123	1	0.08718566351668722	0.0	0	1	0.08718566351668722	0.0
21352204124	1	0.08718960282878972	0.0	0	1	0.08718960282878972	0.0
21352204125	11	0.7036429579897279	5.0	5	6	0.11727382633162131	0.8333333333333334
21352204126	3	0.26177149787831006	0.0	0	3	0.08725716595943668	0.0
21352204127	3	0.21797799688807812	1.0	1	2	0.10898899844403906	0.5
21352204128	27	1.5293281280991573	10.0	10	17	0.08996047812347985	0.5882352941176471
21352204129	4	0.8050668105649119	1.0	1	3	0.40253340528245596	0.3333333333333333
21352204130	1	0.08740020451426986	0.0	0	1	0.08740020451426986	0.0
21352204131	11	0.7049068374572824	5.0	5	6	0.11748447290954707	0.8333333333333334
21352204132	3	0.26242767953271817	0.0	0	3	0.08747589317757272	0.0
21352204133	6	0.7851430830544699	2.0	2	4	0.19628577076361747	0.5
21352204134	31	2.0617769657781855	10.0	10	21	0.09817985551324693	0.47619047619047616
21352204135	13	1.8072050153032175	4.333333333333333	5	8	0.3012008358838696	0.625
21352204136	5	1.4236684375950843	0.5	1	4	0.7118342187975422	0.25
21352204137	11	1.5446772705092287	5.0	5	6	0.2574462117515381	0.8333333333333334
21352204138	15	5.945049491732781	2.5	3	12	0.5945049491732781	0.25
21352204139	4	1.0836451983472262	1.0	1	3	0.5418225991736131	0.3333333333333333
21352204140	1	0.08760282656754236	0.0	0	1	0.08760282656754236	0.0
21352204141	3	0.1752668639846775	1.0	1	2	0.08763343199233875	0.5
21352204142	2	0.6736515608413118	0.0	0	2	0.3368257804206559	0.0
21352204143	1	0.08763349933100717	0.0	0	1	0.08763349933100717	0.0
21352204144	9	0.6185823008323362	4.0	4	5	0.12371646016646724	0.8
21352204145	3	0.26315076215420036	0.0	0	3	0.08771692071806679	0.0
21352204146	3	0.21801543718771904	1.0	1	2	0.10900771859385952	0.5
21352204147	28	1.9751599773162956	8.0	8	20	0.09875799886581478	0.4
21352204148	2	0.08781389962370142	1.0	1	1	0.08781389962370142	1.0
21352204149	2	0.4760592347290294	0.0	0	2	0.2380296173645147	0.0
21352204150	1	0.08784457238716624	0.0	0	1	0.08784457238716624	0.0
21352204151	2	0.08785578427545798	1.0	1	1	0.08785578427545798	1.0
21352204152	1	0.08787915079339935	0.0	0	1	0.08787915079339935	0.0
21352204153	2	0.5632856044707758	0.0	0	2	0.2816428022353879	0.0
21352204154	11	0.7076733793106049	5.0	5	6	0.11794556321843415	0.8333333333333334
21352204155	3	0.263845932897623	0.0	0	3	0.08794864429920767	0.0
21352204156	4	0.17593910591150347	2.0	2	2	0.08796955295575173	1.0
21352204157	23	1.3655853008036836	8.0	8	15	0.0910390200535789	0.5333333333333333
21352204158	11	6.677385287989135	0.3333333333333333	1	10	0.8346731609986419	0.1
21352204159	12	2.8264320906195315	4.0	5	7	0.47107201510325525	0.7142857142857143
21352204160	4	1.8335590806076518	0.0	0	4	0.45838977015191296	0.0
21352204161	1	0.08810389359924745	0.0	0	1	0.08810389359924745	0.0
21352204162	2	0.08811816939695226	1.0	1	1	0.08811816939695226	1.0
21352204163	2	0.32596986116483706	0.0	0	2	0.16298493058241853	0.0
21352204164	1	0.08814604760567768	0.0	0	1	0.08814604760567768	0.0
21352204165	2	0.8070021575646055	0.0	0	2	0.40350107878230274	0.0
21352204166	10	0.7489774707373925	3.0	3	7	0.10699678153391322	0.42857142857142855
21352204167	9	0.6210896224815801	4.0	4	5	0.12421792449631601	0.8
21352204168	3	0.26472476985915816	0.0	0	3	0.08824158995305272	0.0
21352204169	3	0.17653902610844752	1.0	1	2	0.08826951305422376	0.5
21352204170	10	1.430556442648986	4.0	4	6	0.23842607377483102	0.6666666666666666
21352204171	14	2.0374125561095244	6.0	6	8	0.25467656951369055	0.75
21352204172	10	1.4536628649835794	5.0	5	5	0.2907325729967159	1.0
21352204173	6	1.4842382230645241	2.0	2	4	0.37105955576613103	0.5
21352204174	7	5.337115016836182	0.0	0	7	0.7624450024051689	0.0
21352204175	3	1.1951226467786848	0.0	0	3	0.5975613233893424	0.0
21352204176	2	0.5952150758349566	0.0	0	2	0.5952150758349566	0.0
21352204177	5	1.1749604393740372	0.5	1	4	0.39165347979134574	0.25
21352204178	3	0.14391374428349418	0.5	1	2	0.14391374428349418	0.5
21352204179	3	1.3930365487020016	0.0	0	3	0.4643455162340005	0.0
21352204180	4	1.3591421686626914	0.5	1	3	0.6795710843313457	0.3333333333333333
21352204181	1	0.08846152926722027	0.0	0	1	0.08846152926722027	0.0
21352204182	25	1.8092007987578174	7.0	7	18	0.1005111554865454	0.3888888888888889
21352204183	11	0.7109683613643447	5.0	5	6	0.11849472689405745	0.8333333333333334
21352204184	2	0.17704662499098925	0.0	0	2	0.08852331249549462	0.0
21352204185	18	1.1001953932472177	6.166666666666666	8	10	0.15717077046388825	0.8
21352204186	30	1.9605292711595859	10.0	10	20	0.0980264635579793	0.5
21352204187	7	3.290123467805399	2.0	2	5	0.6580246935610798	0.4
21352204188	2	0.3524358096668497	0.0	0	2	0.3524358096668497	0.0
21352204189	14	5.631925794672885	1.1666666666666665	3	11	0.7039907243341106	0.2727272727272727
21352204190	2	0.6762894858379541	0.0	0	2	0.6762894858379541	0.0
21352204191	8	3.9401280114820514	0.5	1	7	0.6566880019136753	0.14285714285714285
21352204192	8	6.6881160751643645	0.0	0	8	0.8360145093955456	0.0
21352204193	4	0.7650187873201422	1.0	1	3	0.3825093936600711	0.3333333333333333
21352204194	2	0.08872569886342765	1.0	1	1	0.08872569886342765	1.0
21352204195	4	0.26699654084627267	1.0	1	3	0.08899884694875755	0.3333333333333333
21352204196	8	0.5349111097591003	4.0	4	4	0.13372777743977507	1.0
21352204197	3	0.26648671978767313	0.0	0	3	0.08882890659589104	0.0
21352204198	7	1.3220984937787656	2.0	3	4	0.44069949792625523	0.75
21352204199	5	1.324591573299639	1.0	1	4	0.33114789332490974	0.25
21352204200	30	1.9659980464378908	10.0	10	20	0.09829990232189453	0.5
21352204201	10	1.44577026800487	5.0	5	5	0.289154053600974	1.0
21352204202	4	2.0507251415012693	0.0	0	4	0.6835750471670897	0.0
21352204203	6	4.538281073420125	0.0	0	6	0.7563801789033541	0.0
21352204204	10	2.723224470387265	2.5	3	7	0.4538707450645441	0.42857142857142855
21352204205	9	5.267072700880255	0.5	1	8	0.7524389572686079	0.125
21352204206	2	0.9432824577348006	0.0	0	2	0.9432824577348006	0.0
21352204207	4	1.1458408759656407	0.5	1	3	0.5729204379828203	0.3333333333333333
21352204208	5	3.077748586839122	0.0	0	5	0.6155497173678244	0.0
21352204209	3	0.29272098960099047	0.5	1	2	0.29272098960099047	0.5
21352204210	2	0.546091079522018	0.0	0	2	0.273045539761009	0.0
21352204211	10	0.6251920961776652	5.0	5	5	0.12503841923553305	1.0
21352204212	4	0.548387193437766	1.0	1	3	0.18279573114592199	0.3333333333333333
21352204213	17	1.162984997921087	5.0	5	12	0.0969154164934239	0.4166666666666667
21352204214	13	0.987393999255975	4.0	4	9	0.109710444361775	0.4444444444444444
21352204215	11	0.715414363277369	5.0	5	6	0.11923572721289483	0.8333333333333334
21352204216	2	0.1785877377564244	0.0	0	2	0.0892938688782122	0.0
21352204217	3	0.21835431903653718	1.0	1	2	0.10917715951826859	0.5
21352204218	27	1.8829635424745557	8.0	8	19	0.09910334434076609	0.42105263157894735
21352204219	3	0.17899846996444552	1.0	1	2	0.08949923498222276	0.5
21352204220	9	0.4472432677071995	4.0	4	5	0.08944865354143991	0.8
21352204221	1	0.08943911838599178	0.0	0	1	0.08943911838599178	0.0
21352204222	3	0.21828721605345774	1.0	1	2	0.10914360802672887	0.5
21352204223	33	7.607277148484829	8.0	8	25	0.31696988118686786	0.32
21352204224	13	4.385147621680721	2.0	3	10	0.626449660240103	0.3
21352204225	11	0.7295635979548842	3.5	4	7	0.12159393299248071	0.5714285714285714
21352204226	3	0.21822698161455703	1.0	1	2	0.10911349080727852	0.5
21352204227	32	2.8710894457175757	5.0	5	27	0.10633664613768799	0.18518518518518517
21352204228	2	0.08969924766209403	1.0	1	1	0.08969924766209403	1.0
21352204229	23	2.4292734053302665	4.0	4	19	0.12785649501738244	0.21052631578947367
21352204230	1	0.08972803494284311	0.0	0	1	0.08972803494284311	0.0
21352204231	1	0.08973587989771391	0.0	0	1	0.08973587989771391	0.0
21352204232	7	2.3727777439775073	1.0	1	6	0.39546295732958453	0.16666666666666666
21352204233	2	0.17954233071993084	0.0	0	2	0.08977116535996542	0.0
21352204234	5	2.5823348383637956	0.0	0	5	0.5164669676727591	0.0
21352204235	2	0.08979268006452526	1.0	1	1	0.08979268006452526	1.0
21352204236	3	0.5521199778442314	0.0	0	3	0.1840399926147438	0.0
21352204237	8	2.407559378311905	1.0	1	7	0.3439370540445578	0.14285714285714285
21352204238	3	1.3733210996929794	0.0	0	3	0.4577736998976598	0.0
21352204239	4	1.581952287388508	0.0	0	4	0.395488071847127	0.0
21352204240	1	0.0898473253939472	0.0	0	1	0.0898473253939472	0.0
21352204241	8	0.35995713489723125	4.0	4	4	0.08998928372430781	1.0
21352204242	3	0.1798054565667777	1.0	1	2	0.08990272828338886	0.5
21352204243	5	1.2375246615247084	0.5	1	4	0.6187623307623542	0.25
21352204244	31	3.3286891986115985	5.0	5	26	0.12802650763890763	0.19230769230769232
21352204245	8	0.36037429794808634	4.0	4	4	0.09009357448702159	1.0
21352204246	11	1.3087358420870516	5.0	5	6	0.21812264034784193	0.8333333333333334
21352204247	10	0.4514820348681645	5.0	5	5	0.0902964069736329	1.0
21352204248	17	1.912882516885087	2.0	2	15	0.12752550112567246	0.13333333333333333
21352204249	9	0.45195199143506004	4.0	4	5	0.09039039828701201	0.8
21352204250	10	0.4524459879065812	5.0	5	5	0.09048919758131624	1.0
21352204251	8	0.36234701790875257	4.0	4	4	0.09058675447718814	1.0
21352204252	10	0.45345637095687275	5.0	5	5	0.09069127419137454	1.0
21352204253	35	3.837042981295642	5.0	5	30	0.12790143270985474	0.16666666666666666
21352204254	8	0.36315016620698487	4.0	4	4	0.09078754155174622	1.0
21352204255	9	0.45445591248154876	4.0	4	5	0.09089118249630976	0.8
21352204256	9	0.4549576865692724	4.0	4	5	0.09099153731385448	0.8
21352204257	9	0.4554304713602414	4.0	4	5	0.09108609427204828	0.8
21352204258	8	0.3687592752702747	4.0	4	4	0.09218981881756867	1.0
21352204259	32	26.673506479680196	0.0	0	32	0.8604356928929096	0.0
21352204260	1	0.0912152094348747	0.0	0	1	0.0912152094348747	0.0
21352204261	4	0.854536355254842	1.0	1	3	0.28484545175161397	0.3333333333333333
21352204262	2	0.7922130035211054	0.0	0	2	0.3961065017605527	0.0
21352204263	2	0.44520139093406713	0.0	0	2	0.22260069546703357	0.0
21352204264	2	0.1826594376810421	0.0	0	2	0.09132971884052105	0.0
21352204265	1	0.09129975313307465	0.0	0	1	0.09129975313307465	0.0
21352204266	2	0.18262075161603547	0.0	0	2	0.09131037580801774	0.0
21352204267	1	0.09132170553897921	0.0	0	1	0.09132170553897921	0.0
21352204268	2	0.1827125005517562	0.0	0	2	0.0913562502758781	0.0
21352204269	5	1.3884060051681755	0.0	0	5	0.2776812010336351	0.0
21352204270	1	0.09138271437256675	0.0	0	1	0.09138271437256675	0.0
21352204271	2	0.18287313694526952	0.0	0	2	0.09143656847263476	0.0
21352204272	1	0.0914021752477398	0.0	0	1	0.0914021752477398	0.0
21352204273	1	0.09141338713603155	0.0	0	1	0.09141338713603155	0.0
21352204274	2	0.1828662347317566	0.0	0	2	0.0914331173658783	0.0
21352204275	6	2.1472079519425473	0.0	0	6	0.4294415903885095	0.0
21352204276	2	0.18291936494113908	0.0	0	2	0.09145968247056954	0.0
21352204277	5	1.9011896958234908	0.0	0	5	0.4752974239558727	0.0
21352204278	3	1.1501030433138812	0.0	0	3	0.3833676811046271	0.0
21352204279	5	2.3268342876513306	0.0	0	5	0.46536685753026613	0.0
21352204280	5	3.234221699838761	0.0	0	5	0.6468443399677521	0.0
21352204281	3	1.654359739395313	0.0	0	3	0.5514532464651043	0.0
21352204282	2	0.3859125889539601	0.0	0	2	0.19295629447698004	0.0
21352204283	17	14.773663826579764	0.0	0	17	0.869039048622339	0.0
21352204284	4	0.5990645918231261	1.0	1	3	0.19968819727437537	0.3333333333333333
21352204285	2	0.3696667311658879	0.0	0	2	0.18483336558294394	0.0
21352204286	3	0.8640811064632092	1.0	1	2	0.4320405532316046	0.5
21352204287	3	0.5674939008842812	0.0	0	3	0.18916463362809374	0.0
21352204288	5	2.7044581935789416	0.0	0	5	0.5408916387157883	0.0
21352204289	1	0.09163947671524804	0.0	0	1	0.09163947671524804	0.0
21352204290	1	0.0916510926355503	0.0	0	1	0.0916510926355503	0.0
21352204291	3	0.6849698105598278	0.0	0	3	0.22832327018660925	0.0
21352204292	3	0.717448159410291	0.0	0	3	0.3587240797051455	0.0
21352204293	3	1.4129253947822027	0.0	0	3	0.47097513159406756	0.0
21352204294	3	0.6368039088211535	1.0	1	2	0.3184019544105767	0.5
21352204295	2	0.1834813734677633	0.0	0	2	0.09174068673388165	0.0
21352204296	5	1.0106065473319965	0.0	0	5	0.2021213094663993	0.0
21352204297	2	0.959462289958488	0.0	0	2	0.479731144979244	0.0
21352204298	1	0.09181943930659757	0.0	0	1	0.09181943930659757	0.0
21352204299	2	0.28849663291506705	0.0	0	2	0.14424831645753353	0.0
21352204300	1	0.09186704774516974	0.0	0	1	0.09186704774516974	0.0
21352204301	1	0.09187489270004054	0.0	0	1	0.09187489270004054	0.0
21352204302	1	0.09188273765491134	0.0	0	1	0.09188273765491134	0.0
21352204303	1	0.09189058260978215	0.0	0	1	0.09189058260978215	0.0
21352204304	2	0.18382062567925778	0.0	0	2	0.09191031283962889	0.0
21352204305	3	1.481248924896072	0.0	0	3	0.493749641632024	0.0
21352204306	3	1.8177379951399664	0.0	0	3	0.6059126650466554	0.0
21352204307	7	0.41500888685241794	3.0	3	4	0.10375222171310448	0.75
21352204308	7	4.32177483046901	0.0	0	7	0.6173964043527157	0.0
21352204309	1	0.09198058074012402	0.0	0	1	0.09198058074012402	0.0
21352204310	1	0.09199778576990505	0.0	0	1	0.09199778576990505	0.0
21352204311	1	0.09200603475678637	0.0	0	1	0.09200603475678637	0.0
21352204312	2	0.1840344259514878	0.0	0	2	0.0920172129757439	0.0
21352204313	1	0.09204684198984822	0.0	0	1	0.09204684198984822	0.0
21352204314	2	0.18412068678573246	0.0	0	2	0.09206034339286623	0.0
21352204315	2	0.18425506109856235	0.0	0	2	0.09212753054928118	0.0
21352204316	2	0.18420607221728763	0.0	0	2	0.09210303610864382	0.0
21352204317	1	0.0921129685622356	0.0	0	1	0.0921129685622356	0.0
21352204318	2	0.3685882013831564	0.0	0	2	0.1842941006915782	0.0
21352204319	16	3.5081180636752425	2.0	4	12	0.4385147579594053	0.3333333333333333
21352204320	2	0.19717290721603525	0.0	0	2	0.09858645360801763	0.0
21352204321	6	4.31500473542351	0.0	0	6	0.7191674559039183	0.0
21352204322	4	1.109850916565134	0.0	0	4	0.2774627291412835	0.0
21352204323	2	0.1844140140253652	0.0	0	2	0.0922070070126826	0.0
21352204324	4	0.9597133958530222	0.0	0	4	0.23992834896325554	0.0
21352204325	2	0.28920523772283924	0.0	0	2	0.14460261886141962	0.0
21352204326	4	0.9234532063761505	0.0	0	4	0.23086330159403762	0.0
21352204327	2	0.18462996913498464	0.0	0	2	0.09231498456749232	0.0
21352204328	1	0.09233495048267852	0.0	0	1	0.09233495048267852	0.0
21352204329	2	0.31699668057400965	0.0	0	2	0.15849834028700482	0.0
21352204330	2	0.1847248829881211	0.0	0	2	0.09236244149406055	0.0
21352204331	4	2.491690593498445	0.0	0	4	0.6229226483746112	0.0
21352204332	2	1.0437838378913138	0.0	0	2	0.5218919189456569	0.0
21352204333	1	0.09239033653745307	0.0	0	1	0.09239033653745307	0.0
21352204334	1	0.09240461233515788	0.0	0	1	0.09240461233515788	0.0
21352204335	3	0.7169739941766192	0.0	0	3	0.3584869970883096	0.0
21352204336	17	3.896895508938417	3.5	5	12	0.3896895508938417	0.4166666666666667
21352204337	8	0.3750396835190326	4.0	4	4	0.09375992087975815	1.0
21352204338	2	0.18512053133441636	0.0	0	2	0.09256026566720818	0.0
21352204339	3	0.4459500285802143	1.0	1	2	0.22297501429010716	0.5
21352204340	11	0.8377558957781921	2.0	2	9	0.09308398841979912	0.2222222222222222
21352204341	12	0.9347517932034881	2.0	2	10	0.09347517932034881	0.2
21352204342	2	0.09413504776685279	1.0	1	1	0.09413504776685279	1.0
21352204343	27	2.172442208860509	4.0	4	23	0.0944540090808917	0.17391304347826086
21352204344	9	0.47130064671720456	4.0	4	5	0.09426012934344091	0.8
21352204345	7	1.2780786001853093	0.0	0	7	0.1825826571693299	0.0
21352204346	9	0.4719850096043459	4.0	4	5	0.09439700192086918	0.8
21352204347	27	3.3108858647616644	6.0	9	18	0.23649184748297603	0.5
21352204348	8	0.37808063044616214	4.0	4	4	0.09452015761154053	1.0
21352204349	2	0.18928889591754944	0.0	0	2	0.09464444795877472	0.0
21352204350	13	4.910118601239833	0.0	0	13	0.3777014308646025	0.0
21352204351	4	0.3819345234477789	0.0	0	4	0.09548363086194472	0.0
21352204352	10	0.4783442714338224	5.0	5	5	0.09566885428676448	1.0
21352204353	2	0.19096131908640146	0.0	0	2	0.09548065954320073	0.0
21352204354	3	0.30131128252318795	1.0	1	2	0.15065564126159398	0.5
21352204355	10	2.08496833584299	2.0	2	8	0.2606210419803737	0.25
21352204356	3	1.0520237340523937	0.0	0	3	0.35067457801746454	0.0
21352204357	26	9.464408567673862	5.0	5	21	0.4506861222701839	0.23809523809523808
21352204358	14	4.465140235975569	3.0	3	11	0.40592183963414263	0.2727272727272727
21352204359	8	0.3835581597513614	4.0	4	4	0.09588953993784036	1.0
21352204360	8	0.7777443142006109	0.0	0	8	0.09721803927507636	0.0
21352204361	9	0.48052264368783987	4.0	4	5	0.09610452873756797	0.8
21352204362	10	0.4815389525409523	5.0	5	5	0.09630779050819047	1.0
21352204363	4	0.3858605698326065	0.0	0	4	0.09646514245815163	0.0
21352204364	8	0.3863321761968783	4.0	4	4	0.09658304404921958	1.0
21352204365	1	0.09641961310096689	0.0	0	1	0.09641961310096689	0.0
21352204366	4	0.780484459295913	1.0	1	3	0.3902422296479565	0.3333333333333333
21352204367	17	1.9485987109291365	7.5	8	9	0.24357483886614206	0.8888888888888888
21352204368	2	0.8143373587154772	0.0	0	2	0.4071686793577386	0.0
21352204369	1	0.09661755511678427	0.0	0	1	0.09661755511678427	0.0
21352204370	10	0.48420913275976724	5.0	5	5	0.09684182655195345	1.0
21352204371	22	1.6542894714948175	5.0	5	17	0.09731114538204809	0.29411764705882354
21352204372	10	0.48557307748859224	5.0	5	5	0.09711461549771845	1.0
21352204373	2	0.19387600601024552	0.0	0	2	0.09693800300512276	0.0
21352204374	15	1.9865789993521012	7.0	7	8	0.24832237491901266	0.875
21352204375	12	1.7010015313823281	5.0	5	7	0.243000218768904	0.7142857142857143
21352204376	9	2.126229195844652	2.0	3	6	0.4252458391689304	0.5
21352204377	6	4.361789588411581	0.0	0	6	0.8723579176823162	0.0
21352204378	9	7.010938089265958	0.0	0	9	0.8763672611582447	0.0
21352204379	4	2.5831624979373324	0.0	0	4	0.6457906244843331	0.0
21352204380	10	6.346496438104299	0.5	1	9	0.7933120547630373	0.1111111111111111
21352204381	8	4.768155287817758	0.5	1	7	0.7946925479696264	0.14285714285714285
21352204382	3	0.3623910573978985	0.5	1	2	0.3623910573978985	0.5
21352204383	10	0.48776417675094086	5.0	5	5	0.09755283535018817	1.0
21352204384	10	0.4887852329801768	5.0	5	5	0.09775704659603536	1.0
21352204385	8	0.39183515951873993	4.0	4	4	0.09795878987968498	1.0
21352204386	14	1.07891883188824	3.0	3	11	0.09808353017165818	0.2727272727272727
21352204387	9	0.49085620005806613	4.0	4	5	0.09817124001161323	0.8
21352204388	8	0.39849859011346467	4.0	4	4	0.09962464752836617	1.0
21352204389	1	0.09828018050938134	0.0	0	1	0.09828018050938134	0.0
21352204390	13	1.0868932790184123	4.5	6	7	0.21737865580368246	0.8571428571428571
21352204391	7	4.053970764311058	1.0	1	6	0.6756617940518429	0.16666666666666666
21352204392	3	1.5148234799297269	0.0	0	3	0.7574117399648634	0.0
21352204393	12	2.023797586427245	5.0	5	7	0.2891139409181779	0.7142857142857143
21352204394	2	0.723946879622063	0.0	0	2	0.723946879622063	0.0
21352204395	3	0.539446402746448	0.5	1	2	0.539446402746448	0.5
21352204396	4	1.672302262272868	0.0	0	4	0.418075565568217	0.0
21352204397	5	1.6236172804086864	1.0	1	4	0.5412057601362288	0.25
21352204398	3	1.2548465238954463	0.0	0	3	0.41828217463181544	0.0
21352204399	4	0.40046508124730207	0.0	0	4	0.10011627031182552	0.0
21352204400	20	5.060877624192117	3.0	5	15	0.5623197360213463	0.3333333333333333
21352204401	1	0.10010593382622321	0.0	0	1	0.10010593382622321	0.0
21352204402	6	0.732907770905904	0.6666666666666666	2	4	0.366453885452952	0.5
21352204403	5	0.40070739944560746	1.0	1	4	0.10017684986140186	0.25
21352204404	5	1.9385919154474127	0.0	0	5	0.38771838308948253	0.0
21352204405	27	19.602840944348056	0.0	0	27	0.7841136377739223	0.0
21352204406	11	2.4022658519181608	5.0	5	6	0.4003776419863601	0.8333333333333334
21352204407	6	2.5670214527866544	1.0	1	5	0.5134042905573308	0.2
21352204408	11	2.8192824748388228	5.0	5	6	0.4698804124731371	0.8333333333333334
21352204409	5	1.9462920921811153	1.0	1	4	0.48657302304527883	0.25
21352204410	4	3.070403554242661	0.0	0	4	0.7676008885606652	0.0
21352204411	2	0.561181776122698	0.0	0	2	0.561181776122698	0.0
21352204412	5	0.8583046608088984	1.0	1	4	0.28610155360296613	0.25
21352204413	2	0.49862752009495287	0.0	0	2	0.24931376004747643	0.0
21352204414	9	4.985334951122396	0.0	0	9	0.8308891585203994	0.0
21352204415	14	2.8238752750489997	3.0	5	9	0.5647750550098	0.5555555555555556
21352204416	6	3.2872859509955634	0.0	0	6	0.8218214877488909	0.0
21352204417	4	1.6906453492195128	0.5	1	3	0.8453226746097564	0.3333333333333333
21352204418	27	2.4357346179037287	3.0	3	24	0.10148894241265537	0.125
21352204419	1	0.10064114156281669	0.0	0	1	0.10064114156281669	0.0
21352204420	24	2.0266453387146806	4.0	4	20	0.10133226693573402	0.2
21352204421	3	0.8566744589851449	1.0	1	2	0.42833722949257247	0.5
21352204422	12	6.158362871720813	1.0	1	11	0.5598511701564376	0.09090909090909091
21352204423	19	2.7656715010331268	3.0	3	16	0.17285446881457042	0.1875
21352204424	12	2.8683160689894085	2.5	4	8	0.5736632137978817	0.5
21352204425	14	2.7900965828420334	3.0	5	9	0.5580193165684066	0.5555555555555556
21352204426	13	3.711855379974093	1.5	3	10	0.6186425633290155	0.3
21352204427	8	5.281957139139567	0.5	1	7	0.8803261898565945	0.14285714285714285
21352204428	12	3.1804667559599853	2.5	4	8	0.6360933511919971	0.5
21352204429	2	0.10209562313133091	1.0	1	1	0.10209562313133091	1.0
21352204430	1	0.10211077433172516	0.0	0	1	0.10211077433172516	0.0
21352204431	11	2.1945101679200807	2.5	4	7	0.5486275419800202	0.5714285714285714
21352204432	9	0.923080688862457	0.0	0	9	0.10256452098471744	0.0
21352204433	13	3.061239333849529	2.0	4	9	0.6122478667699058	0.4444444444444444
21352204434	13	2.894602458932082	2.5	4	9	0.5789204917864164	0.4444444444444444
21352204435	13	3.045474947540652	2.5	4	9	0.6090949895081305	0.4444444444444444
21352204436	13	4.308180197064592	2.0	4	9	0.8616360394129184	0.4444444444444444
21352204437	4	0.41211231403037857	0.0	0	4	0.10302807850759464	0.0
21352204438	12	1.4129036780616375	5.0	5	7	0.20184338258023393	0.7142857142857143
21352204439	4	0.4153036955427559	0.0	0	4	0.10382592388568898	0.0
21352204440	6	0.3160065664629122	3.0	3	3	0.10533552215430407	1.0
21352204441	2	0.10384905471829087	1.0	1	1	0.10384905471829087	1.0
21352204442	5	0.4155500540611665	1.0	1	4	0.10388751351529163	0.25
21352204443	2	0.20780066622858373	0.0	0	2	0.10390033311429187	0.0
21352204444	12	3.8702756915790673	2.0	2	10	0.4837844614473834	0.2
21352204445	17	1.3621222077642363	4.0	4	13	0.10477863136647972	0.3076923076923077
21352204446	10	1.9889894543268243	3.0	3	7	0.28414135061811774	0.42857142857142855
21352204447	9	1.4321651634375139	3.0	3	6	0.23869419390625232	0.5
21352204448	13	1.4750639355404638	6.0	6	7	0.2107234193629234	0.8571428571428571
21352204449	16	2.170004178701069	8.0	8	8	0.27125052233763364	1.0
21352204450	7	2.0607490410047706	2.0	2	5	0.41214980820095415	0.4
21352204451	6	1.1159595438707552	2.0	2	4	0.2789898859676888	0.5
21352204452	8	2.315615564484738	3.0	3	5	0.4631231128969476	0.6
21352204453	1	0.10421137042371881	0.0	0	1	0.10421137042371881	0.0
21352204454	2	0.10421480469580817	1.0	1	1	0.10421480469580817	1.0
21352204455	1	0.10421507405048185	0.0	0	1	0.10421507405048185	0.0
21352204456	2	0.10421652183185286	1.0	1	1	0.10421652183185286	1.0
21352204457	2	0.8634383925424849	0.0	0	2	0.43171919627124244	0.0
21352204458	6	1.989960309578754	2.0	2	4	0.4974900773946885	0.5
21352204459	7	0.4172904892851216	3.0	3	4	0.1043226223212804	0.75
21352204460	2	0.2087467745198694	0.0	0	2	0.1043733872599347	0.0
21352204461	1	0.10428237904956654	0.0	0	1	0.10428237904956654	0.0
21352204462	2	0.9618359443509203	0.0	0	2	0.4809179721754602	0.0
21352204463	3	2.0168459463316872	0.0	0	3	0.6722819821105624	0.0
21352204464	1	0.10431968467187062	0.0	0	1	0.10431968467187062	0.0
21352204465	2	0.20867206226725862	0.0	0	2	0.10433603113362931	0.0
21352204466	13	3.9699648327171113	3.5	4	9	0.4962456040896389	0.4444444444444444
21352204467	5	1.6161902966527597	1.0	1	4	0.4040475741631899	0.25
21352204468	4	0.6164701224893745	0.0	0	4	0.15411753062234362	0.0
21352204469	3	2.03734589082779	0.0	0	3	0.6791152969425966	0.0
21352204470	3	0.4518110852713935	0.0	0	3	0.1506036950904645	0.0
21352204471	2	0.6403415794358751	0.0	0	2	0.32017078971793755	0.0
21352204472	4	0.4194053275054858	0.0	0	4	0.10485133187637145	0.0
21352204473	6	1.0725750579524997	2.0	2	4	0.26814376448812494	0.5
21352204474	24	3.6692851195650245	7.0	7	17	0.2158403011508838	0.4117647058823529
21352204475	3	0.5514858496037305	0.0	0	3	0.18382861653457683	0.0
21352204476	1	0.1045635853288839	0.0	0	1	0.1045635853288839	0.0
21352204477	3	1.0112347834390107	0.0	0	3	0.5056173917195054	0.0
21352204478	2	0.34630536463266065	0.0	0	2	0.17315268231633033	0.0
21352204479	3	0.8702286218498424	1.0	1	2	0.4351143109249212	0.5
21352204480	2	0.20926541694403183	0.0	0	2	0.10463270847201592	0.0
21352204481	1	0.10463341552803432	0.0	0	1	0.10463341552803432	0.0
21352204482	3	0.7077542530513761	0.0	0	3	0.2359180843504587	0.0
21352204483	2	0.34680431049631055	0.0	0	2	0.17340215524815528	0.0
21352204484	3	0.3930730462602848	0.0	0	3	0.13102434875342825	0.0
21352204485	2	0.20938716525653323	0.0	0	2	0.10469358262826661	0.0
21352204486	1	0.10472758865581816	0.0	0	1	0.10472758865581816	0.0
21352204487	1	0.10473583764269948	0.0	0	1	0.10473583764269948	0.0
21352204488	2	0.34648862681876275	0.0	0	2	0.17324431340938137	0.0
21352204489	2	0.20961944999324422	0.0	0	2	0.10480972499662211	0.0
21352204490	3	0.6802396394660757	0.0	0	3	0.22674654648869189	0.0
21352204491	1	0.10481799081817054	0.0	0	1	0.10481799081817054	0.0
21352204492	1	0.10482623980505186	0.0	0	1	0.10482623980505186	0.0
21352204493	3	0.6327455082835485	0.0	0	3	0.2109151694278495	0.0
21352204494	3	1.0169454728836105	0.0	0	3	0.3389818242945368	0.0
21352204495	1	0.10488617121994469	0.0	0	1	0.10488617121994469	0.0
21352204496	2	0.34754968221703947	0.0	0	2	0.17377484110851973	0.0
21352204497	1	0.10490859499652819	0.0	0	1	0.10490859499652819	0.0
21352204498	5	1.1944206748297517	1.0	1	4	0.2986051687074379	0.25
21352204499	1	0.10494731473086906	0.0	0	1	0.10494731473086906	0.0
21352204500	2	0.20996570542625428	0.0	0	2	0.10498285271312714	0.0
21352204501	8	3.461866600279718	2.0	2	6	0.5769777667132864	0.3333333333333333
21352204502	4	0.7683506372948414	1.0	1	3	0.25611687909828046	0.3333333333333333
21352204503	2	0.8273969190606377	0.0	0	2	0.41369845953031886	0.0
21352204504	2	0.49307642329450596	0.0	0	2	0.24653821164725298	0.0
21352204505	3	0.7085578053816188	1.0	1	2	0.3542789026908094	0.5
21352204506	2	0.8655484160480572	0.0	0	2	0.4327742080240286	0.0
21352204507	6	1.0104511633546198	2.0	2	4	0.25261279083865495	0.5
21352204508	14	4.990424037318821	2.5	3	11	0.5544915597020912	0.2727272727272727
21352204509	2	0.3477971518234789	0.0	0	2	0.17389857591173946	0.0
21352204510	3	0.5755460231684749	0.0	0	3	0.19184867438949163	0.0
21352204511	4	0.8886038293413232	0.0	0	4	0.29620127644710775	0.0
21352204512	1	0.10512737833022122	0.0	0	1	0.10512737833022122	0.0
21352204513	1	0.10514165412792603	0.0	0	1	0.10514165412792603	0.0
21352204514	4	0.9396284259010511	0.0	0	4	0.23490710647526278	0.0
21352204515	3	0.5554329056531048	0.0	0	3	0.18514430188436826	0.0
21352204516	2	1.0655363826280106	0.0	0	2	0.5327681913140053	0.0
21352204517	4	0.3882501498201199	1.0	1	3	0.12941671660670664	0.3333333333333333
21352204518	1	0.1052259621407865	0.0	0	1	0.1052259621407865	0.0
21352204519	3	0.44832408700465715	1.0	1	2	0.22416204350232857	0.5
21352204520	3	1.8404846943078659	0.0	0	3	0.6134948981026219	0.0
21352204521	1	0.10526626433383522	0.0	0	1	0.10526626433383522	0.0
21352204522	1	0.1052861292410188	0.0	0	1	0.1052861292410188	0.0
21352204523	1	0.1052939741958896	0.0	0	1	0.1052939741958896	0.0
21352204524	2	0.3105735480175378	0.0	0	2	0.1552867740087689	0.0
21352204525	14	7.076119327756727	0.0	0	14	0.5054370948397662	0.0
21352204526	1	0.1053295963514832	0.0	0	1	0.1053295963514832	0.0
21352204527	2	0.21070639710952804	0.0	0	2	0.10535319855476402	0.0
21352204528	1	0.10534946125866679	0.0	0	1	0.10534946125866679	0.0
21352204529	3	0.7082154555913771	0.0	0	3	0.23607181853045903	0.0
21352204530	5	1.1014940194676763	1.0	1	4	0.2753735048669191	0.25
21352204531	1	0.10539198562777333	0.0	0	1	0.10539198562777333	0.0
21352204532	2	0.21081784260576136	0.0	0	2	0.10540892130288068	0.0
21352204533	1	0.10543413963420356	0.0	0	1	0.10543413963420356	0.0
21352204534	1	0.10547935755004685	0.0	0	1	0.10547935755004685	0.0
21352204535	2	0.34286718690052803	0.0	0	2	0.17143359345026402	0.0
21352204536	4	0.6790422569335849	0.0	0	4	0.16976056423339622	0.0
21352204537	2	0.21105325859055385	0.0	0	2	0.10552662929527692	0.0
21352204538	8	2.9053868140180388	0.5	1	7	0.48423113566967313	0.14285714285714285
21352204539	1	0.10557935547264893	0.0	0	1	0.10557935547264893	0.0
21352204540	2	0.2111844343166339	0.0	0	2	0.10559221715831694	0.0
21352204541	6	1.5983862220774738	0.0	0	6	0.39959655551936846	0.0
21352204542	2	0.3484642423421709	0.0	0	2	0.17423212117108544	0.0
21352204543	4	1.1899565251455886	1.0	1	3	0.3966521750485295	0.3333333333333333
21352204544	2	0.9709865286636975	0.0	0	2	0.48549326433184875	0.0
21352204545	5	2.7512264475852475	0.0	0	5	0.5502452895170495	0.0
21352204546	2	1.056692391272545	0.0	0	2	0.5283461956362725	0.0
21962501723	2	0.8470692713218718	0.0	0	2	0.8470692713218718	0.0
21962501724	36	2.3422818118559623	11.0	11	25	0.09369127247423849	0.44
21962501725	2	0.08465288785078101	1.0	1	1	0.08465288785078101	1.0
21962501726	2	0.1693929792771645	0.0	0	2	0.08469648963858226	0.0
21962501727	2	0.0847255126046708	1.0	1	1	0.0847255126046708	1.0
21962501728	5	0.2637323999026687	2.0	2	3	0.08791079996755624	0.6666666666666666
21962501729	4	1.3254657975623874	1.0	1	3	0.44182193252079577	0.3333333333333333
21962501730	9	0.6016659519228169	4.0	4	5	0.12033319038456339	0.8
21962501731	8	3.8757413356092907	2.0	2	6	0.6459568892682152	0.3333333333333333
21962501732	1	0.08501035517208279	0.0	0	1	0.08501035517208279	0.0
21962501733	2	0.08502156706037453	1.0	1	1	0.08502156706037453	1.0
21962501734	1	0.08504156664489496	0.0	0	1	0.08504156664489496	0.0
21962501735	4	0.44991553542473545	2.0	2	2	0.22495776771236772	1.0
21962501736	9	0.6027218222436255	4.0	4	5	0.1205443644487251	0.8
21962501737	4	0.17033117527491096	2.0	2	2	0.08516558763745548	1.0
21962501738	8	3.4832140355872068	2.0	2	6	0.5805356725978678	0.3333333333333333
21962501739	1	0.08527610722699801	0.0	0	1	0.08527610722699801	0.0
21966063248	1	0.7650760925269667	0.0	0	1	0.7650760925269667	0.0
21966063249	6	1.808686061976423	2.0	2	4	0.4521715154941057	0.5
21966063254	1	0.8158785388195807	0.0	0	1	0.8158785388195807	0.0
21966063255	3	0.47807622986418097	0.0	0	3	0.15935874328806032	0.0
21966063259	2	0.527864522141072	0.0	0	2	0.263932261070536	0.0
21966063262	4	0.778102353900594	2.0	2	2	0.389051176950297	1.0
21966063263	4	0.0	4.0	4	0	0.0	inf
21966063264	4	0.07821595086728333	2.0	2	2	0.03910797543364167	1.0
21966063269	4	1.2206575708511376	1.0	1	3	0.3051643927127844	0.3333333333333333
21966063271	3	2.478518981609035	0.0	0	3	0.8261729938696784	0.0
21966063274	1	0.12267782181090717	0.0	0	1	0.12267782181090717	0.0
21966063275	2	1.7654582731395783	0.0	0	2	0.8827291365697891	0.0
21966063276	1	0.4624998867868637	0.0	0	1	0.4624998867868637	0.0
21966063278	3	2.6027293641744884	0.0	0	3	0.8675764547248295	0.0
21966063279	2	1.4017642125077738	0.0	0	2	0.7008821062538869	0.0
21966063281	3	0.9525485615332503	0.0	0	3	0.3175161871777501	0.0
21966063283	1	0.0	1.0	1	0	0.0	inf
21966063284	1	0.0	1.0	1	0	0.0	inf
21966063285	16	7.429778276996737	0.0	0	16	0.571521405922826	0.0
21966063286	7	0.0	7.0	7	0	0.0	inf
21966063287	5	0.0	5.0	5	0	0.0	inf
21966063288	2	0.9620595760687396	1.0	1	1	0.4810297880343698	1.0
21966063289	7	0.0	7.0	7	0	0.0	inf
21966063290	5	0.0	5.0	5	0	0.0	inf
21966063291	5	0.0	5.0	5	0	0.0	inf
21966063292	4	0.4180248848028982	2.0	2	2	0.2090124424014491	1.0
21966063293	4	0.412548331908391	2.0	2	2	0.10313708297709775	1.0
21966063294	23	3.215928544514748	8.0	8	15	0.20099553403217174	0.5333333333333333
21966063295	1	0.0	1.0	1	0	0.0	inf
21966063296	1	0.0	1.0	1	0	0.0	inf
21966063297	7	0.24240637829173717	5.0	5	2	0.048481275658347436	2.5
21966063299	3	0.45301802989479983	1.0	1	2	0.22650901494739992	0.5
21966063300	1	0.0	1.0	1	0	0.0	inf
21966063301	6	0.0	6.0	6	0	0.0	inf
21966063302	2	0.0	2.0	2	0	0.0	inf
21966063303	1	0.0	1.0	1	0	0.0	inf
21966063304	1	0.0	1.0	1	0	0.0	inf
21966063305	1	0.0	1.0	1	0	0.0	inf
21966063306	6	0.12129091459615132	5.0	5	1	0.024258182919230264	5.0
21966063307	2	0.0	2.0	2	0	0.0	inf
21966063308	39	12.859818602421628	0.0	0	39	0.3297389385236315	0.0
21966063309	34	8.513044122955424	11.0	11	23	0.34052176491821695	0.4782608695652174
21966063310	8	0.027434547908550183	7.0	7	1	0.003429318488568773	7.0
21966063311	6	0.02611066968743444	5.0	5	1	0.004351778281239073	5.0
21966063312	4	0.7066486531239402	2.0	2	2	0.17666216328098505	1.0
21966063313	32	5.32135699403147	17.0	17	15	0.23136334756658566	1.1333333333333333
21966063314	3	0.12756034664195698	2.0	2	1	0.12756034664195698	2.0
21966063315	7	0.936730438966975	3.0	3	4	0.23418260974174376	0.75
21966063316	5	0.8616990010678902	2.0	2	3	0.2872330003559634	0.6666666666666666
21966063317	34	9.550734148048168	8.0	8	26	0.3673359287710834	0.3076923076923077
21966063318	21	6.7720447019669665	3.0	3	18	0.37622470566483146	0.16666666666666666
21966063319	21	3.033335065059423	13.0	13	8	0.16851861472552349	1.625
21966063320	4	0.0	4.0	4	0	0.0	inf
21966063321	13	1.3472297898727155	8.0	8	5	0.26944595797454307	1.6
21966063322	4	0.7411368255413684	2.0	2	2	0.3705684127706842	1.0
21966063323	31	8.190306585213367	9.0	9	22	0.37228666296424395	0.4090909090909091
21966063324	39	10.795952723810416	8.0	8	31	0.3373735226190755	0.25806451612903225
21966063325	21	7.285451746675835	3.0	3	18	0.4047473192597686	0.16666666666666666
21966063326	5	1.1366182056083212	2.0	2	3	0.3788727352027737	0.6666666666666666
21966063327	9	0.846705676181744	5.0	5	4	0.14111761269695733	1.25
21966063328	11	1.3882856036290425	5.0	5	6	0.23138093393817374	0.8333333333333334
21966063329	1	0.0	1.0	1	0	0.0	inf
21966063330	3	0.096056017960839	2.0	2	1	0.096056017960839	2.0
21966063331	10	1.1585549889418123	5.0	5	5	0.19309249815696872	1.0
21966063332	12	3.9829680642661396	0.0	0	12	0.44255200714068216	0.0
21966063333	3	0.0	3.0	3	0	0.0	inf
21966063334	2	0.8272380671418375	1.0	1	1	0.4136190335709187	1.0
21966063335	2	0.5747856685940228	1.0	1	1	0.2873928342970114	1.0
21966063337	1	0.4431214004746097	0.0	0	1	0.4431214004746097	0.0
21966063338	4	0.0	4.0	4	0	0.0	inf
21966063340	4	0.7064223278593842	2.0	2	2	0.3532111639296921	1.0
21966063341	2	0.0	2.0	2	0	0.0	inf
21966063342	2	0.0	2.0	2	0	0.0	inf
21966063343	8	3.495561321167166	0.0	0	8	0.4993659030238809	0.0
21966063344	9	4.69030451454931	0.0	0	9	0.5211449460610345	0.0
21966063345	2	0.0	2.0	2	0	0.0	inf
21966063346	1	0.9700080641422365	0.0	0	1	0.9700080641422365	0.0
21966063347	9	0.15375993704103857	8.0	8	1	0.019219992130129822	8.0
21966063348	4	0.0	4.0	4	0	0.0	inf
21966063349	2	0.0	2.0	2	0	0.0	inf
21966063350	4	0.0	4.0	4	0	0.0	inf
21966063351	4	0.0	4.0	4	0	0.0	inf
21966063352	2	0.0	2.0	2	0	0.0	inf
21966063353	4	0.0	4.0	4	0	0.0	inf
21966063354	2	0.0	2.0	2	0	0.0	inf
21966063355	4	0.0	4.0	4	0	0.0	inf
21966063356	4	0.0	4.0	4	0	0.0	inf
21966063357	4	0.0	4.0	4	0	0.0	inf
21966063358	4	0.0	4.0	4	0	0.0	inf
21966063359	2	0.0	2.0	2	0	0.0	inf
21966063360	3	0.0	3.0	3	0	0.0	inf
21966063361	5	0.6597586171357989	4.0	4	1	0.16493965428394972	4.0
21966063362	4	0.15347034709750307	3.0	3	1	0.051156782365834354	3.0
21966063363	4	0.0	4.0	4	0	0.0	inf
21966063364	5	0.3582690218186376	4.0	4	1	0.07165380436372752	4.0
21966063365	8	1.2918888520060037	6.0	6	2	0.21531480866766728	3.0
21966063366	2	0.0	2.0	2	0	0.0	inf
21966063368	12	0.38094599179538935	8.0	8	4	0.04761824897442367	2.0
21966063370	3	0.0	3.0	3	0	0.0	inf
21966063371	4	0.0	4.0	4	0	0.0	inf
21966063372	4	0.0	4.0	4	0	0.0	inf
21966063373	4	0.0	4.0	4	0	0.0	inf
21966063374	4	0.0	4.0	4	0	0.0	inf
21966063375	2	0.0	2.0	2	0	0.0	inf
21966063376	6	0.0	6.0	6	0	0.0	inf
21966063377	2	0.0	2.0	2	0	0.0	inf
21966063378	6	0.8676762843007605	5.0	5	1	0.14461271405012674	5.0
21966063379	4	0.0	4.0	4	0	0.0	inf
21966063380	4	0.0	4.0	4	0	0.0	inf
21966063381	4	0.0	4.0	4	0	0.0	inf
21966063382	2	0.0	2.0	2	0	0.0	inf
21966063383	2	0.0	2.0	2	0	0.0	inf
21966063384	4	0.31529631185776374	3.0	3	1	0.07882407796444094	3.0
21966063385	7	0.7994837278969659	4.5	5	2	0.15989674557939318	2.5
21966063386	7	0.8337508274659748	5.0	5	2	0.16675016549319496	2.5
21966063387	5	0.0	5.0	5	0	0.0	inf
21966063388	3	0.0	3.0	3	0	0.0	inf
21966063389	5	0.9077311760897089	4.0	4	1	0.18154623521794178	4.0
21966063390	4	0.0	4.0	4	0	0.0	inf
21966063391	12	4.672140986162004	0.0	0	12	0.389345082180167	0.0
21966063392	2	0.0	2.0	2	0	0.0	inf
21966063393	2	0.0	2.0	2	0	0.0	inf
21966063394	4	0.0	4.0	4	0	0.0	inf
21966063395	11	1.9296285326328406	5.0	5	6	0.3216047554388068	0.8333333333333334
21966063397	4	0.0	4.0	4	0	0.0	inf
21966063399	1	0.0	1.0	1	0	0.0	inf
21966063400	2	0.0	2.0	2	0	0.0	inf
21966063401	4	0.0	4.0	4	0	0.0	inf
21966063402	28	7.53444630460034	9.0	9	19	0.396549805505281	0.47368421052631576
21966063403	3	0.0	3.0	3	0	0.0	inf
21966063404	2	0.0	2.0	2	0	0.0	inf
21966063405	9	3.5887233588446996	2.0	2	7	0.5126747655492429	0.2857142857142857
21966063406	8	1.4274021984122418	1.0	2	6	0.4758007328040806	0.3333333333333333
21966063407	1	0.7794264678070493	0.0	0	1	0.7794264678070493	0.0
21966063408	6	3.971277734735275	1.0	1	5	0.794255546947055	0.2
21966063409	6	2.903794995235284	0.5	1	5	0.725948748808821	0.2
21966063410	3	1.4434146940449084	1.0	1	2	0.7217073470224542	0.5
21966063411	1	0.7794516187997037	0.0	0	1	0.7794516187997037	0.0
21966063412	5	4.046590614599016	0.0	0	5	0.8093181229198032	0.0
21966063413	2	0.0	2.0	2	0	0.0	inf
21966063415	9	0.9728447728880515	4.0	4	5	0.1945689545776103	0.8
21966063416	4	0.0	4.0	4	0	0.0	inf
21966063418	11	3.7495439236161325	2.0	2	9	0.4166159915129036	0.2222222222222222
21966063419	3	0.0	3.0	3	0	0.0	inf
21966063420	1	0.0	1.0	1	0	0.0	inf
21966063421	11	1.2203605399847417	6.0	6	5	0.17433721999782023	1.2
21966063422	16	1.970465630394143	8.0	8	8	0.24630820379926788	1.0
21966063423	15	3.365979029997929	8.0	8	7	0.4207473787497411	1.1428571428571428
21966063424	2	0.9475881258628398	0.0	0	2	0.9475881258628398	0.0
21966063425	6	0.5120745471381958	3.0	3	3	0.17069151571273192	1.0
21966063426	2	0.9475959708177106	1.0	1	1	0.4737979854088553	1.0
21966063428	1	0.19448326612204722	0.0	0	1	0.19448326612204722	0.0
21966063430	4	0.20446817653653457	2.0	2	2	0.10223408826826728	1.0
21966063431	2	0.0	2.0	2	0	0.0	inf
21966063434	5	0.0	5.0	5	0	0.0	inf
21966063437	4	0.0	4.0	4	0	0.0	inf
21966063438	10	2.014847536669019	5.0	5	5	0.4029695073338038	1.0
21966063439	2	0.7680307786198516	1.0	1	1	0.7680307786198516	1.0
21966063440	2	0.0	2.0	2	0	0.0	inf
21966063443	4	0.0	4.0	4	0	0.0	inf
21966063444	1	0.8755148419980635	0.0	0	1	0.8755148419980635	0.0
21966063446	2	0.8156384764666673	1.0	1	1	0.40781923823333366	1.0
21966063447	4	0.0	4.0	4	0	0.0	inf
21966063448	20	7.613990982072863	2.0	2	18	0.422999499004048	0.1111111111111111
21966063449	1	0.4204670562904468	0.0	0	1	0.4204670562904468	0.0
21966063450	4	0.0	4.0	4	0	0.0	inf
21966063451	1	0.0	1.0	1	0	0.0	inf
21966063452	2	0.0	2.0	2	0	0.0	inf
21966063455	5	0.0	5.0	5	0	0.0	inf
21966063457	1	0.0	1.0	1	0	0.0	inf
21966063458	5	0.0	5.0	5	0	0.0	inf
21966063459	1	0.42472956033202947	0.0	0	1	0.42472956033202947	0.0
21966063460	4	0.0	4.0	4	0	0.0	inf
21966063461	9	1.3101433549343438	5.0	6	3	0.2620286709868688	2.0
21966063462	2	0.1288510268995422	1.0	1	1	0.1288510268995422	1.0
21966063463	3	0.21793547251897158	0.5	1	2	0.21793547251897158	0.5
21966063465	4	0.0	4.0	4	0	0.0	inf
21966063467	1	0.0	1.0	1	0	0.0	inf
21966063468	4	0.0	4.0	4	0	0.0	inf
21966063469	4	0.0	4.0	4	0	0.0	inf
21966063470	1	0.0	1.0	1	0	0.0	inf
21966063472	14	4.084864263930948	7.0	7	7	0.37135129672099526	1.0
21966063474	1	0.0	1.0	1	0	0.0	inf
21966063475	2	0.0	2.0	2	0	0.0	inf
21966063476	4	0.0	4.0	4	0	0.0	inf
21966063477	4	0.4707620720471901	2.0	2	2	0.23538103602359506	1.0
21966063478	2	0.0	2.0	2	0	0.0	inf
21966063479	2	0.0	2.0	2	0	0.0	inf
21966063480	8	6.525617935815946	0.0	0	8	0.8157022419769933	0.0
21966063482	5	0.8754433283322026	4.0	4	1	0.17508866566644052	4.0
21966063484	3	0.36858136650831197	1.0	1	2	0.12286045550277065	0.5
21966063485	2	0.0	2.0	2	0	0.0	inf
21966063486	14	0.5782661350099225	7.0	7	7	0.07228326687624032	1.0
21966063487	6	0.5108016106197389	2.0	2	4	0.1021603221239478	0.5
21966063488	8	1.7852679289457185	3.0	3	5	0.3570535857891437	0.6
21966063489	11	1.2271738327860326	5.0	5	6	0.1753105475408618	0.8333333333333334
21966063490	11	1.2925330473774332	5.0	5	6	0.18464757819677619	0.8333333333333334
21966063492	2	0.5201932336961216	1.0	1	1	0.5201932336961216	1.0
21966063493	4	1.7038859159053834	1.0	1	3	0.5679619719684611	0.3333333333333333
21966063494	2	0.1637305379884869	1.0	1	1	0.1637305379884869	1.0
21966063496	1	0.0	1.0	1	0	0.0	inf
21966063498	2	0.0	2.0	2	0	0.0	inf
21966063500	2	0.6450128291947606	0.0	0	2	0.3225064145973803	0.0
21966063501	5	0.0	5.0	5	0	0.0	inf
21991672472	10	2.2828370871891313	3.5	4	6	0.45656741743782625	0.6666666666666666
21991672473	3	1.1402027439362623	0.0	0	3	0.38006758131208745	0.0
21991672474	4	0.7601831975409804	2.0	2	2	0.3800915987704902	1.0
21991672475	28	7.24159087334785	7.0	8	20	0.4023106040748805	0.4
21991672476	10	2.0929036592068107	5.0	5	5	0.41858073184136213	1.0
21991672477	3	1.1409433346115334	0.0	0	3	0.38031444487051114	0.0
21991672478	20	5.493857821202838	3.0	4	16	0.4578214851002365	0.25
21991672479	2	0.38047755034853314	1.0	1	1	0.38047755034853314	1.0
21991672480	3	0.38451834182434663	0.5	1	2	0.38451834182434663	0.5
21991672481	2	0.38050876182134535	1.0	1	1	0.38050876182134535	1.0
21991672482	1	0.3805199737096371	0.0	0	1	0.3805199737096371	0.0
21991672483	2	0.3805403436568338	1.0	1	1	0.3805403436568338	1.0
21991672484	17	3.6409367522566956	5.0	6	11	0.45511709403208694	0.5454545454545454
21991672485	11	2.4751134294617514	5.0	5	6	0.4125189049102919	0.8333333333333334
21991672486	3	1.1418742580330907	0.0	0	3	0.3806247526776969	0.0
21991672487	1	0.3806476814942935	0.0	0	1	0.3806476814942935	0.0
21991672488	25	8.38168459597994	1.5	2	23	0.41908422979899707	0.08695652173913043
21991672489	3	0.4284116387211754	0.5	1	2	0.4284116387211754	0.5
21991672490	12	3.386538299860909	5.0	5	7	0.48379118569441554	0.7142857142857143
21991672491	4	1.3778117471431655	0.0	0	4	0.45927058238105517	0.0
21991672492	3	1.0205258362141096	0.0	0	3	0.5102629181070548	0.0
21991672493	9	2.8992490964076607	0.5	1	8	0.5798498192815321	0.125
21991672494	42	11.112585472550958	3.5	7	35	0.505117521479589	0.2
21991672495	20	7.155019675180485	0.0	0	20	0.5110728339414632	0.0
21991672496	4	0.48971642575640767	1.0	2	2	0.48971642575640767	1.0
21991672497	7	2.287804324065052	1.0	1	6	0.3813007206775087	0.16666666666666666
21991672498	5	1.8289196483695944	0.0	0	5	0.4572299120923986	0.0
21991672499	6	1.5405902173682116	2.0	2	4	0.3851475543420529	0.5
21991672500	44	11.26019412323993	15.0	15	29	0.3882825559737907	0.5172413793103449
21991672501	13	3.3812277704533886	6.0	6	7	0.4830325386361984	0.8571428571428571
21991672502	3	0.7652244732828277	1.0	1	2	0.38261223664141386	0.5
21991672503	2	0.38280100376365916	1.0	1	1	0.38280100376365916	1.0
21991672504	11	3.536465723927553	4.0	4	7	0.5052093891325076	0.5714285714285714
22299848488	3	0.3910582059625226	0.5	1	2	0.3910582059625226	0.5
22299848489	2	0.3661183873722219	1.0	1	1	0.3661183873722219	1.0
22299848490	1	0.3661201045082666	0.0	0	1	0.3661201045082666	0.0
22299848491	12	3.517329656821607	3.0	3	9	0.3908144063135119	0.3333333333333333
22299848492	9	2.027484041829838	4.0	4	5	0.40549680836596763	0.8
22299848493	4	0.7324536725954212	2.0	2	2	0.3662268362977106	1.0
22299848494	31	7.916362242575634	10.0	10	21	0.3769696305988397	0.47619047619047616
22299848495	2	0.8611883382759354	0.0	0	2	0.8611883382759354	0.0
22299848496	7	2.4891062700818636	2.0	2	5	0.4978212540163727	0.4
22299848497	7	2.1699044501331404	3.0	3	4	0.5424761125332851	0.75
22299848498	3	1.4375347825265719	0.0	0	3	0.7187673912632859	0.0
22299848499	6	2.904428955129114	1.0	1	5	0.5808857910258227	0.2
22299848500	1	0.3663583150477985	0.0	0	1	0.3663583150477985	0.0
22299848501	3	0.8933773328682026	1.0	1	2	0.4466886664341013	0.5
22299848502	11	2.3965721318180027	5.0	5	6	0.3994286886363338	0.8333333333333334
22299848503	3	1.0993275661579691	0.0	0	3	0.36644252205265637	0.0
22299848504	3	0.773544031088647	1.0	1	2	0.3867720155443235	0.5
22299848505	2	0.3666299929055346	1.0	1	1	0.3666299929055346	1.0
22299848506	1	0.36664120479382634	0.0	0	1	0.36664120479382634	0.0
22299848507	2	0.36664271991386577	1.0	1	1	0.36664271991386577	1.0
22299848508	1	0.3666739313866779	0.0	0	1	0.3666739313866779	0.0
22299848509	8	1.833791028651021	3.0	3	5	0.36675820573020423	0.6
22299848510	3	1.1002786575107177	0.0	0	3	0.36675955250357256	0.0
22299848511	3	0.7335736493285645	1.0	1	2	0.36678682466428225	0.5
22299848512	22	5.591899117786005	7.0	7	15	0.37279327451906696	0.4666666666666667
22299848513	1	0.36691685563299914	0.0	0	1	0.36691685563299914	0.0
22299848514	10	3.1603415848229686	2.0	2	8	0.39504269810287107	0.25
22299848515	11	2.920135598529822	5.0	5	6	0.48668926642163696	0.8333333333333334
22299848516	3	1.1009944002173424	0.0	0	3	0.3669981334057808	0.0
22299848517	1	0.36711015128069563	0.0	0	1	0.36711015128069563	0.0
22299848518	3	0.734238281985859	1.0	1	2	0.3671191409929295	0.5
22299848519	30	7.565088765664362	10.0	10	20	0.37825443828321814	0.5
22299848520	2	0.7344143726037745	0.0	0	2	0.36720718630188726	0.0
22299848521	3	0.7344913407017774	1.0	1	2	0.3672456703508887	0.5
22299848522	31	7.9370485805059205	10.0	10	21	0.3779546943098057	0.47619047619047616
22299848523	3	0.616475980953527	0.5	1	2	0.616475980953527	0.5
22299848524	2	1.310804553319549	0.0	0	2	0.6554022766597745	0.0
22299848525	3	0.5127375636674484	0.5	1	2	0.5127375636674484	0.5
22299848526	3	0.6034410328916736	0.5	1	2	0.6034410328916736	0.5
22299848527	1	0.3673754319649319	0.0	0	1	0.3673754319649319	0.0
22299848528	13	4.327042229459408	5.0	5	8	0.540880278682426	0.625
22299848529	2	0.7349211970916294	0.0	0	2	0.3674605985458147	0.0
22299848530	3	0.7737352729069569	1.0	1	2	0.38686763645347844	0.5
22299848531	27	6.2936080418800735	10.0	10	17	0.3702122377576514	0.5882352941176471
22299848532	2	0.3676022959388352	1.0	1	1	0.3676022959388352	1.0
22299848533	2	0.903796409347321	0.0	0	2	0.4518982046736605	0.0
22299848534	10	3.7011163438119823	4.0	4	6	0.6168527239686638	0.6666666666666666
22299848535	1	0.367795322231858	0.0	0	1	0.367795322231858	0.0
22299848536	1	0.3678095980295628	0.0	0	1	0.3678095980295628	0.0
22299848537	8	6.065378944821247	0.0	0	8	0.7581723681026559	0.0
22299848538	2	0.36784747603054846	1.0	1	1	0.36784747603054846	1.0
22299848539	1	0.36784774538522214	0.0	0	1	0.36784774538522214	0.0
22299848540	2	0.3678480147398958	1.0	1	1	0.3678480147398958	1.0
22299848541	3	1.2533023808899322	0.0	0	3	0.4177674602966441	0.0
22299848542	3	1.4945416117112988	0.0	0	3	0.4981805372370996	0.0
22299848543	7	4.358195353315387	0.0	0	7	0.6225993361879124	0.0
22299848544	2	0.7359826228525825	0.0	0	2	0.36799131142629127	0.0
22299848545	3	1.6899723665673343	0.0	0	3	0.5633241221891114	0.0
22299848546	2	0.7385636466744108	0.0	0	2	0.3692818233372054	0.0
22299848547	2	1.2608141440293985	0.0	0	2	0.6304070720146993	0.0
22299848548	2	0.7385286979055015	0.0	0	2	0.36926434895275073	0.0
22299848549	3	0.7362877680285228	1.0	1	2	0.3681438840142614	0.5
22299848550	2	0.7390799322451787	0.0	0	2	0.3695399661225893	0.0
22299848551	5	1.7188107573657478	0.5	1	4	0.5729369191219159	0.25
22299848552	1	0.3695870358518141	0.0	0	1	0.3695870358518141	0.0
22299848553	2	0.7392730258768698	0.0	0	2	0.3696365129384349	0.0
22299848554	3	1.9532226216041235	0.0	0	3	0.6510742072013745	0.0
22299848555	3	1.5270619798908553	0.0	0	3	0.5090206599636184	0.0
22299848556	1	0.36962595760216027	0.0	0	1	0.36962595760216027	0.0
22299848557	3	1.647349076956886	0.0	0	3	0.5491163589856286	0.0
22299848558	1	0.3696951480839607	0.0	0	1	0.3696951480839607	0.0
22299848559	4	2.1888810592722705	0.0	0	4	0.7296270197574235	0.0
22299848560	2	0.7394925162665813	0.0	0	2	0.36974625813329065	0.0
22299848561	1	0.36977023069924775	0.0	0	1	0.36977023069924775	0.0
22299848562	1	0.3697993883426732	0.0	0	1	0.3697993883426732	0.0
22299848563	2	0.7397986378532136	0.0	0	2	0.3698993189266068	0.0
22299848564	1	0.36986070020026857	0.0	0	1	0.36986070020026857	0.0
22299848565	2	1.1341786266595069	0.0	0	2	0.5670893133297534	0.0
22299848566	1	0.3698846727662257	0.0	0	1	0.3698846727662257	0.0
22299848567	1	0.36989628868652796	0.0	0	1	0.36989628868652796	0.0
22299848568	2	0.739872979743148	0.0	0	2	0.369936489871574	0.0
22299848569	1	0.36997642170194645	0.0	0	1	0.36997642170194645	0.0
22299848570	2	0.9918008100639795	0.0	0	2	0.49590040503198973	0.0
22299848571	10	3.053049908020429	4.0	4	6	0.5088416513367382	0.6666666666666666
22299848572	1	0.37002988860467106	0.0	0	1	0.37002988860467106	0.0
22299848573	2	0.7401692698841913	0.0	0	2	0.37008463494209565	0.0
22299848574	1	0.37014301756761486	0.0	0	1	0.37014301756761486	0.0
22299848575	1	0.37020752801196016	0.0	0	1	0.37020752801196016	0.0
22299848576	1	0.3702191439322624	0.0	0	1	0.3702191439322624	0.0
22299848577	3	2.2877376924526516	0.0	0	3	0.7625792308175505	0.0
22299848578	1	0.37025517011986653	0.0	0	1	0.37025517011986653	0.0
22299848579	1	0.37026910922422923	0.0	0	1	0.37026910922422923	0.0
22299848580	2	0.7406759260253752	0.0	0	2	0.3703379630126876	0.0
22299848581	1	0.37033924244738753	0.0	0	1	0.37033924244738753	0.0
22299848582	1	0.370392844027449	0.0	0	1	0.370392844027449	0.0
22299848583	10	4.888001821645658	3.0	3	7	0.6982859745208083	0.42857142857142855
22299848584	2	0.7409650445982318	0.0	0	2	0.3704825222991159	0.0
22299848585	2	1.1756957776331718	0.0	0	2	0.5878478888165859	0.0
22299848586	1	0.37051058568917944	0.0	0	1	0.37051058568917944	0.0
22299848587	2	1.0402725303652782	0.0	0	2	0.5201362651826391	0.0
22299848588	2	0.7411538285551442	0.0	0	2	0.3705769142775721	0.0
22299848589	2	0.7411956121988981	0.0	0	2	0.37059780609944903	0.0
22299848590	1	0.37061432090787877	0.0	0	1	0.37061432090787877	0.0
22299848591	1	0.3706225698947601	0.0	0	1	0.3706225698947601	0.0
22299848592	2	0.7413037581003789	0.0	0	2	0.3706518790501894	0.0
22299848593	2	1.0644942493955596	0.0	0	2	0.5322471246977798	0.0
22299848594	3	0.8269410026061075	1.0	1	2	0.41347050130305374	0.5
22299848595	2	0.7415319015089821	0.0	0	2	0.37076595075449104	0.0
22299848596	2	1.2382738715495372	0.0	0	2	0.6191369357747686	0.0
22299848597	1	0.37083098307351664	0.0	0	1	0.37083098307351664	0.0
22299848598	5	2.0020703273605394	1.0	1	4	0.5005175818401348	0.25
22299848599	10	4.167101276044198	0.5	1	9	0.5953001822920283	0.1111111111111111
22299848600	2	0.7420373455541345	0.0	0	2	0.37101867277706724	0.0
22299848601	2	1.352618634151607	0.0	0	2	0.6763093170758036	0.0
22299848602	1	0.37103855451891793	0.0	0	1	0.37103855451891793	0.0
22299848603	4	1.8879486577669415	1.0	1	3	0.6293162192556472	0.3333333333333333
22299848604	2	0.37105427809799374	1.0	1	1	0.37105427809799374	1.0
22299848605	3	1.6323226214458777	0.0	0	3	0.5441075404819592	0.0
22299848606	1	0.37108892384289527	0.0	0	1	0.37108892384289527	0.0
22299848607	1	0.37109757686178707	0.0	0	1	0.37109757686178707	0.0
22299848608	2	0.7441660218708588	0.0	0	2	0.3720830109354294	0.0
22299848609	1	0.37113383873473066	0.0	0	1	0.37113383873473066	0.0
22299848610	4	0.7423623893065925	2.0	2	2	0.37118119465329624	1.0
22299848611	11	3.3727670707985626	2.0	2	9	0.37475189675539583	0.2222222222222222
22299848612	3	2.0840406783468506	0.0	0	3	0.6946802261156169	0.0
22299848613	2	0.7450017620846059	0.0	0	2	0.37250088104230294	0.0
22299848614	2	0.7450098427248162	0.0	0	2	0.3725049213624081	0.0
22299848615	2	1.28276452977391	0.0	0	2	0.641382264886955	0.0
22299848616	3	2.3359926832496445	0.0	0	3	0.7786642277498815	0.0
22299848617	1	0.37255323685699865	0.0	0	1	0.37255323685699865	0.0
22299848618	2	0.7452487266510321	0.0	0	2	0.3726243633255161	0.0
22299848619	2	1.2828026097909009	0.0	0	2	0.6414013048954504	0.0
22299848620	1	0.3726225956854701	0.0	0	1	0.3726225956854701	0.0
22299848621	1	0.37263421160577237	0.0	0	1	0.37263421160577237	0.0
22299848622	2	1.2829337181783127	0.0	0	2	0.6414668590891563	0.0
22299848623	1	0.3726913147965916	0.0	0	1	0.3726913147965916	0.0
22299848624	1	0.37270293071689387	0.0	0	1	0.37270293071689387	0.0
22299848625	4	2.5224470925974365	0.0	0	4	0.6306117731493591	0.0
22299848626	4	2.152228117011845	0.0	0	4	0.5380570292529613	0.0
22299848627	2	1.2807185790113382	0.0	0	2	0.6403592895056691	0.0
22299848628	1	0.37277484841476527	0.0	0	1	0.37277484841476527	0.0
22299848629	1	0.37278309740164656	0.0	0	1	0.37278309740164656	0.0
22299848630	2	1.3331391398367245	0.0	0	2	0.6665695699183622	0.0
22299848631	1	0.3728412106724921	0.0	0	1	0.3728412106724921	0.0
22299848632	2	0.7457537329948398	0.0	0	2	0.3728768664974199	0.0
22299848633	4	1.6180228848444462	0.0	0	4	0.40450572121111156	0.0
22299848634	3	1.2076676386891223	0.0	0	3	0.4025558795630408	0.0
22299848635	1	0.37294218500578624	0.0	0	1	0.37294218500578624	0.0
22299848636	4	2.085888215722926	0.0	0	4	0.695296071907642	0.0
22299848637	2	1.2403987432314958	0.0	0	2	0.6201993716157479	0.0
22299848638	1	0.3730101297222209	0.0	0	1	0.3730101297222209	0.0
22299848639	4	2.1909564370329413	0.0	0	4	0.7303188123443137	0.0
22299848640	2	0.7462237569004038	0.0	0	2	0.3731118784502019	0.0
22299848641	1	0.37308703048155534	0.0	0	1	0.37308703048155534	0.0
22299848642	1	0.3731119121195361	0.0	0	1	0.3731119121195361	0.0
22299848643	1	0.37312716432793297	0.0	0	1	0.37312716432793297	0.0
22299848644	2	1.2833571437253308	0.0	0	2	0.6416785718626654	0.0
22299848645	2	0.7465023033023186	0.0	0	2	0.3732511516511593	0.0
22299848646	2	0.746438870276668	0.0	0	2	0.373219435138334	0.0
22299848647	2	1.2838121847771715	0.0	0	2	0.6419060923885858	0.0
22299848648	1	0.37320813907670675	0.0	0	1	0.37320813907670675	0.0
22299848649	4	1.4128879881518959	1.0	1	3	0.47096266271729864	0.3333333333333333
22299848650	1	0.3732661513395496	0.0	0	1	0.3732661513395496	0.0
22299848651	3	2.1892488630791744	0.0	0	3	0.7297496210263915	0.0
22299848652	1	0.37331726138887955	0.0	0	1	0.37331726138887955	0.0
22299848653	1	0.37336712567284375	0.0	0	1	0.37336712567284375	0.0
22299848654	1	0.3733749706277146	0.0	0	1	0.3733749706277146	0.0
22299848655	2	1.0954545826438555	0.0	0	2	0.5477272913219278	0.0
22299848656	1	0.373417158303479	0.0	0	1	0.373417158303479	0.0
22299848657	1	0.3734322758345391	0.0	0	1	0.3734322758345391	0.0
22299848658	4	1.866311632515917	1.0	1	3	0.6221038775053057	0.3333333333333333
22299848659	4	1.1791891057347395	1.0	1	3	0.39306303524491315	0.3333333333333333
22299848660	2	1.0957616133025114	0.0	0	2	0.5478808066512557	0.0
22299848661	2	1.335782721281514	0.0	0	2	0.667891360640757	0.0
22299848662	2	0.7472178103236038	0.0	0	2	0.3736089051618019	0.0
22299848663	8	2.5236684140265506	2.0	2	6	0.42061140233775846	0.3333333333333333
22299848664	5	4.129317414517012	0.0	0	5	0.8258634829034024	0.0
22299848665	3	1.2448224223759392	0.0	0	3	0.4149408074586464	0.0
22299848666	1	0.37369099099860453	0.0	0	1	0.37369099099860453	0.0
22299848667	2	0.7474328226918653	0.0	0	2	0.37371641134593264	0.0
22299848668	3	0.7535813144891905	1.0	1	2	0.37679065724459526	0.5
22299848669	2	0.6142331319244984	0.0	0	2	0.6142331319244984	0.0
22299848670	2	0.3767870882951691	1.0	1	1	0.3767870882951691	1.0
22299848671	1	0.3767873576498428	0.0	0	1	0.3767873576498428	0.0
22299848672	2	0.8536031423185586	0.0	0	2	0.4268015711592793	0.0
22299848673	4	1.507525584401159	0.0	0	4	0.37688139610028976	0.0
22299848674	2	0.7537523883763089	0.0	0	2	0.37687619418815443	0.0
22299848675	2	0.37691196785575193	1.0	1	1	0.37691196785575193	1.0
22299848676	10	3.961692917019199	2.0	2	8	0.4952116146273999	0.25
22299848677	4	1.9809021812577159	0.0	0	4	0.49522554531442897	0.0
22299848678	20	13.452611236998882	1.0	1	19	0.7080321703683622	0.05263157894736842
22299848679	5	1.885788500622731	0.0	0	5	0.3771577001245462	0.0
22299848680	1	0.37714627275251555	0.0	0	1	0.37714627275251555	0.0
22299848681	2	0.37718115418275655	1.0	1	1	0.37718115418275655	1.0
22299848682	4	2.990139800799424	0.0	0	4	0.747534950199856	0.0
22299848683	18	12.747286159072049	0.0	0	18	0.7081825643928916	0.0
22299848684	4	1.215128392787261	1.0	1	3	0.4050427975957536	0.3333333333333333
22299848685	2	0.37754256081616083	1.0	1	1	0.37754256081616083	1.0
22299848686	1	0.3775392275520741	0.0	0	1	0.3775392275520741	0.0
22299848687	20	5.1758492424585	4.0	5	15	0.39814224941988463	0.3333333333333333
22299848688	2	0.37776592317930635	1.0	1	1	0.37776592317930635	1.0
22299848689	2	0.9781317000922911	0.0	0	2	0.48906585004614556	0.0
22299848690	1	0.3777975050147948	0.0	0	1	0.3777975050147948	0.0
22299848691	2	1.1191209596756861	0.0	0	2	0.5595604798378431	0.0
22299848692	4	2.3027183576691352	1.0	1	3	0.7675727858897118	0.3333333333333333
22299848693	2	0.7557818411651178	0.0	0	2	0.3778909205825589	0.0
22299848694	5	1.3134729490636508	2.0	2	3	0.43782431635455027	0.6666666666666666
22299848695	15	3.874867313362547	3.0	4	11	0.3874867313362547	0.36363636363636365
22299848696	18	3.7671419418660563	4.0	6	12	0.47089274273325704	0.5
22299848697	10	2.0801193793381465	5.0	5	5	0.4160238758676293	1.0
22299848698	3	1.1343279164873914	0.0	0	3	0.37810930549579713	0.0
22299848699	35	8.7485844822685	8.0	10	25	0.41659926106040474	0.4
22299848700	2	0.3782490444558778	1.0	1	1	0.3782490444558778	1.0
22299848701	9	2.081307233449056	4.0	4	5	0.4162614466898112	0.8
22299848702	4	1.371063301479562	0.0	0	4	0.4570211004931873	0.0
22299848703	4	0.7567906754260357	2.0	2	2	0.37839533771301787	1.0
22299848704	33	8.256009765723048	7.0	9	24	0.4128004882861524	0.375
22299848705	1	0.3785182981215508	0.0	0	1	0.3785182981215508	0.0
22299848706	2	0.37852951000984253	1.0	1	1	0.37852951000984253	1.0
22299848707	2	0.3785525398344418	1.0	1	1	0.3785525398344418	1.0
22299848708	3	0.9156706071123034	1.0	1	2	0.4578353035561517	0.5
22299848709	1	0.37856762369616764	0.0	0	1	0.37856762369616764	0.0
22299848710	9	1.8932183126027313	4.0	4	5	0.37864366252054626	0.8
22299848711	3	1.135938388081298	0.0	0	3	0.3786461293604327	0.0
22299848712	23	6.169776607671145	3.0	5	18	0.38561103797944657	0.2777777777777778
22299848713	20	4.823723258005044	3.0	5	15	0.48237232580050443	0.3333333333333333
22299848714	6	1.327596931740509	3.0	3	3	0.4425323105801697	1.0
22299848715	3	0.7577545274564499	1.0	1	2	0.37887726372822494	0.5
22299848716	3	1.136603862471948	0.0	0	3	0.37886795415731594	0.0
22299848717	21	5.202240748062573	7.0	7	14	0.4001723652355826	0.5
22299848718	10	1.9220718882708732	3.0	4	6	0.38441437765417463	0.6666666666666666
22299848719	4	1.3730577718301273	0.0	0	4	0.45768592394337576	0.0
22299848720	3	0.7582723954859254	1.0	1	2	0.3791361977429627	0.5
22299848721	25	7.363924628232471	6.0	6	19	0.387574980433288	0.3157894736842105
22299848722	1	0.3792451853777987	0.0	0	1	0.3792451853777987	0.0
22299848723	1	0.37925639726609045	0.0	0	1	0.37925639726609045	0.0
22299848724	2	0.3792763968506109	1.0	1	1	0.3792763968506109	1.0
22299848725	2	0.37929094200298935	1.0	1	1	0.37929094200298935	1.0
22299848726	2	0.379291211357663	1.0	1	1	0.379291211357663	1.0
22299848727	10	2.467330695520568	4.0	4	6	0.4112217825867613	0.6666666666666666
22299848728	2	0.37940373427259105	1.0	1	1	0.37940373427259105	1.0
22299848729	32	7.548618232409112	8.0	10	22	0.41936767957828397	0.45454545454545453
22299848730	1	0.37954016241480776	0.0	0	1	0.37954016241480776	0.0
22299848731	11	2.468915309065802	5.0	5	6	0.4114858848443003	0.8333333333333334
22299848732	4	1.3744356893326493	0.0	0	4	0.45814522977754973	0.0
22299848733	3	0.7593232154066025	1.0	1	2	0.37966160770330126	0.5
22299848734	36	7.870953219591363	8.0	11	25	0.4919345762244602	0.44
22299848735	3	0.7595578569967082	1.0	1	2	0.3797789284983541	0.5
22299848736	1	0.3797799890823817	0.0	0	1	0.3797799890823817	0.0
22299848737	3	0.7596201452649958	1.0	1	2	0.3798100726324979	0.5
22299848738	2	1.1825755337001922	0.0	0	2	0.5912877668500961	0.0
22299848739	1	0.37983561082249573	0.0	0	1	0.37983561082249573	0.0
22299848740	6	1.330882621058007	3.0	3	3	0.443627540352669	1.0
22299848741	5	1.1397765238345048	2.0	2	3	0.37992550794483493	0.6666666666666666
22299848742	3	1.1397176698383067	0.0	0	3	0.37990588994610225	0.0
22299848743	4	0.3823234715965665	1.0	2	2	0.3823234715965665	1.0
22299848744	23	8.050890087569561	2.0	2	21	0.40254450437847805	0.09523809523809523
22484514660	1	0.1878783864995128	0.0	0	1	0.1878783864995128	0.0
22484514661	4	0.9237130999669131	0.5	1	3	0.46185654998345654	0.3333333333333333
22484514662	3	1.1787755453026447	0.0	0	3	0.39292518176754826	0.0
22484514663	2	0.18793054029820322	1.0	1	1	0.18793054029820322	1.0
22484514664	1	0.1879272070341165	0.0	0	1	0.1879272070341165	0.0
22641002218	5	0.0	5.0	5	0	0.0	inf
22641002220	1	0.0	1.0	1	0	0.0	inf
22641002221	1	0.0	1.0	1	0	0.0	inf
22641002222	4	0.0	4.0	4	0	0.0	inf
22641002223	4	0.0	4.0	4	0	0.0	inf
22641002224	1	0.0	1.0	1	0	0.0	inf
22641002225	1	0.0	1.0	1	0	0.0	inf
22641002228	4	0.0	4.0	4	0	0.0	inf
22641002230	1	0.0	1.0	1	0	0.0	inf
22641002231	4	0.0	4.0	4	0	0.0	inf
22641002232	3	0.1217591540270022	2.0	2	1	0.1217591540270022	2.0
22641002233	2	0.0	2.0	2	0	0.0	inf
22641002236	4	0.0	4.0	4	0	0.0	inf
22641002237	4	0.0	4.0	4	0	0.0	inf
22641002238	6	0.1728947247122846	4.0	4	2	0.04322368117807115	2.0
22641002239	3	0.0	3.0	3	0	0.0	inf
22641002240	2	0.0	2.0	2	0	0.0	inf
22641002241	11	1.043182671929004	5.0	5	6	0.17386377865483402	0.8333333333333334
22641002243	1	0.0	1.0	1	0	0.0	inf
22641002244	6	1.828448378698665	1.0	1	5	0.365689675739733	0.2
22641002245	1	0.0	1.0	1	0	0.0	inf
22641002246	3	0.0	3.0	3	0	0.0	inf
22641002247	2	0.0	2.0	2	0	0.0	inf
22641002248	2	0.0	2.0	2	0	0.0	inf
22641002249	4	0.18002891993792586	3.0	3	1	0.06000963997930862	3.0
22641002250	2	0.0	2.0	2	0	0.0	inf
22641002251	3	0.0	3.0	3	0	0.0	inf
22641002252	5	0.0	5.0	5	0	0.0	inf
22641002253	5	0.0	5.0	5	0	0.0	inf
22641002254	9	0.9700198147398755	7.0	7	2	0.16166996912331258	3.5
22641002255	8	0.7088161165136738	7.0	7	1	0.10125944521623911	7.0
22641002256	1	0.0	1.0	1	0	0.0	inf
22641002257	4	0.0	4.0	4	0	0.0	inf
22641002258	8	0.0	8.0	8	0	0.0	inf
22641002259	6	0.0	6.0	6	0	0.0	inf
22641002260	6	0.0	6.0	6	0	0.0	inf
22641002261	6	0.8099918934344024	5.0	5	1	0.16199837868688047	5.0
22641002262	6	0.4572299625963999	5.0	5	1	0.09144599251927998	5.0
22641002263	7	0.16813606936179137	4.0	4	3	0.04203401734044784	1.3333333333333333
22641002264	7	0.6545005108816426	4.5	5	2	0.13090010217632853	2.5
22641002265	3	0.0	3.0	3	0	0.0	inf
22641002266	4	0.0	4.0	4	0	0.0	inf
22641002267	11	2.0852907870567132	3.0	4	7	0.41705815741134267	0.5714285714285714
22641002268	14	2.7383484996288123	7.0	7	7	0.39119264280411603	1.0
22641002269	10	2.5637411842319637	2.0	3	7	0.427290197371994	0.42857142857142855
22641002270	17	3.534903197465561	7.5	8	9	0.44186289968319514	0.8888888888888888
22641002271	12	2.554241852955445	6.0	6	6	0.3648916932793493	1.0
22641002272	10	2.006909048387783	4.0	4	6	0.3344848413979638	0.6666666666666666
22641002274	2	1.5829707510790096	0.0	0	2	0.7914853755395048	0.0
22641002275	5	0.0	5.0	5	0	0.0	inf
22641002276	6	0.6527370795024224	5.0	5	1	0.10878951325040374	5.0
22641002277	5	0.1349895862432757	4.0	4	1	0.033747396560818925	4.0
22641002278	6	0.3909388818420843	5.0	5	1	0.06515648030701406	5.0
22641002279	6	0.03605372911949944	5.0	5	1	0.007210745823899888	5.0
22641002280	7	0.25462895265778485	6.0	6	1	0.042438158776297474	6.0
22641002281	8	0.3806638427747141	5.0	5	3	0.07613276855494282	1.6666666666666667
22641002282	6	0.7880085454116996	2.0	2	4	0.15760170908233992	0.5
22641002283	15	2.5771041726170196	7.0	8	7	0.32213802157712745	1.1428571428571428
22641002284	9	3.2028359208833943	4.0	4	5	0.533805986813899	0.8
22641002285	9	2.6727858885894524	1.0	2	7	0.4454643147649087	0.2857142857142857
22641002286	10	3.3375637280531922	4.0	4	6	0.5562606213421987	0.6666666666666666
22641002287	14	3.9545598328815865	6.0	6	8	0.4943199791101983	0.75
22641002288	9	2.785430417152613	4.0	4	5	0.4642384028587689	0.8
22641002289	2	0.14580043909525517	1.0	1	1	0.14580043909525517	1.0
22641002290	133	23.52544369701141	41.666666666666664	54	79	0.38566301142641657	0.6835443037974683
22641002291	1	0.0	1.0	1	0	0.0	inf
22641002293	2	0.0	2.0	2	0	0.0	inf
22641002294	3	0.0	3.0	3	0	0.0	inf
22641002295	8	1.074310207090984	4.0	4	4	0.21486204141819681	1.0
22641002296	6	3.657084598612884	1.0	1	5	0.7314169197225768	0.2
22641002297	3	0.9414805086372449	1.0	1	2	0.47074025431862243	0.5
22641002298	8	2.7295541032026374	3.0	3	5	0.45492568386710625	0.6
22641002299	1	0.5942343554681035	0.0	0	1	0.5942343554681035	0.0
22641002300	2	0.8716791977755882	0.0	0	2	0.4358395988877941	0.0
22641002302	1	0.0	1.0	1	0	0.0	inf
22641002303	2	0.0	2.0	2	0	0.0	inf
22641002304	2	0.0	2.0	2	0	0.0	inf
22641002305	11	2.032088929330997	4.0	4	7	0.2902984184758567	0.5714285714285714
22641002306	9	0.32634655367597243	4.0	4	5	0.054391092279328736	0.8
22641002307	11	1.3934040158155638	4.0	4	7	0.19905771654508056	0.5714285714285714
22641002308	9	1.006147313370628	4.0	4	5	0.20122946267412561	0.8
22641002309	16	4.1331644053051155	5.0	6	10	0.5166455506631394	0.6
22641002310	4	2.133354670712733	1.0	1	3	0.711118223570911	0.3333333333333333
22641002311	12	3.3842206039019325	3.0	4	8	0.5640367673169887	0.5
22641002312	7	1.1712667787339233	3.0	3	4	0.2928166946834808	0.75
22641002313	6	4.7274279520859785	0.0	0	6	0.7879046586809965	0.0
22641002314	99	23.708219967282165	21.5	29	70	0.4473249050430597	0.4142857142857143
22641002315	3	1.169131839921036	1.0	1	2	0.584565919960518	0.5
22641002316	2	0.29251503428363124	1.0	1	1	0.29251503428363124	1.0
22641002317	3	1.283131491847459	0.0	0	3	0.42771049728248633	0.0
22641002318	2	0.0	2.0	2	0	0.0	inf
22641002319	4	0.19207045429392933	3.0	3	1	0.0640234847646431	3.0
22641002320	5	0.0	5.0	5	0	0.0	inf
22641002321	6	0.0	6.0	6	0	0.0	inf
22641002322	7	0.9486173300709544	3.0	3	4	0.18972346601419088	0.75
22641002323	7	0.07580502452188115	5.0	5	2	0.015161004904376229	2.5
22641002324	7	0.3700463529090995	3.0	3	4	0.0740092705818199	0.75
22641002325	10	1.7041560449737458	5.0	5	5	0.34083120899474917	1.0
22641002326	1	0.4308778837826837	0.0	0	1	0.4308778837826837	0.0
22641002327	8	2.8276734453025	2.0	2	6	0.4712789075504167	0.3333333333333333
22641002328	14	1.6265941882621497	7.0	7	7	0.20332427353276872	1.0
22641002329	7	2.495178130474528	2.0	2	5	0.49903562609490565	0.4
22641002330	3	0.6222593961600191	1.0	1	2	0.31112969808000956	0.5
22641002331	12	4.328609839990866	5.0	5	7	0.6183728342844095	0.7142857142857143
22641002332	2	0.4309287918160084	1.0	1	1	0.4309287918160084	1.0
22641002333	12	5.429575789620802	2.0	3	9	0.6786969737026003	0.3333333333333333
22641002334	5	0.0	5.0	5	0	0.0	inf
22641002336	10	0.0	10.0	10	0	0.0	inf
22641002337	6	0.9816256342418745	5.0	5	1	0.16360427237364575	5.0
22641002338	6	0.4136141683521255	5.0	5	1	0.0827228336704251	5.0
22641002339	8	0.0	8.0	8	0	0.0	inf
22641002340	7	0.0	7.0	7	0	0.0	inf
22641002341	5	0.02212364813835349	4.0	4	1	0.005530912034588373	4.0
22641002342	7	0.0	7.0	7	0	0.0	inf
22641002343	8	0.9979957655425138	6.0	6	2	0.14257082364893053	3.0
22641002344	9	1.595626851792338	1.5	3	6	0.5318756172641127	0.5
23255994035	8	1.3695190911353796	3.0	3	5	0.27390381822707593	0.6
23255994036	4	2.155072064664515	0.0	0	4	0.7183573548881718	0.0
23255994037	6	3.5222815068117947	0.0	0	6	0.5870469178019658	0.0
23255994038	11	5.104349953403325	3.0	3	8	0.6380437441754157	0.375
23255994039	1	0.20328742665514324	0.0	0	1	0.20328742665514324	0.0
23255994040	3	0.6668597490752465	0.5	1	2	0.6668597490752465	0.5
23255994041	4	0.9876817710554633	0.5	1	3	0.49384088552773164	0.3333333333333333
23255994042	3	0.3353362322405625	0.5	1	2	0.3353362322405625	0.5
23255994043	2	0.20334442883795983	1.0	1	1	0.20334442883795983	1.0
23255994044	10	1.9699037228755216	4.0	4	6	0.3283172871459203	0.6666666666666666
23255994045	2	0.4069474381626482	0.0	0	2	0.2034737190813241	0.0
23255994046	2	1.0707373183526794	0.0	0	2	0.5353686591763397	0.0
23255994047	74	14.804885265514859	12.0	18	56	0.34429965733755485	0.32142857142857145
23255994048	3	0.40680124591351086	1.0	1	2	0.20340062295675543	0.5
23255994049	5	2.3517034343091257	0.0	0	5	0.4703406868618251	0.0
23255994050	1	0.20342823181080716	0.0	0	1	0.20342823181080716	0.0
23255994051	1	0.20343607676567796	0.0	0	1	0.20343607676567796	0.0
23795025411	3	0.17988895651561715	1.0	1	2	0.08994447825780857	0.5
23795025412	29	1.8846665710682033	7.0	7	22	0.08566666232128196	0.3181818181818182
23795025413	3	0.13640161078135177	1.0	1	2	0.06820080539067588	0.5
23795025414	5	0.246511848558567	2.0	2	3	0.082170616186189	0.6666666666666666
23795025415	11	0.5888068587935396	5.0	5	6	0.09813447646558993	0.8333333333333334
23795025416	2	0.13630026608538132	0.0	0	2	0.06815013304269066	0.0
23795025417	4	0.13636699870578445	2.0	2	2	0.06818349935289222	1.0
23795025418	31	1.647389816851279	10.0	10	21	0.0784471341357752	0.47619047619047616
23795025419	5	0.20515206805299702	2.0	2	3	0.06838402268433234	0.6666666666666666
23795025420	9	0.5216793644387926	4.0	4	5	0.10433587288775852	0.8
23795025421	4	0.9657217558813678	1.0	1	3	0.32190725196045594	0.3333333333333333
23795025422	30	1.5414073047708066	10.0	10	20	0.07707036523854033	0.5
23795025423	9	2.426730326848092	2.5	3	6	0.48534606536961844	0.5
23795025424	10	0.8479361893390969	4.0	5	5	0.21198404733477422	1.0
23795025425	13	4.98995300333323	3.5	4	9	0.6237441254166538	0.4444444444444444
23795025426	11	5.539968681458705	0.5	1	10	0.6924960851823381	0.1
23795025427	1	0.06844234919429451	0.0	0	1	0.06844234919429451	0.0
23796184825	1	0.16528350235956377	0.0	0	1	0.16528350235956377	0.0
23796184826	2	0.0	2.0	2	0	0.0	inf
23796184827	8	0.11106398900736641	6.0	6	2	0.022212797801473283	3.0
23796184830	1	0.6909713357133288	0.0	0	1	0.6909713357133288	0.0
23796184831	4	1.2774227888935776	1.0	1	3	0.6387113944467888	0.3333333333333333
23796184832	1	0.0	1.0	1	0	0.0	inf
23796184834	1	0.0	1.0	1	0	0.0	inf
23796184835	14	0.0	14.0	14	0	0.0	inf
23796184836	5	0.040404143792703025	4.0	4	1	0.013468047930901008	4.0
23796184837	4	0.6215407242213183	3.0	3	1	0.2071802414071061	3.0
23796184838	8	0.0	8.0	8	0	0.0	inf
23796184839	8	1.8844291685926928	3.0	3	5	0.4711072921481732	0.6
23796184840	5	0.0	5.0	5	0	0.0	inf
23796184841	8	0.0	8.0	8	0	0.0	inf
23796184842	3	0.0	3.0	3	0	0.0	inf
23796184843	4	0.21206697490493212	3.0	3	1	0.07068899163497737	3.0
23796184844	6	0.10822010869336485	3.0	3	3	0.018036684782227475	1.0
23796184845	7	0.3644928319165895	5.0	5	2	0.09112320797914737	2.5
23796184846	7	0.5813939824886467	3.0	3	4	0.11627879649772935	0.75
23796184847	11	2.622969078386486	4.5	5	6	0.5245938156772972	0.8333333333333334
23796184848	16	2.318639744083431	7.0	7	9	0.25762663823149234	0.7777777777777778
23796184849	8	2.0356763295523455	4.0	4	4	0.5089190823880864	1.0
23796184850	1	0.0	1.0	1	0	0.0	inf
23796184852	2	0.761083313521736	1.0	1	1	0.380541656760868	1.0
23796184853	5	0.107929340323132	4.0	4	1	0.026982335080783	4.0
23796184855	1	0.0	1.0	1	0	0.0	inf
23796184856	6	0.920438790884378	5.0	5	1	0.15340646514739634	5.0
23796184857	6	0.26341015070495	3.0	3	3	0.0658525376762375	1.0
23796184858	11	0.2938333907339366	5.0	5	6	0.04197619867627666	0.8333333333333334
23796184859	11	1.9443927713690257	2.5	4	7	0.4860981928422564	0.5714285714285714
23796184860	10	0.48516540918998413	5.0	5	5	0.09703308183799683	1.0
23796184861	7	0.47787525760828475	3.0	3	4	0.09557505152165695	0.75
23796184862	11	1.2403003277676015	5.0	6	5	0.24806006555352028	1.2
23796184863	3	1.800970969727666	0.0	0	3	0.6003236565758886	0.0
23796184864	12	2.1615089343093445	5.0	5	7	0.27018861678866807	0.7142857142857143
23796184865	6	3.185139520838911	1.0	1	5	0.6370279041677822	0.2
23796184866	3	0.45929389278343946	1.0	1	2	0.22964694639171973	0.5
23796184867	1	0.4547867810288251	0.0	0	1	0.4547867810288251	0.0
23796184868	4	0.4053724877163326	1.0	2	2	0.4053724877163326	1.0
23796184869	2	0.45481799250163724	1.0	1	1	0.45481799250163724	1.0
23796184870	2	1.0877008379994262	0.0	0	2	0.5438504189997131	0.0
23796184871	2	0.26826722151933746	1.0	1	1	0.26826722151933746	1.0
23796184872	11	0.0	11.0	11	0	0.0	inf
23796184873	1	0.0	1.0	1	0	0.0	inf
23796184874	5	0.10803519670988654	4.0	4	1	0.027008799177471635	4.0
23796184876	1	0.0	1.0	1	0	0.0	inf
23796184877	5	0.0	5.0	5	0	0.0	inf
23796184878	6	0.6641542160555116	5.0	5	1	0.13283084321110233	5.0
23796184879	4	0.7132186849855678	1.5	2	2	0.3566093424927839	1.0
23796184880	5	0.9445831714539802	3.0	3	2	0.23614579286349505	1.5
23796184881	7	0.37112340124112575	4.0	4	3	0.09278085031028144	1.3333333333333333
23796184882	9	0.6872765639851859	5.0	5	4	0.13745531279703718	1.25
23796184883	12	1.0841629653686993	5.0	6	6	0.21683259307373987	1.0
23796184884	7	0.8239320078771428	3.0	3	4	0.16478640157542856	0.75
23796184885	7	2.131221583713227	3.0	3	4	0.4262443167426454	0.75
23796184886	7	0.40318196083266555	4.0	4	3	0.10079549020816639	1.3333333333333333
23796184887	16	1.6329180972907062	9.0	9	7	0.20411476216133828	1.2857142857142858
23796184889	2	0.49134871507888206	1.0	1	1	0.49134871507888206	1.0
23796184890	2	0.21471173477641894	1.0	1	1	0.21471173477641894	1.0
23796184891	1	0.35981932631231195	0.0	0	1	0.35981932631231195	0.0
23796184892	2	0.0	2.0	2	0	0.0	inf
23796184893	1	0.0	1.0	1	0	0.0	inf
23796184894	11	1.5476995646252063	7.0	7	4	0.2210999378036009	1.75
23796184895	6	2.0180162250501397	2.0	2	4	0.3363360375083566	0.5
23796184896	8	0.0	8.0	8	0	0.0	inf
23796184897	9	0.13722479233343873	5.0	5	4	0.02287079872223979	1.25
23796184898	3	0.0	3.0	3	0	0.0	inf
23796184899	13	0.6103514617221588	8.0	8	5	0.07629393271526985	1.6
23796184900	9	1.180750857802045	3.0	4	5	0.29518771445051123	0.8
23796184901	5	2.840345841973586	1.0	1	4	0.5680691683947172	0.25
23796184902	18	2.2748674211044166	8.0	9	9	0.2843584276380521	1.0
23796184903	10	1.4606825508035743	5.0	5	5	0.20866893582908205	1.0
23796184904	8	1.9188979138042823	3.0	3	5	0.3198163189673804	0.6
23796184905	14	4.088970878955141	6.0	6	8	0.5111213598693927	0.75
23796184906	10	1.7392295924357395	3.5	5	5	0.4348073981089349	1.0
23796184907	2	0.29409345267137044	1.0	1	1	0.29409345267137044	1.0
23796184908	6	0.8260992692508712	2.0	3	3	0.4130496346254356	1.0
23796184909	5	1.6238468379293265	1.0	1	4	0.4059617094823316	0.25
23796184910	2	0.0	2.0	2	0	0.0	inf
23796184911	13	0.0	13.0	13	0	0.0	inf
23796184912	2	0.0	2.0	2	0	0.0	inf
23796184913	8	0.7757984623686437	6.0	6	2	0.1292997437281073	3.0
23796184914	13	1.645952641320549	5.5	6	7	0.2743254402200915	0.8571428571428571
23796184915	10	0.21882959535823782	5.0	5	5	0.03647159922637297	1.0
23796184916	10	0.3896074280207714	8.0	8	2	0.04328971422453016	4.0
23796184917	13	1.1505269402315783	6.0	6	7	0.1438158675289473	0.8571428571428571
23796184918	12	1.0120648672046106	5.0	5	7	0.12650810840057633	0.7142857142857143
23796184919	8	0.6367126985947801	4.0	4	4	0.15917817464869502	1.0
23796184920	8	0.8434169566241672	3.0	3	5	0.16868339132483343	0.6
23796184921	9	0.6607202469901552	5.0	5	4	0.11012004116502587	1.25
23796184922	9	1.2680891444107036	4.0	4	5	0.25361782888214074	0.8
23796184923	10	0.777538594568591	5.0	5	5	0.1555077189137182	1.0
23796184924	9	1.4997792470102556	5.0	5	4	0.2999558494020511	1.25
23796184925	5	3.5446160259903015	0.0	0	5	0.7089232051980603	0.0
23796184926	1	0.6721498411969017	0.0	0	1	0.6721498411969017	0.0
23796184927	4	0.2673250862094885	1.0	2	2	0.2673250862094885	1.0
23796184928	3	0.3637963817384669	0.5	1	2	0.3637963817384669	0.5
23796184929	9	0.4267404276483549	5.0	5	4	0.08534808552967098	1.25
23796184930	9	0.0	9.0	9	0	0.0	inf
23796184931	1	0.0	1.0	1	0	0.0	inf
23796184932	15	0.0	15.0	15	0	0.0	inf
23796184933	6	0.6233463096069688	5.0	5	1	0.12466926192139376	5.0
23796184934	4	0.0	4.0	4	0	0.0	inf
23796184935	6	0.37623891786490493	3.0	3	3	0.07524778357298098	1.0
23796184936	4	0.3281755729182326	3.0	3	1	0.10939185763941088	3.0
23796184937	8	1.811825963076794	4.0	4	4	0.4529564907691985	1.0
23796184938	8	2.217878504005489	3.0	4	4	0.4435757008010978	1.0
23796184939	12	0.6138671462616415	5.0	5	7	0.07673339328270519	0.7142857142857143
23796184940	2	0.19292818058291517	1.0	1	1	0.19292818058291517	1.0
23796184941	14	2.598728033158368	4.0	5	9	0.324841004144796	0.5555555555555556
23796184942	9	5.248949373677995	1.0	1	8	0.6561186717097494	0.125
23796184945	1	0.0	1.0	1	0	0.0	inf
23796184946	1	0.0	1.0	1	0	0.0	inf
23796184947	9	1.388389675541084	2.0	3	6	0.347097418885271	0.5
23796184948	5	2.3710491603591937	1.0	1	4	0.5927622900897984	0.25
23796184949	1	0.0	1.0	1	0	0.0	inf
23796184950	4	0.0	4.0	4	0	0.0	inf
23796184952	2	0.0	2.0	2	0	0.0	inf
23796184953	5	0.0	5.0	5	0	0.0	inf
23796184954	7	0.0	7.0	7	0	0.0	inf
23796184955	12	0.0	12.0	12	0	0.0	inf
23796184956	1	0.0	1.0	1	0	0.0	inf
23796184957	6	0.00971400695143808	5.0	5	1	0.00242850173785952	5.0
23796184958	1	0.0	1.0	1	0	0.0	inf
23796184959	5	0.0	5.0	5	0	0.0	inf
23796184960	9	3.1086900989295945	3.0	3	6	0.5181150164882657	0.5
23796184961	6	0.039066057112550893	4.0	4	2	0.009766514278137723	2.0
23796184962	17	0.7522178411310445	9.0	9	8	0.09402723014138056	1.125
23796184963	9	0.9397671435579942	5.0	5	4	0.18795342871159884	1.25
23796184964	5	0.0636238634369111	3.0	3	2	0.01272477268738222	1.5
23796184965	14	2.9714570239399403	6.0	7	7	0.49524283732332336	1.0
23796184966	8	6.760616892234933	0.0	0	8	0.8450771115293666	0.0
23796184967	71	17.3901863722225	14.166666666666668	19	52	0.4241508871273781	0.36538461538461536
23796184968	4	0.7487972387913693	2.0	2	2	0.37439861939568464	1.0
23796184969	2	0.6152636492366472	1.0	1	1	0.3076318246183236	1.0
23796184970	1	0.0	1.0	1	0	0.0	inf
23796184971	1	0.4551618237425842	0.0	0	1	0.4551618237425842	0.0
23796184972	2	1.230551843417933	0.0	0	2	0.6152759217089665	0.0
23796184975	2	0.0	2.0	2	0	0.0	inf
23796184976	3	1.702566280020378	1.0	1	2	0.567522093340126	0.5
23796184977	5	0.11042777326814457	4.0	4	1	0.027606943317036142	4.0
23796184978	3	0.38261646214285716	2.0	2	1	0.19130823107142858	2.0
23796184979	7	0.28517222386322816	3.0	3	4	0.05703444477264563	0.75
23796184980	12	0.9272064954071492	6.0	7	5	0.18544129908142984	1.4
23796184981	12	1.4853816673236115	5.0	5	7	0.18567270841545144	0.7142857142857143
23796184982	7	0.6686245608971693	4.0	4	3	0.16715614022429232	1.3333333333333333
23796184983	7	0.17472145443981854	4.0	4	3	0.034944290887963705	1.3333333333333333
23796184984	6	2.424408085528998	1.0	1	5	0.4848816171057996	0.2
23796184985	14	2.5196228751746133	7.0	7	7	0.31495285939682666	1.0
23796184986	3	1.3943456797547338	1.0	1	2	0.6971728398773669	0.5
23796184987	1	0.7107595778229119	0.0	0	1	0.7107595778229119	0.0
23796184988	7	4.393727780133322	0.5	1	6	0.8787455560266644	0.16666666666666666
23796184989	1	0.7107986005812607	0.0	0	1	0.7107986005812607	0.0
23796184990	3	1.277701133279487	1.0	1	2	0.6388505666397435	0.5
23796184991	2	0.0	2.0	2	0	0.0	inf
23796184992	11	0.0	11.0	11	0	0.0	inf
23796184993	1	0.0	1.0	1	0	0.0	inf
23796184994	6	0.110625883630633	5.0	5	1	0.0221251767261266	5.0
23796184995	1	0.0	1.0	1	0	0.0	inf
23796184996	6	0.19991591420474533	3.0	3	3	0.039983182840949066	1.0
23796184997	11	1.2991434151014438	5.0	5	6	0.2165239025169073	0.8333333333333334
23796184998	7	0.20300086695168656	4.0	4	3	0.05075021673792164	1.3333333333333333
23796184999	13	1.8830690621679678	6.0	6	7	0.23538363277099597	0.8571428571428571
23796185000	8	5.5540799707965665	1.0	1	7	0.6942599963495708	0.14285714285714285
23796185001	2	1.0584686169987647	0.0	0	2	0.5292343084993824	0.0
23796185002	2	1.9990426798204226	0.0	0	2	0.9995213399102113	0.0
23796185003	3	0.6451232309416333	0.5	1	2	0.6451232309416333	0.5
23796185004	2	0.7361959854234678	1.0	1	1	0.7361959854234678	1.0
23796185006	1	0.0	1.0	1	0	0.0	inf
23796185008	3	1.7232103966055654	1.0	1	2	0.5744034655351885	0.5
23796185009	5	0.11082954943326598	4.0	4	1	0.027707387358316495	4.0
23796185010	2	0.0	2.0	2	0	0.0	inf
23796185011	7	0.0	7.0	7	0	0.0	inf
23796185012	4	0.0	4.0	4	0	0.0	inf
23796185013	4	0.0	4.0	4	0	0.0	inf
23796185014	8	3.8783855231020956	4.0	4	4	0.48479819038776195	1.0
23796185015	6	0.4181590234303887	5.0	5	1	0.08363180468607774	5.0
23796185016	6	0.4141517329421136	4.0	4	2	0.08283034658842273	2.0
23796185017	6	0.2934046117627792	4.0	4	2	0.05868092235255584	2.0
23796185018	8	0.3221090996190416	3.0	3	5	0.053684849936506934	0.6
23796185019	12	0.799925806255136	5.0	5	7	0.099990725781892	0.7142857142857143
23796185020	15	2.495215840128843	8.0	8	7	0.31190198001610536	1.1428571428571428
23796185021	9	1.8740542662800572	4.0	4	5	0.37481085325601143	0.8
23796185022	4	0.05252284826271454	1.0	2	2	0.05252284826271454	1.0
23796185023	1	0.7912456162105993	0.0	0	1	0.7912456162105993	0.0
23796185024	2	0.43827937985261384	1.0	1	1	0.43827937985261384	1.0
23796185026	1	0.2957530141545544	0.0	0	1	0.2957530141545544	0.0
23796185027	2	0.6164440287553622	1.0	1	1	0.6164440287553622	1.0
23796185028	10	2.1934320085000256	5.0	5	5	0.4386864017000051	1.0
23796185029	1	0.5866717853033154	0.0	0	1	0.5866717853033154	0.0
23796185030	2	0.0	2.0	2	0	0.0	inf
23796185031	2	0.0	2.0	2	0	0.0	inf
23796185032	7	0.13294498225407236	5.0	5	2	0.03323624556351809	2.5
23796185033	3	1.8541292256655812	1.0	1	2	0.6180430752218604	0.5
23796185034	10	0.0	10.0	10	0	0.0	inf
23796185035	4	0.8825781969445281	3.0	3	1	0.22064454923613203	3.0
23796185036	6	0.5085138130295408	4.0	4	2	0.10170276260590816	2.0
23796185037	4	0.05392487300853043	3.0	3	1	0.013481218252132608	3.0
23796185038	11	2.0511285337944325	5.0	5	6	0.2930183619706332	0.8333333333333334
23796185039	15	0.9540552979084576	7.0	7	8	0.1192569122385572	0.875
23796185040	9	0.30097364643973556	8.0	8	1	0.037621705804966946	8.0
23796185041	8	0.23505935920455792	5.0	5	3	0.04701187184091159	1.6666666666666667
23796185042	10	0.9281430079381852	5.0	5	5	0.15469050132303086	1.0
23796185043	7	5.467035819491562	0.0	0	7	0.9111726365819269	0.0
23796185044	15	3.12389042288246	7.0	7	8	0.3904863028603075	0.875
23796185045	6	4.670006114687785	0.0	0	6	0.7783343524479642	0.0
23796185046	18	3.660704725427084	8.0	9	9	0.4575880906783855	1.0
23796185047	5	2.260965656033341	0.0	0	5	0.4521931312066682	0.0
23796185048	3	2.0442163878279027	0.0	0	3	0.6814054626093009	0.0
23796185049	2	0.3322375087359296	1.0	1	1	0.3322375087359296	1.0
23796185050	3	0.05660468265692931	2.0	2	1	0.05660468265692931	2.0
23796185051	4	0.45335758513030217	1.0	2	2	0.45335758513030217	1.0
23796185052	1	0.259115930150542	0.0	0	1	0.259115930150542	0.0
23796185053	12	2.0351395393570444	5.5	6	6	0.2907342199081492	1.0
23796185054	1	0.4422725292205209	0.0	0	1	0.4422725292205209	0.0
23796185058	4	0.11122354798218502	3.0	3	1	0.037074515994061676	3.0
23796185060	3	1.5075189178729858	0.0	0	3	0.7537594589364929	0.0
23796185061	1	0.0	1.0	1	0	0.0	inf
23796185062	7	0.0	7.0	7	0	0.0	inf
23796185063	8	0.29401443074398087	3.0	3	5	0.04900240512399681	0.6
23796185064	9	1.1811710847623131	2.0	3	6	0.2952927711905783	0.5
23796185065	9	0.7551818536295054	5.0	5	4	0.1510363707259011	1.25
23796185066	8	1.5675101631727044	3.0	3	5	0.2612516938621174	0.6
23796185067	14	3.542291495156481	7.0	7	7	0.4427864368945601	1.0
23796185069	7	3.1997918763775175	0.5	1	6	0.6399583752755035	0.16666666666666666
23796185070	3	0.4912863594719261	0.5	1	2	0.4912863594719261	0.5
23796185072	1	0.0	1.0	1	0	0.0	inf
23796185073	1	0.0	1.0	1	0	0.0	inf
23796185074	2	1.4223149976985328	0.0	0	2	0.7111574988492664	0.0
23796185075	1	0.0	1.0	1	0	0.0	inf
23796185077	3	0.0	3.0	3	0	0.0	inf
23796185078	6	0.11142175935267608	5.0	5	1	0.022284351870535214	5.0
23796185080	4	1.2113661477133624	2.0	2	2	0.40378871590445414	1.0
23796185081	10	0.0	10.0	10	0	0.0	inf
23796185082	6	0.37715805701948885	3.0	3	3	0.09428951425487221	1.0
23796185083	8	0.0	8.0	8	0	0.0	inf
23796185084	13	2.043653840591931	7.0	7	6	0.2919505486559902	1.1666666666666667
23796185085	7	0.17247507013069796	4.0	4	3	0.034495014026139595	1.3333333333333333
23796185086	9	3.520132999257221	1.0	2	7	0.7040265998514441	0.2857142857142857
23796185087	5	1.127658425412509	0.5	1	4	0.3758861418041697	0.25
23796185088	2	0.22891527809001408	1.0	1	1	0.22891527809001408	1.0
23796185089	3	0.43292184805453704	0.5	1	2	0.43292184805453704	0.5
23796185090	2	0.23463633768955036	1.0	1	1	0.23463633768955036	1.0
23796185091	1	0.7343844068963281	0.0	0	1	0.7343844068963281	0.0
23796185092	2	0.4622420806948219	1.0	1	1	0.4622420806948219	1.0
23796185093	1	0.7602876398156981	0.0	0	1	0.7602876398156981	0.0
23796185094	1	0.29880332115659414	0.0	0	1	0.29880332115659414	0.0
23796185095	1	0.5556558303149056	0.0	0	1	0.5556558303149056	0.0
23796185096	4	0.0	4.0	4	0	0.0	inf
23796185098	1	0.0	1.0	1	0	0.0	inf
23796185099	8	0.15687121920733163	4.0	4	4	0.03137424384146632	1.0
23796185100	7	0.11811246210811041	4.0	4	3	0.029528115527027603	1.3333333333333333
23796185101	9	0.0	9.0	9	0	0.0	inf
23796185102	11	1.1701504382888746	5.0	5	6	0.19502507304814576	0.8333333333333334
23796185103	5	3.236500878079401	1.0	1	4	0.6473001756158803	0.25
23796185104	2	0.15214168783092957	1.0	1	1	0.15214168783092957	1.0
23796185105	2	0.24956872108077754	1.0	1	1	0.24956872108077754	1.0
23796185106	2	0.2495799329690693	1.0	1	1	0.12478996648453465	1.0
23796185107	1	0.13472056826294215	0.0	0	1	0.13472056826294215	0.0
23796185108	1	0.6950615874410959	0.0	0	1	0.6950615874410959	0.0
23796185109	2	0.6838530997521028	0.0	0	2	0.3419265498760514	0.0
23796185110	2	0.0	2.0	2	0	0.0	inf
23796185111	7	0.5715210226104057	5.0	5	2	0.09525350376840096	2.5
23796185113	2	0.0	2.0	2	0	0.0	inf
23796185114	8	0.0	8.0	8	0	0.0	inf
23796185115	8	1.4999115001550305	5.0	5	3	0.1874889375193788	1.6666666666666667
23796185116	7	0.5546147408318151	4.5	5	2	0.11092294816636301	2.5
23796185117	14	0.8252032609288891	7.0	7	7	0.10315040761611113	1.0
23796185118	13	0.19093061265360245	7.0	7	6	0.027275801807657492	1.1666666666666667
23796185119	8	1.5589037426394206	3.0	3	5	0.2598172904399034	0.6
23796185120	8	0.11228446870312492	5.0	5	3	0.022456893740624984	1.6666666666666667
23796185121	10	1.077877540389144	4.0	4	6	0.179646256731524	0.6666666666666666
23796185122	8	0.5042894900129515	5.0	5	3	0.1008578980025903	1.6666666666666667
23796185123	7	6.57697410797897	0.0	0	7	0.9395677297112813	0.0
23796185124	4	0.13929134872854662	1.0	2	2	0.13929134872854662	1.0
23796185126	1	0.23174861990240808	0.0	0	1	0.23174861990240808	0.0
23796185127	1	0.0	1.0	1	0	0.0	inf
23796185128	2	0.23176026949204456	1.0	1	1	0.23176026949204456	1.0
23796185130	2	1.10090015975089	0.0	0	2	0.550450079875445	0.0
23796185131	2	0.0	2.0	2	0	0.0	inf
23796185132	9	4.146241844066741	4.0	4	5	0.4606935382296379	0.8
23796185133	6	3.1745972145965857	2.0	2	4	0.5290995357660976	0.5
23796185134	2	0.0	2.0	2	0	0.0	inf
23796185135	8	0.0	8.0	8	0	0.0	inf
23796185136	3	0.0	3.0	3	0	0.0	inf
23796185137	4	0.0	4.0	4	0	0.0	inf
23796185138	5	0.5249300039793786	3.0	3	2	0.1749766679931262	1.5
23796185139	5	2.6366695681776577	1.0	1	4	0.6591673920444144	0.25
23796185140	19	2.147901573896596	11.0	11	8	0.30684308198522803	1.375
23796185141	9	1.3147960192207455	5.0	5	4	0.21913266987012425	1.25
23796185142	8	0.8107102960184296	4.0	4	4	0.2026775740046074	1.0
23796185143	3	2.272821099979169	0.0	0	3	0.7576070333263897	0.0
23796185144	5	1.5733292005347903	2.0	2	3	0.5244430668449301	0.6666666666666666
23796185145	8	1.849767127733407	4.0	4	4	0.36995342554668137	1.0
23796185146	4	1.1099192653135792	1.0	1	3	0.5549596326567896	0.3333333333333333
23796185147	1	0.6451486176196273	0.0	0	1	0.6451486176196273	0.0
23796185148	3	1.2550505937300898	1.0	1	2	0.6275252968650449	0.5
23796185149	2	1.5802095963191607	0.0	0	2	0.7901047981595803	0.0
23796185150	2	0.0	2.0	2	0	0.0	inf
23796185151	6	0.0	6.0	6	0	0.0	inf
23796185152	4	0.0	4.0	4	0	0.0	inf
23796185153	1	0.0	1.0	1	0	0.0	inf
23796185154	10	0.0	10.0	10	0	0.0	inf
23796185155	14	3.056217518982855	7.0	7	7	0.4366025027118364	1.0
23796185156	7	1.045020041166148	4.0	4	3	0.34834001372204937	1.3333333333333333
23796185157	6	1.7595151642809306	2.0	2	4	0.3519030328561861	0.5
23796185158	13	2.3223141795337114	5.5	6	7	0.3870523632556186	0.8571428571428571
23796185159	8	4.792000011312896	1.0	1	7	0.7986666685521494	0.14285714285714285
23796185160	6	2.8023821188630524	1.0	1	5	0.5604764237726105	0.2
23796185161	2	1.294861281838017	0.0	0	2	0.6474306409190085	0.0
23796185162	2	0.26336429307175674	1.0	1	1	0.26336429307175674	1.0
23796185164	1	0.0	1.0	1	0	0.0	inf
23796185166	2	0.0	2.0	2	0	0.0	inf
23796185167	4	0.0	4.0	4	0	0.0	inf
23796185168	1	0.0	1.0	1	0	0.0	inf
23796185169	10	0.0	10.0	10	0	0.0	inf
23796185170	8	2.044421905443917	5.0	5	3	0.29206027220627384	1.6666666666666667
23796185172	1	0.0	1.0	1	0	0.0	inf
23796185173	5	0.0	5.0	5	0	0.0	inf
23796185174	5	0.0	5.0	5	0	0.0	inf
23796185175	5	0.42856355475712843	4.0	4	1	0.10714088868928211	4.0
23796185176	3	0.0	3.0	3	0	0.0	inf
23796185177	15	0.13716290809716175	10.0	10	5	0.009144193873144116	2.0
23796185178	7	0.8628139610702363	3.0	3	4	0.17256279221404727	0.75
23796185179	18	1.5763403501011444	7.0	8	10	0.17514892778901603	0.8
23796185180	7	1.1121785786470362	4.0	4	3	0.3707261928823454	1.3333333333333333
23796185181	7	2.1859092018189386	2.0	2	5	0.5464773004547346	0.4
23796185182	86	21.807677530739515	22.166666666666664	27	59	0.4543266152237399	0.4576271186440678
23796185183	5	0.7211830313154775	3.0	3	2	0.2403943437718258	1.5
23796185184	2	0.18054025611656485	1.0	1	1	0.18054025611656485	1.0
23796185185	1	0.0	1.0	1	0	0.0	inf
23796185186	1	0.0	1.0	1	0	0.0	inf
23796185187	9	3.3858278432397553	2.0	2	7	0.4836896918913936	0.2857142857142857
23796185188	2	0.5125402276996468	0.0	0	2	0.2562701138498234	0.0
23796185191	5	0.0	5.0	5	0	0.0	inf
23796185192	9	3.932356556767828	4.0	4	5	0.43692850630753644	0.8
23796185194	8	1.8411138058175696	2.0	2	6	0.3068523009695949	0.3333333333333333
23796185195	12	0.28673522169589943	11.0	11	1	0.02606683833599086	11.0
23796185196	7	0.0	7.0	7	0	0.0	inf
23796185197	16	0.634192010219855	7.0	8	8	0.07927400127748188	1.0
23796185198	11	1.6703200812292889	2.5	4	7	0.4175800203073222	0.5714285714285714
23796185199	7	0.17644293382861373	5.0	5	2	0.035288586765722746	2.5
23796185200	8	1.0922521912591918	3.0	3	5	0.21845043825183835	0.6
23796185201	7	0.4186113035968243	4.0	4	3	0.10465282589920608	1.3333333333333333
23796185202	16	2.2758126876623472	7.5	8	8	0.2844765859577934	1.0
23796185203	9	1.5017097792951573	5.0	5	4	0.30034195585903145	1.25
23796185204	18	3.665826740232367	8.5	9	9	0.4582283425290459	1.0
23796185205	4	1.6186243538307639	1.0	1	3	0.8093121769153819	0.3333333333333333
23796185206	2	0.7038059175673017	1.0	1	1	0.7038059175673017	1.0
23796185207	1	0.8620267383670851	0.0	0	1	0.8620267383670851	0.0
23796185208	1	0.8620666701974575	0.0	0	1	0.8620666701974575	0.0
23796185209	2	0.6366564708066502	1.0	1	1	0.6366564708066502	1.0
23796185210	3	0.376764731857254	0.5	1	2	0.376764731857254	0.5
23796185211	2	1.4836814332847026	0.0	0	2	0.7418407166423513	0.0
23796185212	6	0.12082025097323736	5.0	5	1	0.02416405019464747	5.0
23796185214	1	0.0	1.0	1	0	0.0	inf
23796185215	10	0.0	10.0	10	0	0.0	inf
23796185216	5	0.1209162085757343	4.0	4	1	0.030229052143933576	4.0
23796185218	1	0.0	1.0	1	0	0.0	inf
23796185219	8	0.0	8.0	8	0	0.0	inf
23796185220	10	0.2508065741529881	5.0	5	5	0.050161314830597624	1.0
23796185221	11	0.4510840633378088	6.0	6	5	0.0563855079172261	1.2
23796185222	7	2.2126139332391648	3.0	3	4	0.5531534833097912	0.75
23796185223	1	0.5568203852465422	0.0	0	1	0.5568203852465422	0.0
23796185224	6	2.2146618368231206	2.0	2	4	0.5536654592057801	0.5
23796185225	13	0.538378882836003	7.0	7	6	0.06729736035450037	1.1666666666666667
23796185226	2	1.8469072208163217	0.0	0	2	0.9234536104081609	0.0
23796185227	2	1.3053644306446563	0.0	0	2	0.6526822153223282	0.0
23796185228	2	0.12707160258657252	1.0	1	1	0.12707160258657252	1.0
23796185229	3	1.195759266549917	1.0	1	2	0.5978796332749585	0.5
23796185230	2	0.0	2.0	2	0	0.0	inf
23796185231	6	0.12101583613566008	5.0	5	1	0.024203167227132016	5.0
23796185233	5	1.1384042964494643	3.0	3	2	0.3794680988164881	1.5
23796185234	1	0.0	1.0	1	0	0.0	inf
23796185235	6	2.5213515261315953	0.0	0	6	0.42022525435526586	0.0
23796185236	13	0.6733874585837729	6.0	6	7	0.09619820836911042	0.8571428571428571
23796185237	7	1.0392681067871419	3.0	3	4	0.34642270226238064	0.75
23796185238	10	2.249493537457488	5.0	5	5	0.44989870749149763	1.0
23796185239	12	2.335271250425538	6.0	6	6	0.38921187507092303	1.0
23796185240	12	3.6033993165865876	5.0	5	7	0.5147713309409411	0.7142857142857143
23796185241	4	2.374694135142041	0.0	0	4	0.7915647117140137	0.0
23796185242	16	4.314758040211757	8.0	8	8	0.5393447550264696	1.0
23796185243	1	0.43013264673929164	0.0	0	1	0.43013264673929164	0.0
23796185244	5	2.1763259665615697	0.0	0	5	0.5440814916403924	0.0
23796185245	7	3.020587114402371	0.0	0	7	0.4315124449146244	0.0
23796185246	5	0.5277635814771121	0.6666666666666666	2	3	0.5277635814771121	0.6666666666666666
23796185247	2	0.4715579477692332	1.0	1	1	0.4715579477692332	1.0
23796185249	2	0.1791055384472316	1.0	1	1	0.1791055384472316	1.0
23796185250	2	0.1917932883347171	1.0	1	1	0.09589664416735855	1.0
23796185251	11	5.4160880563525	0.0	0	11	0.6770110070440625	0.0
23796185252	4	0.0	4.0	4	0	0.0	inf
23796185253	1	0.0	1.0	1	0	0.0	inf
23796185254	4	1.5225472588667097	0.0	0	4	0.5075157529555699	0.0
23796185256	2	0.3677679153938115	0.0	0	2	0.18388395769690574	0.0
23796185258	5	1.7141510898578303	1.0	1	4	0.42853777246445757	0.25
23796185263	2	1.4690954736731563	0.0	0	2	0.7345477368365781	0.0
23796185266	4	0.7354305804488843	2.0	2	2	0.36771529022444216	1.0
23796185267	2	1.8160183675645527	0.0	0	2	0.9080091837822764	0.0
23796185268	3	0.0	3.0	3	0	0.0	inf
23796185269	9	2.3194995578711377	4.0	4	5	0.2899374447338922	0.8
23796185270	5	3.631231196308144	1.0	1	4	0.7262462392616288	0.25
23796185271	8	3.9319194951404546	0.0	0	8	0.4914899368925568	0.0
23796185272	4	0.8752474738151061	2.0	2	2	0.4376237369075531	1.0
23796185273	4	0.0	4.0	4	0	0.0	inf
23796185274	4	0.0	4.0	4	0	0.0	inf
23796185275	4	0.0	4.0	4	0	0.0	inf
23796185276	5	0.0	5.0	5	0	0.0	inf
23796185277	2	0.0	2.0	2	0	0.0	inf
23796185278	2	0.0	2.0	2	0	0.0	inf
23796185279	5	0.0	5.0	5	0	0.0	inf
23796185280	17	2.90930312996528	6.0	8	9	0.3232559033294755	0.8888888888888888
23796185281	7	1.392490667786464	5.0	5	2	0.23208177796441065	2.5
23796185282	4	0.0	4.0	4	0	0.0	inf
23796185283	4	0.0	4.0	4	0	0.0	inf
23796185284	4	0.0	4.0	4	0	0.0	inf
23796185285	6	1.1799533322826257	4.0	4	2	0.19665888871377094	2.0
23796185286	2	0.0	2.0	2	0	0.0	inf
23796185287	3	0.0	3.0	3	0	0.0	inf
23796185290	2	1.6312939559471105	0.0	0	2	0.8156469779735552	0.0
23796185291	1	0.8927947187090423	0.0	0	1	0.8927947187090423	0.0
23796185294	2	1.7156325742323806	0.0	0	2	0.8578162871161903	0.0
23796185296	2	0.0	2.0	2	0	0.0	inf
23796185297	4	2.4906347231776365	0.0	0	4	0.8302115743925454	0.0
23796185298	2	0.5386566211738968	1.0	1	1	0.5386566211738968	1.0
23796185299	2	1.6121373842166309	0.0	0	2	0.8060686921083154	0.0
23796185300	1	0.22488398136644772	0.0	0	1	0.22488398136644772	0.0
23796185301	2	1.8190966874526546	0.0	0	2	0.9095483437263273	0.0
23796185302	12	2.7392839684104877	4.5	5	7	0.45654732806841464	0.7142857142857143
23796185303	19	4.1950051408022935	5.5	6	13	0.34958376173352446	0.46153846153846156
23796185304	1	0.669783998090006	0.0	0	1	0.669783998090006	0.0
23796185305	1	0.8050040509259454	0.0	0	1	0.8050040509259454	0.0
23796185306	3	1.0472421162159695	0.0	0	3	0.34908070540532316	0.0
23796185307	3	1.11186346734817	0.0	0	3	0.3706211557827233	0.0
23796185308	1	0.2240356824910405	0.0	0	1	0.2240356824910405	0.0
23796185309	7	1.2525334069659226	3.0	3	4	0.31313335174148066	0.75
23796185311	9	0.9716243605309614	4.0	4	5	0.19432487210619226	0.8
23796185313	6	1.8309672825988768	0.0	0	6	0.3051612137664795	0.0
23796185314	1	0.49844169903945096	0.0	0	1	0.49844169903945096	0.0
23796185317	5	3.8761461756838247	0.0	0	5	0.7752292351367649	0.0
23796185323	2	0.33471388826703496	0.0	0	2	0.16735694413351748	0.0
23796185324	2	0.34822020700782075	0.0	0	2	0.17411010350391037	0.0
23796185327	2	0.14764986195404628	1.0	1	1	0.14764986195404628	1.0
23796185328	3	2.560112606414877	0.0	0	3	0.853370868804959	0.0
23796185329	13	1.2945041175407233	6.0	6	7	0.18492915964867476	0.8571428571428571
23796185331	3	2.1013310935594367	0.0	0	3	0.7004436978531455	0.0
23796185333	2	0.332535751698357	1.0	1	1	0.332535751698357	1.0
23796185335	4	3.2411650572781032	0.0	0	4	0.8102912643195258	0.0
23796185336	2	0.49431077475595875	1.0	1	1	0.49431077475595875	1.0
23797497645	3	0.7125724357847516	1.0	1	2	0.3562862178923758	0.5
23797497646	1	0.33599019171891276	0.0	0	1	0.33599019171891276	0.0
23797497647	2	0.3359956798203889	1.0	1	1	0.3359956798203889	1.0
23797497648	3	0.6720141537800377	1.0	1	2	0.33600707689001885	0.5
23797497649	1	0.3360036931219308	0.0	0	1	0.3360036931219308	0.0
23797497650	24	6.795337753421082	4.0	4	20	0.3397668876710541	0.2
23797497651	28	6.834360141407163	9.0	9	19	0.3597031653372191	0.47368421052631576
23797497652	2	0.33670724752957154	1.0	1	1	0.33670724752957154	1.0
23797497653	29	8.902360984621968	4.0	4	25	0.3560944393848787	0.16
23797497654	12	4.055063266867486	0.0	0	12	0.33792193890562383	0.0
23797497655	2	0.3369523602826163	1.0	1	1	0.3369523602826163	1.0
23797497656	2	0.6740077823972479	0.0	0	2	0.33700389119862395	0.0
23797497657	7	1.7201722442331755	3.0	3	4	0.4300430610582939	0.75
23797497658	4	1.0119792124183817	1.0	1	3	0.3373264041394606	0.3333333333333333
23797497659	3	0.6750222731063129	1.0	1	2	0.33751113655315645	0.5
23797497660	2	0.33761961914797933	1.0	1	1	0.33761961914797933	1.0
23797497661	4	1.6740732692522853	1.0	1	3	0.5580244230840951	0.3333333333333333
23797497662	12	4.059567314712688	4.0	4	8	0.507445914339086	0.5
23797497663	2	0.3382363403426939	1.0	1	1	0.3382363403426939	1.0
23797497664	2	0.33824337723354364	1.0	1	1	0.33824337723354364	1.0
23797497665	1	0.3382475522309856	0.0	0	1	0.3382475522309856	0.0
23797497666	1	0.33825122218841447	0.0	0	1	0.33825122218841447	0.0
23797497667	2	0.33831643968877817	1.0	1	1	0.33831643968877817	1.0
23797497668	3	0.6772545162950655	1.0	1	2	0.33862725814753275	0.5
23797497669	2	0.338731144878236	1.0	1	1	0.338731144878236	1.0
23797497670	3	0.6818622993589663	1.0	1	2	0.3409311496794831	0.5
23797497671	2	0.3391678698122669	1.0	1	1	0.3391678698122669	1.0
23797497672	3	0.68172755468346	1.0	1	2	0.34086377734173	0.5
23797497673	3	0.6820103770908194	1.0	1	2	0.3410051885454097	0.5
23797497674	2	0.3411947974010102	1.0	1	1	0.3411947974010102	1.0
23797497675	6	1.7562532455133846	2.0	2	4	0.43906331137834614	0.5
23797497676	9	3.701491521203078	2.0	2	7	0.5287845030290111	0.2857142857142857
23797497677	3	0.6865496093902695	1.0	1	2	0.34327480469513477	0.5
23797497678	2	0.34333997169149716	1.0	1	1	0.34333997169149716	1.0
23797497679	2	0.7576739230703524	0.0	0	2	0.7576739230703524	0.0
23797497680	5	1.1682356295830487	0.5	1	4	0.5841178147915244	0.25
23797497681	3	0.39488691430215067	0.5	1	2	0.39488691430215067	0.5
23797497682	1	0.34436722307822765	0.0	0	1	0.34436722307822765	0.0
23797497683	3	0.509514667658251	0.5	1	2	0.509514667658251	0.5
23797497684	1	0.3448883233637874	0.0	0	1	0.3448883233637874	0.0
23797497685	2	0.3449020267828106	1.0	1	1	0.3449020267828106	1.0
23797497686	4	2.5072952861551663	0.0	0	4	0.6268238215387916	0.0
23797497687	1	0.3449150904844839	0.0	0	1	0.3449150904844839	0.0
23797497688	1	0.34492236306067314	0.0	0	1	0.34492236306067314	0.0
23797497689	1	0.34510367242539103	0.0	0	1	0.34510367242539103	0.0
23797497690	2	0.3451003391613043	1.0	1	1	0.3451003391613043	1.0
23797497691	2	0.34511515366835643	1.0	1	1	0.34511515366835643	1.0
23797497692	1	0.34512299862322726	0.0	0	1	0.34512299862322726	0.0
23797497693	2	0.8353888742445991	0.0	0	2	0.41769443712229953	0.0
23797497694	11	2.222932742441007	5.0	5	6	0.3704887904068345	0.8333333333333334
23797497695	2	0.34527477998184347	1.0	1	1	0.34527477998184347	1.0
23797497696	2	0.34538433999536106	1.0	1	1	0.34538433999536106	1.0
23797497697	1	0.345387706928782	0.0	0	1	0.345387706928782	0.0
23797497698	2	0.345391410555545	1.0	1	1	0.345391410555545	1.0
23797497699	1	0.3453916799102187	0.0	0	1	0.3453916799102187	0.0
23797497700	3	0.6908066926690446	1.0	1	2	0.3454033463345223	0.5
23797497701	1	0.3454043395798815	0.0	0	1	0.3454043395798815	0.0
23797497702	12	3.2222456186684605	5.0	5	7	0.46032080266692293	0.7142857142857143
23797497703	2	0.3455312729698511	1.0	1	1	0.3455312729698511	1.0
23797497704	5	1.4135939330822658	1.0	1	4	0.35339848327056644	0.25
23797497705	8	3.4481829114863167	2.0	2	6	0.5746971519143861	0.3333333333333333
23797497706	8	1.7894336673207833	4.0	4	4	0.44735841683019584	1.0
23797497707	3	0.35680760436727627	0.5	1	2	0.35680760436727627	0.5
23797497708	1	0.34571948454808193	0.0	0	1	0.34571948454808193	0.0
23797497709	2	0.34573409703912883	1.0	1	1	0.34573409703912883	1.0
23797497710	1	0.34574012384995234	0.0	0	1	0.34574012384995234	0.0
23797497711	1	0.3457453089274206	0.0	0	1	0.3457453089274206	0.0
23797497712	3	0.8502394748230315	1.0	1	2	0.42511973741151576	0.5
23797497713	10	1.8802247441526214	5.0	5	5	0.3760449488305243	1.0
23797497714	6	1.7996158800337378	2.0	2	4	0.44990397000843446	0.5
23797497715	5	3.6726530630659964	0.0	0	5	0.7345306126131993	0.0
23797497716	1	0.34600291300345715	0.0	0	1	0.34600291300345715	0.0
23797497717	2	0.3460092428382885	1.0	1	1	0.3460092428382885	1.0
23797497718	1	0.3460109599743332	0.0	0	1	0.3460109599743332	0.0
23797497719	6	1.1891691340957664	3.0	3	3	0.39638971136525547	1.0
23797497720	3	0.6922441375544488	1.0	1	2	0.3461220687772244	0.5
23797497721	15	3.667272333096649	7.0	7	8	0.4584090416370811	0.875
23797497722	14	3.658526016479725	6.0	6	8	0.4573157520599656	0.75
23797497723	8	1.6200829430580517	4.0	4	4	0.4050207357645129	1.0
23797497724	9	3.024147713833689	3.0	3	6	0.5040246189722816	0.5
23797497725	9	1.8824501861358638	4.0	4	5	0.3764900372271728	0.8
23797497726	3	0.6927710626348267	1.0	1	2	0.34638553131741334	0.5
23797497727	10	1.8835186151183323	3.5	4	6	0.37670372302366645	0.6666666666666666
23797497728	3	0.6932295716280911	1.0	1	2	0.34661478581404553	0.5
23797497729	9	1.7341453882927749	4.0	4	5	0.346829077658555	0.8
23797497730	3	0.6936999995656656	1.0	1	2	0.3468499997828328	0.5
23797497731	10	1.893886615217455	5.0	5	5	0.378777323043491	1.0
23797497732	2	0.694050160641444	0.0	0	2	0.347025080320722	0.0
23797497733	3	0.90770919001447	1.0	1	2	0.453854595007235	0.5
23797497734	4	0.8817181138021477	0.5	1	3	0.44085905690107385	0.3333333333333333
23797497735	1	0.3471442697638234	0.0	0	1	0.3471442697638234	0.0
23797497736	2	0.6944280652486108	0.0	0	2	0.3472140326243054	0.0
23797497737	2	0.3472400590196493	1.0	1	1	0.3472400590196493	1.0
23797497738	13	1.8251285486762783	4.0	6	7	0.36502570973525567	0.8571428571428571
23797497739	2	0.3474053417812835	1.0	1	1	0.3474053417812835	1.0
23797497740	9	2.2485895495032984	3.0	3	6	0.3747649249172164	0.5
23797497741	2	0.3477904516259713	1.0	1	1	0.3477904516259713	1.0
23797497742	19	4.621184367988046	6.0	6	13	0.3554757206144651	0.46153846153846156
23797497743	11	2.98269571302172	3.0	3	8	0.372836964127715	0.375
23797497744	10	1.9016732211320728	5.0	5	5	0.38033464422641455	1.0
23797497745	3	1.0438930612114894	0.0	0	3	0.3479643537371631	0.0
23797497746	32	8.407643686324764	9.0	9	23	0.3655497254923811	0.391304347826087
23797497747	1	0.34815950119824113	0.0	0	1	0.34815950119824113	0.0
23797497748	4	1.5535460424946728	0.5	1	3	0.7767730212473364	0.3333333333333333
23797497749	2	1.1459981790950673	0.0	0	2	0.5729990895475336	0.0
23797497750	18	5.8798873100851745	3.5	5	13	0.5345352100077432	0.38461538461538464
23797497751	3	1.0448217961263229	0.0	0	3	0.3482739320421076	0.0
23797497752	4	0.6966101747987256	2.0	2	2	0.3483050873993628	1.0
23797497753	32	7.962913733408299	10.0	10	22	0.36195062424583174	0.45454545454545453
23797497754	11	2.252748183648845	5.0	5	6	0.3754580306081408	0.8333333333333334
23797497755	3	1.0455038021600696	0.0	0	3	0.34850126738668985	0.0
23797497756	2	0.3485256552077689	1.0	1	1	0.3485256552077689	1.0
23797497757	15	5.482395736088581	1.0	1	14	0.39159969543489864	0.07142857142857142
23797497758	2	0.6161945389888701	0.0	0	2	0.6161945389888701	0.0
23797497759	3	0.37456460921333723	0.5	1	2	0.37456460921333723	0.5
23797497760	1	0.348628548693113	0.0	0	1	0.348628548693113	0.0
23797497761	25	5.679783251640867	9.0	9	16	0.3549864532275542	0.5625
23797497762	10	2.2539669125392248	4.0	4	6	0.3756611520898708	0.6666666666666666
23797497763	3	1.0461352368538337	0.0	0	3	0.34871174561794455	0.0
23797497764	2	0.3487361558852464	1.0	1	1	0.3487361558852464	1.0
23797497765	31	7.577929980377174	10.0	10	21	0.36085380858938926	0.47619047619047616
23797497766	2	0.6979312584651018	0.0	0	2	0.3489656292325509	0.0
23797497767	30	7.182914348210341	10.0	10	20	0.35914571741051704	0.5
23797497768	2	0.9493673818291384	0.0	0	2	0.4746836909145692	0.0
23797497769	7	5.08307349305235	0.0	0	7	0.7261533561503357	0.0
23797497770	2	0.3490957443746034	1.0	1	1	0.3490957443746034	1.0
23797497771	2	0.6982229695766926	0.0	0	2	0.3491114847883463	0.0
23797497772	3	0.6982674804365175	1.0	1	2	0.34913374021825877	0.5
23797497773	1	0.34913480080228637	0.0	0	1	0.34913480080228637	0.0
23797497774	4	2.378893037811302	0.0	0	4	0.5947232594528254	0.0
23797497775	1	0.3491593120775908	0.0	0	1	0.3491593120775908	0.0
23797497776	14	6.2335874032515886	4.0	4	10	0.6233587403251588	0.4
23797497777	2	0.6984637053162903	0.0	0	2	0.34923185265814516	0.0
23797497778	2	0.34926759265640844	1.0	1	1	0.34926759265640844	1.0
23797497779	20	4.640917695413532	7.0	7	13	0.356993668877964	0.5384615384615384
23797497780	2	1.2464129280546596	0.0	0	2	0.6232064640273298	0.0
23797497781	8	6.05980784843628	0.0	0	8	0.757475981054535	0.0
23797497782	2	0.7362538966783081	0.0	0	2	0.7362538966783081	0.0
23797497783	3	0.4446560487278766	0.5	1	2	0.4446560487278766	0.5
23797497784	6	1.1086664630569796	1.0	2	4	0.5543332315284898	0.5
23797497785	2	0.7362851081511202	0.0	0	2	0.7362851081511202	0.0
23797497786	1	0.3494125728095144	0.0	0	1	0.3494125728095144	0.0
23797497787	12	3.344036253522949	3.0	3	9	0.3715595837247721	0.3333333333333333
23797497788	14	5.434854636184831	4.0	4	10	0.543485463618483	0.4
23797497789	2	0.6989754791962739	0.0	0	2	0.34948773959813695	0.0
23797497790	2	0.34952512939377656	1.0	1	1	0.34952512939377656	1.0
23797497791	30	7.1924853951687275	10.0	10	20	0.35962426975843637	0.5
23797497792	1	0.3496124676467159	0.0	0	1	0.3496124676467159	0.0
23797497793	5	1.0446425405909918	0.5	1	4	0.5223212702954959	0.25
23797497794	10	1.91005675067289	5.0	5	5	0.382011350134578	1.0
23797497795	3	1.0491123803926363	0.0	0	3	0.3497041267975454	0.0
23797497796	3	0.6994585331341769	1.0	1	2	0.34972926656708847	0.5
23797497797	28	7.246937529950977	8.0	8	20	0.3623468764975489	0.4
23797497798	1	0.3498450554074348	0.0	0	1	0.3498450554074348	0.0
23797497799	5	2.657411191154716	0.5	1	4	0.8858037303849052	0.25
23797497800	3	1.7809394666784195	0.0	0	3	0.8904697333392098	0.0
23797497801	2	0.8904452052292382	0.0	0	2	0.8904452052292382	0.0
23797497802	2	0.8904759116620372	0.0	0	2	0.8904759116620372	0.0
23797497803	3	0.5919896882950276	0.5	1	2	0.5919896882950276	0.5
23797497804	13	4.161181567372826	5.0	5	8	0.5201476959216033	0.625
23797497805	3	1.0498490990944733	0.0	0	3	0.34994969969815776	0.0
23797497806	4	0.6999640445179978	2.0	2	2	0.3499820222589989	1.0
23797497807	24	5.702197499802782	8.0	8	16	0.3563873437376739	0.5
23797497808	7	3.2292312311222355	1.0	1	6	0.5382052051870393	0.16666666666666666
23797497809	4	1.5408931740374283	1.0	1	3	0.7704465870187142	0.3333333333333333
23797497810	13	5.170334710555003	5.0	5	8	0.6462918388193754	0.625
23797497811	1	0.35008989880580593	0.0	0	1	0.35008989880580593	0.0
23797497812	1	0.35010989839032636	0.0	0	1	0.35010989839032636	0.0
23797497813	3	1.096213859799613	1.0	1	2	0.5481069298998065	0.5
23797497814	3	0.7002989533853792	1.0	1	2	0.3501494766926896	0.5
23797497815	1	0.3501523217514303	0.0	0	1	0.3501523217514303	0.0
23797497816	4	1.0475581029175254	0.5	1	3	0.5237790514587627	0.3333333333333333
23797497817	1	0.3501801999601557	0.0	0	1	0.3501801999601557	0.0
23797497818	15	4.552698652691289	3.0	3	12	0.37939155439094074	0.25
23797497819	10	1.9126674708474911	5.0	5	5	0.3825334941694982	1.0
23797497820	3	1.050797463231151	0.0	0	3	0.35026582107705034	0.0
23797497821	2	0.35029582045383095	1.0	1	1	0.35029582045383095	1.0
23797497822	4	1.2937487123583997	1.0	1	3	0.6468743561791999	0.3333333333333333
23797497823	2	1.118541409425939	0.0	0	2	0.5592707047129695	0.0
23797497824	2	0.35043989153491323	1.0	1	1	0.35043989153491323	1.0
23797497825	3	1.855851109086387	0.0	0	3	0.618617036362129	0.0
23797497826	21	5.056694344093929	7.0	7	14	0.36119245314956633	0.5
23797497827	10	1.9157031990278184	5.0	5	5	0.3831406398055637	1.0
23797497828	3	1.051604247817478	0.0	0	3	0.3505347492724927	0.0
23797497829	4	0.7011170171986663	2.0	2	2	0.35055850859933313	1.0
23797497830	28	7.262682219699343	8.0	8	20	0.3631341109849672	0.4
23797497831	2	0.3506501901963855	1.0	1	1	0.3506501901963855	1.0
23797497832	3	0.7013552614075323	1.0	1	2	0.3506776307037662	0.5
23797497833	2	0.3506737923996663	1.0	1	1	0.3506737923996663	1.0
23797497834	10	1.9167053330912283	5.0	5	5	0.38334106661824563	1.0
23797497835	3	1.0522405645647026	0.0	0	3	0.35074685485490087	0.0
23797497836	3	0.7019945073868331	1.0	1	2	0.35099725369341656	0.5
23797497837	4	1.403834371521642	0.0	0	4	0.3509585928804105	0.0
23797497838	2	0.7019020177257598	0.0	0	2	0.3509510088628799	0.0
23797497839	2	0.3509809914049934	1.0	1	1	0.3509809914049934	1.0
23797497840	5	1.4040698548451032	1.0	1	4	0.3510174637112758	0.25
23797497841	3	1.8858878924973175	0.0	0	3	0.6286292974991058	0.0
23797497842	23	6.678721388178568	4.0	4	19	0.3515116520093983	0.21052631578947367
23797497843	2	0.702126962547613	0.0	0	2	0.3510634812738065	0.0
23797497844	21	7.156656139500401	3.0	3	18	0.3975920077500223	0.16666666666666666
23797497845	2	0.35118381547427113	1.0	1	1	0.35118381547427113	1.0
23797497846	29	7.536441919708269	10.0	10	19	0.39665483787938255	0.5263157894736842
23797497847	3	0.42513086512647197	0.5	1	2	0.42513086512647197	0.5
23797497848	1	0.3524680312196881	0.0	0	1	0.3524680312196881	0.0
23797497849	2	0.7180844761575156	0.0	0	2	0.3590422380787578	0.0
23797497850	3	0.5272411680875182	0.5	1	2	0.5272411680875182	0.5
23797497851	1	0.35249341789768207	0.0	0	1	0.35249341789768207	0.0
23797497852	6	1.7056580676421638	2.0	2	4	0.42641451691054094	0.5
23797497853	2	0.35254281081096733	1.0	1	1	0.35254281081096733	1.0
23797497854	9	1.9241458182501727	4.0	4	5	0.38482916365003456	0.8
23797497855	4	0.7052476384581505	2.0	2	2	0.35262381922907526	1.0
23797497856	47	20.522964792280245	11.0	11	36	0.570082355341118	0.3055555555555556
23797497857	2	0.7055322790095573	0.0	0	2	0.35276613950477864	0.0
23797497858	3	1.7280813728549815	0.0	0	3	0.8640406864274908	0.0
23797497859	2	1.3199729487101228	0.0	0	2	0.6599864743550614	0.0
23797497860	2	1.1876047558203926	0.0	0	2	0.5938023779101963	0.0
23797497861	19	9.440058804165583	3.0	3	16	0.5900036752603489	0.1875
23797497862	12	2.7866334561332513	1.5	3	9	0.5573266912266502	0.3333333333333333
23797497863	3	1.7928060215045365	0.0	0	3	0.5976020071681788	0.0
23797497864	7	4.447743122642874	0.0	0	7	0.6353918746632676	0.0
23797497865	51	27.58620085232572	1.5	3	48	0.689655021308143	0.0625
23797497866	8	4.844166604350341	0.0	0	8	0.6920238006214773	0.0
23797497867	3	0.3552785115541539	0.5	1	2	0.3552785115541539	0.5
23797497868	1	0.35321131544169604	0.0	0	1	0.35321131544169604	0.0
23797497869	2	1.1787668922837529	0.0	0	2	0.5893834461418764	0.0
23797497870	2	0.3532387222797425	1.0	1	1	0.3532387222797425	1.0
23797497871	2	0.35329151579578294	1.0	1	1	0.35329151579578294	1.0
23797497872	9	1.7666784834806633	4.0	4	5	0.35333569669613263	0.8
23797497873	3	0.7067190893711064	1.0	1	2	0.3533595446855532	0.5
23797497874	7	2.339666411643906	1.0	1	6	0.389944401940651	0.16666666666666666
23797497875	8	6.675002913239142	0.0	0	8	0.8343753641548928	0.0
23797497876	2	0.904762820247135	0.0	0	2	0.904762820247135	0.0
23797497877	8	6.916341131903086	0.0	0	8	0.8645426414878857	0.0
23797497878	1	0.3535814761019948	0.0	0	1	0.3535814761019948	0.0
23797497879	3	1.4521494620801985	0.0	0	3	0.7260747310400992	0.0
23797497880	4	2.048732152601409	0.0	0	4	0.5121830381503523	0.0
23797497881	10	1.9287876746802939	5.0	5	5	0.3857575349360588	1.0
23797497882	1	0.3536598919813686	0.0	0	1	0.3536598919813686	0.0
23797497883	30	7.325726802241181	10.0	10	20	0.366286340112059	0.5
23797497884	1	0.3538020102410667	0.0	0	1	0.3538020102410667	0.0
23797497885	2	0.9043790571758155	0.0	0	2	0.45218952858790773	0.0
23797497886	8	2.3809453520780393	2.0	2	6	0.3968242253463399	0.3333333333333333
23797497887	2	0.3539341287085046	1.0	1	1	0.3539341287085046	1.0
23797497888	26	6.118796858664585	9.0	9	17	0.35992922698026975	0.5294117647058824
23797497889	1	0.3540412645299591	0.0	0	1	0.3540412645299591	0.0
23797497890	1	0.3540524764182508	0.0	0	1	0.3540524764182508	0.0
23797497891	1	0.35407247600277125	0.0	0	1	0.35407247600277125	0.0
23797497892	8	1.57745298691943	4.0	4	4	0.3943632467298575	1.0
23797497893	3	1.0624522042757563	0.0	0	3	0.35415073475858544	0.0
23797497894	2	0.3541761775521364	1.0	1	1	0.3541761775521364	1.0
23797497895	1	0.35419466201661737	0.0	0	1	0.35419466201661737	0.0
23797497896	19	5.5613888088587515	4.0	4	15	0.3707592539239168	0.26666666666666666
23797497897	13	3.386682067917983	4.0	4	9	0.3762980075464426	0.4444444444444444
23797497898	9	1.9326082687103772	4.0	4	5	0.3865216537420754	0.8
23797497899	3	1.063108688954172	0.0	0	3	0.35436956298472405	0.0
23797497900	2	0.3543929407257768	1.0	1	1	0.3543929407257768	1.0
23797497901	8	5.588581240585003	0.0	0	8	0.6985726550731254	0.0
24532106548	3	0.558592772668662	0.5	1	2	0.558592772668662	0.5
24532106549	2	0.5912496026597697	0.0	0	2	0.29562480132988483	0.0
24532106550	3	0.9224858864043127	0.0	0	3	0.3074952954681042	0.0
24532106551	2	0.6039133126426296	0.0	0	2	0.3019566563213148	0.0
24532106552	4	0.4933638247313179	2.0	2	2	0.24668191236565895	1.0
24532106553	2	0.2467575673596276	1.0	1	1	0.2467575673596276	1.0
24532106554	9	1.395859352012788	4.0	4	5	0.2791718704025576	0.8
24532106555	2	0.4936338527916777	0.0	0	2	0.24681692639583885	0.0
24532106556	5	1.0744845805728547	2.0	2	3	0.3581615268576182	0.6666666666666666
24532106557	5	1.2349474760069798	0.0	0	5	0.24698949520139596	0.0
24532106558	5	1.3496456992795804	1.0	1	4	0.3374114248198951	0.25
24532106559	26	7.313335207817399	4.0	4	22	0.3324243276280636	0.18181818181818182
24532106560	4	0.9899630031254907	0.0	0	4	0.24749075078137267	0.0
24532106561	13	2.7248941663400457	2.0	2	11	0.24771765148545868	0.18181818181818182
24532106562	2	0.9970659195396513	0.0	0	2	0.9970659195396513	0.0
24532106563	6	3.2878141555106417	0.5	1	5	0.8219535388776604	0.2
24532106564	3	0.7407729610465668	0.5	1	2	0.7407729610465668	0.5
24532106565	2	0.9971007336312239	0.0	0	2	0.9971007336312239	0.0
24532106566	4	0.9912210577982269	0.0	0	4	0.24780526444955672	0.0
24532106567	2	0.495600646949523	0.0	0	2	0.2478003234747615	0.0
24532106568	5	1.2402646382733395	0.0	0	5	0.2480529276546679	0.0
24532106569	26	5.224122414695964	5.0	5	21	0.24876773403314115	0.23809523809523808
24532106570	4	0.9957573271962668	0.0	0	4	0.2489393317990667	0.0
24532106571	3	0.3927291476806694	0.5	1	2	0.3927291476806694	0.5
24532106572	1	0.24831901640292522	0.0	0	1	0.24831901640292522	0.0
24532106573	2	0.2483207335389699	1.0	1	1	0.2483207335389699	1.0
24532106574	3	0.49666951363333633	1.0	1	2	0.24833475681666817	0.5
24532106575	2	0.9630771980258861	0.0	0	2	0.48153859901294305	0.0
24532106576	2	0.24836143976402913	1.0	1	1	0.24836143976402913	1.0
24532106577	5	1.2421735211763445	0.0	0	5	0.2484347042352689	0.0
24532106578	2	0.49685563771284613	0.0	0	2	0.24842781885642307	0.0
24532106579	5	2.0671367870909885	1.0	1	4	0.5167841967727471	0.25
24532106580	16	3.501663719645959	8.0	8	8	0.4377079649557449	1.0
24532106581	4	1.184547849628848	0.5	1	3	0.592273924814424	0.3333333333333333
24532106582	2	1.246147310677081	0.0	0	2	0.6230736553385405	0.0
24532106583	5	0.977440637007642	2.0	2	3	0.325813545669214	0.6666666666666666
24532106584	3	0.5820532617218019	0.5	1	2	0.5820532617218019	0.5
24532106585	1	0.24868809964452926	0.0	0	1	0.24868809964452926	0.0
24532106586	2	0.6148000561739172	0.0	0	2	0.3074000280869586	0.0
24532106587	4	0.9950402377162737	0.0	0	4	0.24876005942906843	0.0
24532106588	1	0.2487526100888746	0.0	0	1	0.2487526100888746	0.0
24532106589	8	1.9996876495865388	0.0	0	8	0.24996095619831735	0.0
24532106590	12	2.33858616472513	6.0	6	6	0.38976436078752164	1.0
24532106591	7	4.204355518944269	0.5	1	6	0.8408711037888539	0.16666666666666666
24532106592	2	0.9439488748668083	0.0	0	2	0.9439488748668083	0.0
24532106593	5	3.8967668247430685	0.0	0	5	0.7793533649486137	0.0
24532106594	5	1.1217020508361828	0.5	1	4	0.5608510254180914	0.25
24532106595	2	0.9439820054916704	0.0	0	2	0.9439820054916704	0.0
24532106596	2	0.9439914329052491	0.0	0	2	0.9439914329052491	0.0
24532106597	6	1.2677374345455519	1.5	2	4	0.4225791448485173	0.5
24532106598	5	1.4459291535930046	0.5	1	4	0.7229645767965023	0.25
24532106599	1	0.24912108728246285	0.0	0	1	0.24912108728246285	0.0
24532106600	4	0.9974641604246808	0.0	0	4	0.2493660401061702	0.0
24532106601	1	0.24936034157135523	0.0	0	1	0.24936034157135523	0.0
24532106602	2	0.24961973012210487	1.0	1	1	0.24961973012210487	1.0
24532106603	1	0.24960087529494757	0.0	0	1	0.24960087529494757	0.0
24532106604	2	0.6411554009130518	0.0	0	2	0.3205777004565259	0.0
24532106605	2	0.2496137369806156	1.0	1	1	0.2496137369806156	1.0
24532106606	4	0.9987169626812803	0.0	0	4	0.24967924067032007	0.0
24532106607	25	5.256117642269855	4.0	4	21	0.2502913162985645	0.19047619047619047
24532106608	3	0.5830569109052516	0.5	1	2	0.5830569109052516	0.5
24532106609	3	0.5093075339141945	0.5	1	2	0.5093075339141945	0.5
24532106610	2	0.852998811438833	0.0	0	2	0.852998811438833	0.0
24532106611	1	0.24989962329738807	0.0	0	1	0.24989962329738807	0.0
24532106612	1	0.2499068958735773	0.0	0	1	0.2499068958735773	0.0
24532106613	2	0.24992245110598207	1.0	1	1	0.24992245110598207	1.0
24532106614	2	0.7095604781543764	0.0	0	2	0.3547802390771882	0.0
24532106615	2	0.4999636202843867	0.0	0	2	0.24998181014219334	0.0
24532106616	5	3.215889420748397	0.0	0	5	0.6431778841496794	0.0
24532106617	3	0.3343302262037183	0.5	1	2	0.3343302262037183	0.5
24532106618	1	0.25022924607929864	0.0	0	1	0.25022924607929864	0.0
24532106619	1	0.2502492793331533	0.0	0	1	0.2502492793331533	0.0
24532106620	3	0.5005382211420053	1.0	1	2	0.25026911057100265	0.5
24532106621	2	0.2502804908059654	1.0	1	1	0.2502804908059654	1.0
24532106622	4	1.001432125130599	0.0	0	4	0.2503580312826498	0.0
24532106623	12	4.935663222080538	4.0	4	8	0.6169579027600672	0.5
24532106624	10	2.0343355156561227	5.0	5	5	0.40686710313122454	1.0
24532106625	2	0.2505913597687213	1.0	1	1	0.2505913597687213	1.0
24532106626	7	3.151167128952237	0.5	1	6	0.6302334257904474	0.16666666666666666
24532106627	1	0.2505992047235921	0.0	0	1	0.2505992047235921	0.0
24532106628	2	0.9660867988028665	0.0	0	2	0.48304339940143326	0.0
24532106629	5	1.2534904914601608	0.0	0	5	0.25069809829203216	0.0
24532106630	1	0.2506875867258919	0.0	0	1	0.2506875867258919	0.0
24532106631	4	1.7241910833030842	1.0	1	3	0.574730361101028	0.3333333333333333
24532106632	3	0.7528360101071301	0.0	0	3	0.2509453367023767	0.0
24532106633	2	0.2509842135602772	1.0	1	1	0.2509842135602772	1.0
24532106634	1	0.25234930304646536	0.0	0	1	0.25234930304646536	0.0
24532106635	4	1.0834077622023812	1.0	1	3	0.5417038811011906	0.3333333333333333
24532106636	2	0.2523747570631277	1.0	1	1	0.2523747570631277	1.0
24532106637	1	0.2523826020179985	0.0	0	1	0.2523826020179985	0.0
24532106638	2	0.2523992683384322	1.0	1	1	0.2523992683384322	1.0
24532106639	1	0.2525906448340787	0.0	0	1	0.2525906448340787	0.0
24532106640	2	0.25260185672237045	1.0	1	1	0.25260185672237045	1.0
24532106641	22	4.028334461873301	7.0	7	15	0.26855563079155337	0.4666666666666667
24532106642	6	0.578734475448776	2.0	3	3	0.289367237724388	1.0
24532106643	2	0.2528688882119856	1.0	1	1	0.2528688882119856	1.0
24532106644	11	1.5762716983286913	4.5	5	6	0.31525433966573824	0.8333333333333334
24532106645	2	0.5058147108526398	0.0	0	2	0.2529073554263199	0.0
24532106646	55	18.203774184219807	16.0	16	39	0.47904668905841596	0.41025641025641024
24532106647	3	0.5240051073686449	1.0	1	2	0.26200255368432246	0.5
24532106648	1	0.2530771330440711	0.0	0	1	0.2530771330440711	0.0
24532106649	2	0.2530971326285915	1.0	1	1	0.2530971326285915	1.0
24532106650	22	12.430131602989931	2.0	2	20	0.6215065801494966	0.1
24532106651	51	22.93932627729586	7.5	9	42	0.6199817912782665	0.21428571428571427
24532106652	29	20.155198594022476	1.0	1	28	0.7464888368156473	0.03571428571428571
24532106653	33	23.685874067868692	0.5	1	32	0.7895291355956231	0.03125
24532106654	12	1.5962620237821996	3.0	5	7	0.3990655059455499	0.7142857142857143
24532106655	14	3.1835190494527437	2.5	4	10	0.5305865082421239	0.4
24532106656	3	0.5071869382376804	1.0	1	2	0.2535934691188402	0.5
24532106657	5	0.7842608791595138	1.0	2	3	0.3921304395797569	0.6666666666666666
24532106658	19	3.9478162356021094	2.0	3	16	0.3588923850547372	0.1875
24532106659	18	4.094455074788513	2.0	2	16	0.29246107677060806	0.125
24532106660	2	0.2538172186793291	1.0	1	1	0.2538172186793291	1.0
24532106661	28	15.391189011325928	2.0	3	25	0.6995995005148149	0.12
24532106662	14	3.093623778926882	2.0	2	12	0.34373597543632023	0.16666666666666666
24532106663	5	1.3013101714351591	0.0	0	5	0.43377005714505307	0.0
24532106664	7	4.172495372739227	1.0	1	6	0.6954158954565378	0.16666666666666666
24532106665	3	0.5831440134728514	1.0	1	2	0.2915720067364257	0.5
24532106666	19	4.361165863995351	6.0	6	13	0.33547429723041167	0.46153846153846156
24532106667	4	0.5104403049943373	2.0	2	2	0.2552201524971687	1.0
24532106668	5	1.1943860290848505	1.0	1	4	0.2985965072712126	0.25
24532106669	4	0.5103439096904956	2.0	2	2	0.2551719548452478	1.0
24532106670	4	0.9790436676786883	2.0	2	2	0.48952183383934417	1.0
24532106671	11	1.6851950920750232	5.0	5	6	0.2808658486791705	0.8333333333333334
24532106672	3	0.8091801931252809	0.0	0	3	0.40459009656264044	0.0
24532106673	45	17.88523389934963	11.0	11	34	0.5260362911573421	0.3235294117647059
24532106674	26	10.301325895014234	4.0	4	22	0.4682420861370106	0.18181818181818182
24532106675	9	2.325434720766912	1.0	2	7	0.46508694415338236	0.2857142857142857
24532106676	4	1.8475777792764374	0.0	0	4	0.46189444481910935	0.0
24532106677	52	24.01764912829925	9.0	10	42	0.6158371571358783	0.23809523809523808
24532106678	28	18.245403487745723	1.0	1	27	0.7017462879902201	0.037037037037037035
24532106679	7	1.655479547781785	0.5	1	6	0.5518265159272616	0.16666666666666666
24532106680	9	1.5686525973517655	2.0	4	5	0.5228841991172551	0.8
24532106681	50	10.210649091902702	11.0	11	39	0.26181151517699236	0.28205128205128205
24532106682	2	0.255756134628449	1.0	1	1	0.255756134628449	1.0
24532106683	3	0.3814209987624163	0.5	1	2	0.3814209987624163	0.5
24532106684	44	8.263081436995062	13.0	13	31	0.2665510140966149	0.41935483870967744
24532106685	3	0.5116059710140028	1.0	1	2	0.2558029855070014	0.5
24532106686	11	1.6884569098345665	5.0	5	6	0.28140948497242774	0.8333333333333334
24532106687	3	0.5117341501693382	1.0	1	2	0.2558670750846691	0.5
24532106688	14	2.8697555340348657	7.0	7	7	0.4099650762906951	1.0
24532106689	7	1.2900245809708264	3.0	3	4	0.3225061452427066	0.75
24532106690	5	1.549520940928601	0.5	1	4	0.5165069803095337	0.25
24532106691	15	3.5170683154494733	6.5	7	8	0.5024383307784962	0.875
24532106692	2	0.7185861492372364	0.0	0	2	0.7185861492372364	0.0
24532106693	4	0.7550559639888963	0.5	1	3	0.37752798199444815	0.3333333333333333
24532106694	8	6.185865195999127	0.0	0	8	0.7732331494998909	0.0
24532106695	1	0.2560366001824137	0.0	0	1	0.2560366001824137	0.0
24532106696	3	0.3224382510302732	0.5	1	2	0.3224382510302732	0.5
24532106697	4	1.5191007311396931	0.0	0	4	0.7595503655698466	0.0
24532106698	4	1.4372511183858572	1.0	1	3	0.7186255591929286	0.3333333333333333
24532106699	6	1.0333434150543068	2.0	2	4	0.2583358537635767	0.5
24532106700	10	1.690152834198697	4.0	4	6	0.2816921390331162	0.6666666666666666
24532106701	2	0.2561591228896019	1.0	1	1	0.2561591228896019	1.0
24532106702	2	0.8771652454223425	0.0	0	2	0.8771652454223425	0.0
24532106703	3	0.726144948436593	0.5	1	2	0.726144948436593	0.5
24532106704	3	0.4997857115224239	0.5	1	2	0.4997857115224239	0.5
24532106705	1	0.2563032949786868	0.0	0	1	0.2563032949786868	0.0
24532106706	1	0.2563084800561551	0.0	0	1	0.2563084800561551	0.0
24532106707	2	0.25631450686697854	1.0	1	1	0.25631450686697854	1.0
24532106708	6	1.0340443095845449	2.0	2	4	0.2585110773961362	0.5
24532106709	38	7.195595498908321	11.0	11	27	0.26650353699660445	0.4074074074074074
24532106710	2	0.2563706336471057	1.0	1	1	0.2563706336471057	1.0
24532106711	9	1.2821025569940179	4.0	4	5	0.25642051139880356	0.8
24532106712	4	0.5128832172072385	2.0	2	2	0.25644160860361925	1.0
24532106713	2	0.2565289805258928	1.0	1	1	0.2565289805258928	1.0
24532106714	10	1.4362740343070985	5.0	5	5	0.2872548068614197	1.0
24532106715	44	8.17899708952174	13.0	13	31	0.26383861579102386	0.41935483870967744
24532106716	4	2.6147634239382973	0.0	0	4	0.6536908559845743	0.0
24532106717	11	4.7951782281155975	3.0	3	8	0.5993972785144497	0.375
24532106718	3	1.1140251396124194	1.0	1	2	0.5570125698062097	0.5
24532106719	9	1.2841124815689855	4.0	4	5	0.2568224963137971	0.8
24532106720	2	0.513628353242628	0.0	0	2	0.256814176621314	0.0
24532106721	2	0.25684217267270915	1.0	1	1	0.25684217267270915	1.0
24532106722	7	2.721048960026655	2.0	2	5	0.544209792005331	0.4
24532106723	5	3.450395592791894	0.0	0	5	0.6900791185583788	0.0
24532106724	5	1.5323897143281568	0.5	1	4	0.7661948571640784	0.25
24532106725	3	1.4859568742292457	0.0	0	3	0.49531895807641524	0.0
24532106726	3	0.5025669668747959	0.5	1	2	0.5025669668747959	0.5
24532106727	2	0.9267871101802363	0.0	0	2	0.9267871101802363	0.0
24532106728	3	0.47467916238911806	0.5	1	2	0.47467916238911806	0.5
24532106729	1	0.2569642913478868	0.0	0	1	0.2569642913478868	0.0
24532106730	6	0.7867287740183984	3.0	3	3	0.26224292467279947	1.0
24532106731	39	7.529940270264419	11.0	11	28	0.26892643822372925	0.39285714285714285
24532106732	4	0.5140235302182443	2.0	2	2	0.25701176510912216	1.0
24532106733	11	1.6958260160049874	5.0	5	6	0.28263766933416457	0.8333333333333334
24532106734	4	1.3943222795674584	1.0	1	3	0.4647740931891528	0.3333333333333333
24532106735	2	0.25716307509705943	1.0	1	1	0.25716307509705943	1.0
24532106736	2	0.9480056929457055	0.0	0	2	0.47400284647285273	0.0
24532106737	1	0.2571748593640327	0.0	0	1	0.2571748593640327	0.0
24532106738	3	0.5144200876365632	1.0	1	2	0.2572100438182816	0.5
24532106739	10	1.4397779345796082	5.0	5	5	0.28795558691592166	1.0
24532106740	2	0.25727822422005575	1.0	1	1	0.25727822422005575	1.0
24532106741	2	0.5933460574236555	0.0	0	2	0.5933460574236555	0.0
24532106742	2	0.5933572693119473	0.0	0	2	0.5933572693119473	0.0
24532106743	4	0.7729218554617905	1.0	1	3	0.2576406184872635	0.3333333333333333
24532106744	41	7.7391462271642375	12.0	12	29	0.2668671112815254	0.41379310344827586
24532106745	2	0.2574689273290181	1.0	1	1	0.2574689273290181	1.0
24532106746	19	4.855236138697051	5.5	6	13	0.4413851035179137	0.46153846153846156
24532106747	2	0.25754454865365256	1.0	1	1	0.25754454865365256	1.0
24532106748	5	1.5980085868249807	0.5	1	4	0.7990042934124904	0.25
24532106749	3	0.6893929509949238	0.5	1	2	0.6893929509949238	0.5
24532106750	4	1.1811257658384673	1.0	1	3	0.5905628829192336	0.3333333333333333
24532106751	2	0.9234894345797597	0.0	0	2	0.9234894345797597	0.0
24532106752	1	0.25763939516812057	0.0	0	1	0.25763939516812057	0.0
24532106753	2	0.2576433008108889	1.0	1	1	0.2576433008108889	1.0
24532106754	1	0.2576559268112174	0.0	0	1	0.2576559268112174	0.0
24532106755	3	0.5153954209099427	1.0	1	2	0.25769771045497136	0.5
24532106756	9	1.442079805951506	4.0	4	5	0.2884159611903012	0.8
24532106757	2	0.2577728604089269	1.0	1	1	0.2577728604089269	1.0
24532106758	42	7.412470791431705	14.0	14	28	0.26473109969398945	0.5
24532106759	3	2.2281136785811553	0.0	0	3	0.7427045595270517	0.0
24532106760	4	2.092621476516801	0.0	0	4	0.697540492172267	0.0
24532106761	3	0.5255524152915746	0.5	1	2	0.5255524152915746	0.5
24532106762	1	0.25789437303608875	0.0	0	1	0.25789437303608875	0.0
24532106763	3	0.5158142000888399	1.0	1	2	0.25790710004441997	0.5
24532106764	1	0.2579048105296937	0.0	0	1	0.2579048105296937	0.0
24532106765	2	0.25790534923904107	1.0	1	1	0.25790534923904107	1.0
24532106766	1	0.25790561859371475	0.0	0	1	0.25790561859371475	0.0
24532106767	2	0.2579379074852216	1.0	1	1	0.2579379074852216	1.0
24532106768	8	1.9703810193572746	0.5	1	7	0.3940762038714549	0.14285714285714285
24532106769	2	0.515967260882156	0.0	0	2	0.257983630441078	0.0
24532106770	5	1.7455187883807264	1.0	1	4	0.4363796970951816	0.25
24532106771	28	5.420658567463429	8.0	8	20	0.27103292837317144	0.4
24532106772	4	0.5163906864291742	2.0	2	2	0.2581953432145871	1.0
24532106773	8	1.669014317109978	0.5	1	7	0.3338028634219956	0.14285714285714285
24532106774	4	0.5165216601392489	2.0	2	2	0.25826083006962447	1.0
24532106775	5	1.4937282279354667	0.5	1	4	0.4979094093118222	0.25
24532106776	3	1.5248457969745206	0.0	0	3	0.5082819323248402	0.0
24532106777	4	0.5238818102667699	2.0	2	2	0.26194090513338497	1.0
24532106778	2	0.25839611345447805	1.0	1	1	0.25839611345447805	1.0
24532106779	18	6.549214718333966	1.5	3	15	0.5953831562121787	0.2
24532106780	30	5.39864148276785	10.0	10	20	0.2699320741383925	0.5
24532106781	5	4.072640241783529	0.0	0	5	0.8145280483567058	0.0
24532106782	6	4.6220158995350165	0.0	0	6	0.7703359832558361	0.0
24532106783	3	0.3102561472039453	0.5	1	2	0.3102561472039453	0.5
24532106784	2	0.5171576738624655	0.0	0	2	0.25857883693123274	0.0
24532106785	2	0.7392578073378071	0.0	0	2	0.7392578073378071	0.0
24532106786	4	1.3845045710666548	0.0	0	4	0.4615015236888849	0.0
24532106787	1	0.258581597816638	0.0	0	1	0.258581597816638	0.0
24532106788	2	0.7392723524901856	0.0	0	2	0.7392723524901856	0.0
24532106789	7	1.312421657772295	0.5	1	6	0.262484331554459	0.16666666666666666
24532106790	2	0.5173259868641786	0.0	0	2	0.2586629934320893	0.0
24532106791	5	0.9033545330051561	2.0	2	3	0.3011181776683854	0.6666666666666666
24532106792	15	3.329349858287456	3.0	3	12	0.27744582152395464	0.25
24532106793	10	2.7940363663152183	4.0	4	6	0.46567272771920304	0.6666666666666666
24532106794	3	1.5956292086457329	0.0	0	3	0.531876402881911	0.0
24532106795	5	1.2204006738311195	0.5	1	4	0.6102003369155597	0.25
24532106796	1	0.25881270412665164	0.0	0	1	0.25881270412665164	0.0
24532106797	3	0.5176655084303468	1.0	1	2	0.2588327542151734	0.5
24532106798	1	0.25883543092724304	0.0	0	1	0.25883543092724304	0.0
24532106799	14	2.4402712913337794	5.0	5	9	0.27114125459264216	0.5555555555555556
24532106800	6	1.8086748837574655	0.0	0	6	0.36173497675149313	0.0
24532106801	2	0.517806044231337	0.0	0	2	0.2589030221156685	0.0
24532106802	3	0.5749345207205628	1.0	1	2	0.2874672603602814	0.5
24532106803	28	5.460900795427921	8.0	8	20	0.27304503977139605	0.4
24532106804	7	1.977523766593805	3.0	3	4	0.49438094164845126	0.75
24532106805	9	3.0453212133606518	4.0	4	5	0.6090642426721303	0.8
24532106806	4	0.5313286925992143	0.3333333333333333	1	3	0.5313286925992143	0.3333333333333333
24532106807	5	3.7202807268279985	0.0	0	5	0.7440561453655997	0.0
24532106808	1	0.2590768400535248	0.0	0	1	0.2590768400535248	0.0
24532106809	1	0.2590846850083956	0.0	0	1	0.2590846850083956	0.0
24532106810	2	0.7365429815818304	0.0	0	2	0.3682714907909152	0.0
24532106811	8	1.6521715693650405	0.5	1	7	0.3304343138730081	0.14285714285714285
24532106812	3	0.7775585604837771	0.0	0	3	0.2591861868279257	0.0
24532106813	4	0.518419937201978	2.0	2	2	0.259209968600989	1.0
24532106814	30	5.782220416498418	9.0	9	21	0.2753438293570675	0.42857142857142855
24532106815	4	0.7394444701266644	0.3333333333333333	1	3	0.7394444701266644	0.3333333333333333
24532106816	1	0.259337440700306	0.0	0	1	0.259337440700306	0.0
24532106817	2	1.0912317747473057	0.0	0	2	0.5456158873736529	0.0
24532106818	1	0.2593492249672793	0.0	0	1	0.2593492249672793	0.0
24532106819	10	2.649959830800822	1.5	2	8	0.3785656901144031	0.25
24532106820	3	0.778259556022018	0.0	0	3	0.25941985200733936	0.0
24532106821	25	4.638263171435126	8.0	8	17	0.2728390100844192	0.47058823529411764
24532106822	10	2.357021269962169	2.0	2	8	0.29462765874527114	0.25
24532106823	11	2.200900944246377	1.0	2	9	0.3668168240410628	0.2222222222222222
24532106824	3	0.7789783963073897	0.0	0	3	0.2596594654357966	0.0
24532106825	3	0.5750365388032175	1.0	1	2	0.28751826940160874	0.5
24532106826	27	4.843022924405914	9.0	9	18	0.2690568291336619	0.5
24532106827	4	1.145356576262372	1.0	1	3	0.572678288131186	0.3333333333333333
24532106828	1	0.25979699344293083	0.0	0	1	0.25979699344293083	0.0
24532106829	1	0.25981160593397773	0.0	0	1	0.25981160593397773	0.0
24532106830	3	0.5196443898791732	1.0	1	2	0.2598221949395866	0.5
24532106831	2	0.2598427837374557	1.0	1	1	0.2598427837374557	1.0
24532106832	8	1.8607047792980191	0.5	1	7	0.37214095585960383	0.14285714285714285
24532106833	3	0.7797635651811544	0.0	0	3	0.25992118839371814	0.0
24532106834	3	0.5749867418579216	1.0	1	2	0.2874933709289608	0.5
24532106835	29	5.478493157229696	9.0	9	20	0.2739246578614848	0.45
24532106836	13	1.8649352638027688	2.0	4	9	0.37298705276055377	0.4444444444444444
24532106837	3	0.7802353062227629	0.0	0	3	0.2600784354075876	0.0
24532106838	3	0.5749151271840581	1.0	1	2	0.28745756359202906	0.5
24532106839	29	5.485714758046946	9.0	9	20	0.2742857379023473	0.45
24532106840	3	0.5620265733873475	0.5	1	2	0.5620265733873475	0.5
24532106841	3	0.8874548969807597	1.0	1	2	0.44372744849037987	0.5
24532106842	2	0.26026284235105285	1.0	1	1	0.26026284235105285	1.0
24532106843	1	0.26027398690067616	0.0	0	1	0.26027398690067616	0.0
24532106844	1	0.2602779262127787	0.0	0	1	0.2602779262127787	0.0
24532106845	7	1.467803008940858	0.5	1	6	0.2935606017881716	0.16666666666666666
24532106846	3	0.781039228915682	0.0	0	3	0.26034640963856065	0.0
24532106847	4	0.5207444006971302	2.0	2	2	0.2603722003485651	1.0
24532106848	17	3.665790343682086	4.0	4	13	0.28198387259092966	0.3076923076923077
24532106849	1	0.2604447240944523	0.0	0	1	0.2604447240944523	0.0
24532106850	3	0.5209209290163905	1.0	1	2	0.26046046450819527	0.5
24532106851	3	0.5209708943083573	1.0	1	2	0.26048544715417865	0.5
24532106852	2	0.7037504641738588	0.0	0	2	0.3518752320869294	0.0
24532106853	16	2.715635873827133	6.0	6	10	0.2715635873827133	0.6
24532106854	5	1.302834348525487	0.0	0	5	0.2605668697050974	0.0
24532106855	3	0.7816921109753376	0.0	0	3	0.2605640369917792	0.0
24532106856	4	0.5211953677595318	2.0	2	2	0.2605976838797659	1.0
24532106857	30	5.810080746807382	9.0	9	21	0.2766705117527325	0.42857142857142855
24532106858	5	0.41399251066063714	0.6666666666666666	2	3	0.41399251066063714	0.6666666666666666
24532106859	2	0.521430278704311	0.0	0	2	0.2607151393521555	0.0
24532106860	2	0.603762911726716	0.0	0	2	0.603762911726716	0.0
24532106861	9	1.4629332784568079	4.0	4	5	0.29258665569136155	0.8
24532106862	2	0.5215537778221914	0.0	0	2	0.2607768889110957	0.0
24532106863	3	0.5216274126561075	1.0	1	2	0.26081370632805373	0.5
24532106864	29	5.495858621388235	9.0	9	20	0.27479293106941177	0.45
24532106865	9	1.4637712408466128	4.0	4	5	0.29275424816932255	0.8
24532106866	2	0.5218809764120389	0.0	0	2	0.26094048820601945	0.0
24532106867	3	0.574910750170611	1.0	1	2	0.2874553750853055	0.5
24532106868	25	4.979850889966361	7.0	7	18	0.27665838277590893	0.3888888888888889
24532106869	3	0.4761715219586179	0.5	1	2	0.4761715219586179	0.5
24532106870	2	0.8640846080739669	0.0	0	2	0.43204230403698346	0.0
24532106871	2	0.9597038000927725	0.0	0	2	0.9597038000927725	0.0
24532106872	3	0.6728636647514764	0.5	1	2	0.6728636647514764	0.5
24532106873	1	0.2611000976848393	0.0	0	1	0.2611000976848393	0.0
24532106874	2	0.2611113095731311	1.0	1	1	0.2611113095731311	1.0
24532106875	5	0.8385446672707169	2.0	2	3	0.27951488909023897	0.6666666666666666
24532106876	9	1.3059151936136546	4.0	4	5	0.2611830387227309	0.8
24532106877	2	0.522347330360174	0.0	0	2	0.261173665180087	0.0
24532106878	3	0.5749204469388632	1.0	1	2	0.2874602234694316	0.5
24532106879	7	5.840192511825596	0.0	0	7	0.8343132159750851	0.0
24532106880	2	0.6378536176538016	0.0	0	2	0.6378536176538016	0.0
24532106881	2	0.6460340874400017	0.0	0	2	0.32301704372000084	0.0
24532106882	1	0.26134123745644744	0.0	0	1	0.26134123745644744	0.0
24532106883	3	0.2963096019183709	0.5	1	2	0.2963096019183709	0.5
24532106884	1	0.26133332516290825	0.0	0	1	0.26133332516290825	0.0
24532106885	2	1.163676061005736	0.0	0	2	0.581838030502868	0.0
24532106886	1	0.2613543348274549	0.0	0	1	0.2613543348274549	0.0
24532106887	9	1.3085987068888165	4.0	4	5	0.2617197413777633	0.8
24532106888	26	6.447212527605068	5.0	5	21	0.3070101203621461	0.23809523809523808
24532106889	1	0.2614153773303767	0.0	0	1	0.2614153773303767	0.0
24532106890	2	0.5256168583972515	0.0	0	2	0.26280842919862574	0.0
24532106891	10	5.110487468997698	2.0	2	8	0.6388109336247122	0.25
24532106892	4	1.0524803912322764	0.0	0	4	0.2631200978080691	0.0
24532106893	1	0.2614573629901359	0.0	0	1	0.2614573629901359	0.0
24532106894	2	0.5229751287658435	0.0	0	2	0.26148756438292176	0.0
24532106895	2	0.5229944886330139	0.0	0	2	0.26149724431650695	0.0
24532106896	2	0.5244348290811601	0.0	0	2	0.26221741454058006	0.0
24532106897	1	0.2615222774664917	0.0	0	1	0.2615222774664917	0.0
24532106898	3	0.863127523579729	0.0	0	3	0.28770917452657635	0.0
24532106899	4	0.5231667409468295	2.0	2	2	0.26158337047341473	1.0
24532106900	3	0.524477723812943	1.0	1	2	0.2622388619064715	0.5
24532106901	12	2.3819743206008144	3.0	3	9	0.2646638134000905	0.3333333333333333
24532106902	1	0.26289224900614017	0.0	0	1	0.26289224900614017	0.0
24532106903	1	0.2629038649264424	0.0	0	1	0.2629038649264424	0.0
24532106904	1	0.26293817397800184	0.0	0	1	0.26293817397800184	0.0
24532106905	2	0.5260008571539103	0.0	0	2	0.26300042857695516	0.0
24532106906	2	0.5260082307381022	0.0	0	2	0.2630041153690511	0.0
24532106907	1	0.2630397206899776	0.0	0	1	0.2630397206899776	0.0
24532106908	2	0.5261306524372877	0.0	0	2	0.26306532621864387	0.0
24532106909	2	0.5261772844651678	0.0	0	2	0.2630886422325839	0.0
24532106910	2	1.077677409866603	0.0	0	2	0.5388387049333015	0.0
24532106911	1	0.26312638555623274	0.0	0	1	0.26312638555623274	0.0
24532106912	1	0.2631375974445245	0.0	0	1	0.2631375974445245	0.0
24532106913	1	0.2631512335248793	0.0	0	1	0.2631512335248793	0.0
24532106914	1	0.2631607619464606	0.0	0	1	0.2631607619464606	0.0
24532106915	1	0.2631764855255364	0.0	0	1	0.2631764855255364	0.0
24532106916	4	1.6518241355053331	0.0	0	4	0.4129560338763333	0.0
24532106917	2	1.2453592125712405	0.0	0	2	0.6226796062856202	0.0
24532106918	1	0.2632106262304248	0.0	0	1	0.2632106262304248	0.0
24532106919	7	4.91531768515112	0.0	0	7	0.7021882407358743	0.0
24532106920	1	0.2632364169404292	0.0	0	1	0.2632364169404292	0.0
24532106921	7	4.001990968739808	0.0	0	7	0.5717129955342583	0.0
24532106922	3	1.8956495078873277	0.0	0	3	0.6318831692957759	0.0
24532106923	1	0.26330806528362694	0.0	0	1	0.26330806528362694	0.0
24532106924	2	0.5266365678531191	0.0	0	2	0.26331828392655954	0.0
24532106925	5	2.5700921634052247	0.0	0	5	0.6425230408513062	0.0
24532106926	6	1.1924215581110655	2.0	2	4	0.2981053895277664	0.5
24532106927	3	0.8655518166508124	0.0	0	3	0.28851727221693746	0.0
24532106928	1	0.2633936864005216	0.0	0	1	0.2633936864005216	0.0
24532106929	2	0.5268149143164265	0.0	0	2	0.26340745715821323	0.0
24532106930	2	0.9157870356699997	0.0	0	2	0.4578935178349999	0.0
24532106931	2	0.526898582611937	0.0	0	2	0.2634492913059685	0.0
24532106932	3	0.8286603944961817	0.0	0	3	0.2762201314987272	0.0
24532106933	1	0.26350210165667604	0.0	0	1	0.26350210165667604	0.0
24532106934	1	0.2635260068839647	0.0	0	1	0.2635260068839647	0.0
24532106935	2	0.5271768596591782	0.0	0	2	0.2635884298295891	0.0
24532106936	2	0.5271301266232954	0.0	0	2	0.2635650633116477	0.0
24532106937	3	1.587870918641185	0.0	0	3	0.5292903062137283	0.0
24532106938	3	1.1324740829458189	0.0	0	3	0.37749136098193964	0.0
24532106939	2	0.5272378011540972	0.0	0	2	0.2636189005770486	0.0
24532106940	2	0.5273726131682719	0.0	0	2	0.26368630658413594	0.0
24532106941	2	0.5273636571253721	0.0	0	2	0.26368182856268607	0.0
24532106942	1	0.263683747714736	0.0	0	1	0.263683747714736	0.0
24532106943	3	1.1977677770128479	0.0	0	3	0.3992559256709493	0.0
24532106944	1	0.2637209859983717	0.0	0	1	0.2637209859983717	0.0
24532106945	3	0.8287772607552226	0.0	0	3	0.27625908691840756	0.0
24532106946	1	0.2637442178389762	0.0	0	1	0.2637442178389762	0.0
24532106947	1	0.2637800420105751	0.0	0	1	0.2637800420105751	0.0
24532106948	3	1.9260729499323197	0.0	0	3	0.6420243166441065	0.0
24532106949	1	0.2638214889609869	0.0	0	1	0.2638214889609869	0.0
24532106950	1	0.2638327008492787	0.0	0	1	0.2638327008492787	0.0
24532106951	4	2.049854048486602	0.0	0	4	0.6832846828288673	0.0
24532106952	2	0.5278314925242125	0.0	0	2	0.26391574626210623	0.0
24532106953	3	0.8286144695243199	0.0	0	3	0.2762048231747733	0.0
24532106954	1	0.2639230693422968	0.0	0	1	0.2639230693422968	0.0
24532106955	1	0.26396970137017695	0.0	0	1	0.26396970137017695	0.0
24532106956	10	2.2720793308772	3.0	4	6	0.45441586617544	0.6666666666666666
24532106957	1	0.2640127644486308	0.0	0	1	0.2640127644486308	0.0
24532106958	1	0.26404350455076403	0.0	0	1	0.26404350455076403	0.0
24532106959	4	0.8865075765934425	1.0	1	3	0.2955025255311475	0.3333333333333333
24532106960	3	1.3289963639475908	0.0	0	3	0.4429987879825303	0.0
24532106961	2	0.5282328983266577	0.0	0	2	0.2641164491633288	0.0
24532106962	1	0.26411653333666435	0.0	0	1	0.26411653333666435	0.0
24532106963	2	0.5875047646316574	0.0	0	2	0.2937523823158287	0.0
24532106964	2	0.5283147484781208	0.0	0	2	0.2641573742390604	0.0
24532106965	2	0.2656268049919636	1.0	1	1	0.2656268049919636	1.0
24532106966	23	12.40184791447262	0.0	0	23	0.6527288376038222	0.0
24532106967	46	14.022129742287843	9.0	12	34	0.5608851896915137	0.35294117647058826
24532106968	1	0.26573902488288376	0.0	0	1	0.26573902488288376	0.0
24532106969	4	1.2386466920872383	0.5	1	3	0.6193233460436192	0.3333333333333333
24532106970	2	0.26579309783362415	1.0	1	1	0.26579309783362415	1.0
24532106971	15	4.949201695035494	5.0	5	10	0.49492016950354933	0.5
24532106972	6	1.6706226001971607	2.0	2	4	0.4176556500492902	0.5
24532106973	2	0.2658670693608823	1.0	1	1	0.2658670693608823	1.0
24532106974	27	5.264734129934069	8.0	8	19	0.27709126999652994	0.42105263157894735
24532106975	9	1.484888849278788	4.0	4	5	0.2969777698557576	0.8
24532106976	3	0.7980818378284869	0.0	0	3	0.26602727927616227	0.0
24532106977	24	4.683186076572079	7.0	7	17	0.27548153391600466	0.4117647058823529
24532106978	10	1.9688212201113535	3.0	3	7	0.2812601743016219	0.42857142857142855
24532106979	10	2.2815859683992423	4.0	4	6	0.38026432806654037	0.6666666666666666
24532106980	3	0.7986338465628509	0.0	0	3	0.26621128218761697	0.0
24532106981	2	0.26623541187713373	1.0	1	1	0.26623541187713373	1.0
24532106982	22	4.47224483585644	6.0	6	16	0.2795153022410275	0.375
24532106983	9	1.3318019958979304	4.0	4	5	0.2663603991795861	0.8
24532106984	3	0.7990776420570657	0.0	0	3	0.2663592140190219	0.0
24532106985	4	0.5327724673194499	2.0	2	2	0.26638623365972497	1.0
24532106986	30	5.541972882246857	10.0	10	20	0.27709864411234286	0.5
24532106987	13	2.959798680276575	5.0	5	8	0.36997483503457185	0.625
24532106988	2	0.7583999685932451	0.0	0	2	0.7583999685932451	0.0
24532106989	12	2.5547362871283115	4.5	5	7	0.42578938118805193	0.7142857142857143
24532106990	6	4.26193331269852	0.0	0	6	0.7103222187830868	0.0
24532106991	14	3.6322595251135694	6.0	6	8	0.4540324406391962	0.75
24532106992	5	3.0655233525956715	0.0	0	5	0.6131046705191343	0.0
24532106993	3	1.3294582735436102	0.0	0	3	0.44315275784787006	0.0
24532106994	13	4.118397809715535	5.0	5	8	0.5147997262144419	0.625
24532106995	1	0.26655389010942093	0.0	0	1	0.26655389010942093	0.0
24532106996	3	1.516903773413192	0.0	0	3	0.758451886706596	0.0
24532106997	2	0.26658547194490945	1.0	1	1	0.26658547194490945	1.0
24532106998	9	1.487960637316053	4.0	4	5	0.2975921274632106	0.8
24532106999	4	1.5172322177684052	1.0	1	3	0.5057440725894684	0.3333333333333333
24532107000	26	4.639565635959684	9.0	9	17	0.2729156256446873	0.5294117647058824
24532107001	9	1.3339500320818252	4.0	4	5	0.266790006416365	0.8
24532107002	3	0.8003705108213746	0.0	0	3	0.26679017027379154	0.0
24532107003	3	0.5336391496513355	1.0	1	2	0.26681957482566776	0.5
24532107004	14	3.2061431922441206	2.0	2	12	0.2671785993536767	0.16666666666666666
24532107005	1	0.26697650759241803	0.0	0	1	0.26697650759241803	0.0
24532107006	2	0.5343527375205707	0.0	0	2	0.26717636876028533	0.0
24532107007	12	5.874960240724966	2.0	2	10	0.5874960240724966	0.2
24532107008	1	0.2675919156830984	0.0	0	1	0.2675919156830984	0.0
24532107009	28	12.433062114500851	7.0	7	21	0.5920505768809929	0.3333333333333333
24532107010	2	0.5359972824806973	0.0	0	2	0.26799864124034867	0.0
24532107011	1	0.2682038221630211	0.0	0	1	0.2682038221630211	0.0
24532107012	23	4.839841273331124	5.0	5	18	0.268880070740618	0.2777777777777778
24532107013	9	2.419325430175407	0.0	0	9	0.26881393668615633	0.0
24532107014	3	0.8076196194846728	0.0	0	3	0.26920653982822423	0.0
24532107015	9	3.468677300542275	2.5	3	6	0.693735460108455	0.5
24532107016	3	0.909245925766458	1.0	1	2	0.454622962883229	0.5
24532107017	2	0.5578396906703992	0.0	0	2	0.5578396906703992	0.0
24532107018	3	0.5578492864306489	0.5	1	2	0.5578492864306489	0.5
24532107019	8	5.829344488028649	0.0	0	8	0.832763498289807	0.0
24532107020	8	3.44927137372264	0.5	1	7	0.689854274744528	0.14285714285714285
24532107021	1	0.27045266433353893	0.0	0	1	0.27045266433353893	0.0
24532107022	2	0.27045939820038084	1.0	1	1	0.27045939820038084	1.0
24532107023	3	0.3329335885513759	0.5	1	2	0.3329335885513759	0.5
24532107024	1	0.2704599705790624	0.0	0	1	0.2704599705790624	0.0
24532107025	3	0.5418871264526255	1.0	1	2	0.27094356322631274	0.5
24532107026	1	0.27094531403169164	0.0	0	1	0.27094531403169164	0.0
24532107027	42	7.756874175374875	14.0	14	28	0.2770312205491027	0.5
24532107028	8	2.177396348365423	2.0	2	6	0.36289939139423716	0.3333333333333333
24532107029	7	1.7989056254285896	3.0	3	4	0.4497264063571474	0.75
24532107030	7	3.0445532831860023	2.0	2	5	0.6089106566372005	0.4
24532107031	4	1.2914317571247762	0.5	1	3	0.6457158785623881	0.3333333333333333
24532107032	1	0.2711309330711884	0.0	0	1	0.2711309330711884	0.0
24532107033	5	3.320676301101758	0.0	0	5	0.6641352602203516	0.0
24532107034	2	0.7385002136487602	0.0	0	2	0.7385002136487602	0.0
24532107035	4	1.009639261029493	1.0	1	3	0.5048196305147465	0.3333333333333333
24532107036	3	0.542339204603056	1.0	1	2	0.271169602301528	0.5
24532107037	2	0.27121662152675147	1.0	1	1	0.27121662152675147	1.0
24532107038	11	1.778186257881444	5.0	5	6	0.296364376313574	0.8333333333333334
24532107039	2	0.5425025345433059	0.0	0	2	0.27125126727165294	0.0
24532107040	5	1.2437219738566374	0.5	1	4	0.6218609869283187	0.25
24532107041	7	4.607308696650982	0.0	0	7	0.9214617393301964	0.0
24532107042	10	6.2145927473493225	0.5	1	9	0.887798963907046	0.1111111111111111
24532107043	4	2.744111107186763	0.0	0	4	0.9147037023955877	0.0
24532107044	3	0.5987586385831648	0.5	1	2	0.5987586385831648	0.5
24532107045	3	1.7743671453020657	0.0	0	3	0.8871835726510329	0.0
24532107046	3	0.5430181467273896	1.0	1	2	0.2715090733636948	0.5
24532107047	2	0.2715201842439839	1.0	1	1	0.2715201842439839	1.0
24532107048	11	1.7797891875444878	5.0	5	6	0.29663153125741465	0.8333333333333334
24532107049	2	0.5431041382069605	0.0	0	2	0.27155206910348023	0.0
24532107050	4	0.5431732276807583	2.0	2	2	0.27158661384037913	1.0
24532107051	45	8.419088263385236	15.0	15	30	0.28063627544617453	0.5
24532107052	5	1.9665189783767791	1.0	1	4	0.4916297445941948	0.25
24532107053	2	0.2717215605318906	1.0	1	1	0.2717215605318906	1.0
24532107054	11	1.7809694323858658	5.0	5	6	0.29682823873097763	0.8333333333333334
24532107055	2	0.5435096516681792	0.0	0	2	0.2717548258340896	0.0
24532107056	2	0.27178246835747555	1.0	1	1	0.27178246835747555	1.0
24532107057	5	0.8160356736023362	2.0	2	3	0.27201189120077873	0.6666666666666666
24532107058	27	5.4363481068423605	8.0	8	19	0.28612358457065057	0.42105263157894735
24532107059	2	0.2718980215124824	1.0	1	1	0.2718980215124824	1.0
24532107060	2	0.2719092670701083	1.0	1	1	0.2719092670701083	1.0
24740503517	6	4.91270777304054	0.0	0	6	0.8187846288400901	0.0
24740503518	8	6.200473646725925	0.0	0	8	0.7750592058407406	0.0
24740503519	2	1.18401580680967	0.0	0	2	0.592007903404835	0.0
24740503520	1	0.38427770709275166	0.0	0	1	0.38427770709275166	0.0
24740503521	1	0.3842948784531985	0.0	0	1	0.3842948784531985	0.0
24740503522	2	1.2590142824305637	0.0	0	2	0.6295071412152818	0.0
24740503523	1	0.38429545083188005	0.0	0	1	0.38429545083188005	0.0
24740503524	5	1.1620681482812294	2.0	2	3	0.38735604942707647	0.6666666666666666
24740503525	2	0.3843422848757654	1.0	1	1	0.3843422848757654	1.0
24740503526	3	0.7688407954622627	1.0	1	2	0.38442039773113135	0.5
24740503527	6	1.5473826351822928	2.0	2	4	0.3868456587955732	0.5
24740503528	5	2.2882086254302396	1.0	1	4	0.5720521563575599	0.25
24740503529	10	2.498243184644952	4.0	4	6	0.41637386410749205	0.6666666666666666
24740503530	2	0.38456999058302394	1.0	1	1	0.38456999058302394	1.0
24740503531	9	4.572744229522235	2.0	2	7	0.6532491756460336	0.2857142857142857
24740503532	3	0.5297775127028506	0.5	1	2	0.5297775127028506	0.5
24740503533	1	0.38470823686928796	0.0	0	1	0.38470823686928796	0.0
24821630680	3	1.4327291247855223	0.0	0	3	0.4775763749285074	0.0
24821630681	3	0.8329414166715796	1.0	1	2	0.4164707083357898	0.5
24821630682	13	4.718139155156272	2.5	4	9	0.6740198793080389	0.4444444444444444
24884927550	4	1.7898804593857427	0.0	0	4	0.4474701148464357	0.0
24884927551	12	0.0	7.0	12	0	0.0	inf
24884927552	1	0.0	1.0	1	0	0.0	inf
24884927554	2	1.0180824862998636	0.0	0	2	0.5090412431499318	0.0
24884927555	8	4.645711232194267	0.0	0	8	0.5807139040242834	0.0
24884927556	8	4.1566935124613735	0.0	0	8	0.5195866890576717	0.0
24884927557	4	2.0466902758282766	0.0	0	4	0.5116725689570691	0.0
26144142086	1	0.0	1.0	1	0	0.0	inf
26144142087	4	0.0	4.0	4	0	0.0	inf
26144142088	4	0.0	4.0	4	0	0.0	inf
26144142091	2	0.0	2.0	2	0	0.0	inf
26144142093	2	0.0	2.0	2	0	0.0	inf
26144142094	4	0.0	4.0	4	0	0.0	inf
26144142095	4	0.0	4.0	4	0	0.0	inf
26144142096	1	0.0	1.0	1	0	0.0	inf
26144142097	2	0.0	2.0	2	0	0.0	inf
26144142098	1	0.0	1.0	1	0	0.0	inf
26144142100	2	0.0	2.0	2	0	0.0	inf
26144142101	5	0.0	5.0	5	0	0.0	inf
26144142103	6	0.5776598513088129	4.0	4	2	0.14441496282720323	2.0
26144142104	2	0.0	2.0	2	0	0.0	inf
26144142105	4	0.0	4.0	4	0	0.0	inf
26144142106	8	1.3678475770385512	5.0	5	3	0.27356951540771024	1.6666666666666667
26144142107	2	1.6378352341973232	0.0	0	2	0.8189176170986616	0.0
26144142108	9	2.037262592894956	4.0	4	5	0.4074525185789912	0.8
26144142109	4	0.0	4.0	4	0	0.0	inf
26144142111	1	0.0	1.0	1	0	0.0	inf
26144142112	2	0.0	2.0	2	0	0.0	inf
26144142113	2	0.3390489160545049	1.0	1	1	0.3390489160545049	1.0
26144142114	3	0.0	3.0	3	0	0.0	inf
26144142115	2	0.0	2.0	2	0	0.0	inf
26144142116	5	2.51902975618318	0.5	1	4	0.8396765853943933	0.25
26144142118	4	0.0	4.0	4	0	0.0	inf
26144142119	10	3.2404168910026345	4.0	4	6	0.5400694818337725	0.6666666666666666
26144142120	1	0.0	1.0	1	0	0.0	inf
26144142121	5	0.0	5.0	5	0	0.0	inf
26144142122	7	6.710750722788014	0.0	0	7	0.958678674684002	0.0
26144142123	2	0.0	2.0	2	0	0.0	inf
26144142124	3	0.0	3.0	3	0	0.0	inf
26144142125	5	0.24123532517859814	4.0	4	1	0.060308831294649534	4.0
26144142126	1	0.0	1.0	1	0	0.0	inf
26144142127	6	0.13615175065218343	5.0	5	1	0.027230350130436686	5.0
26144142128	5	0.19995197406168363	4.0	4	1	0.04998799351542091	4.0
26144142129	6	0.5466418424910162	5.0	5	1	0.10932836849820324	5.0
26144142130	5	0.0	5.0	5	0	0.0	inf
26144142131	2	0.0	2.0	2	0	0.0	inf
26144142132	4	0.6471929185848226	3.0	3	1	0.21573097286160756	3.0
26144142133	12	1.0873827637991493	6.0	6	6	0.13592284547489367	1.0
26144142134	9	5.924293761304689	1.0	1	8	0.8463276801863842	0.125
26144142135	2	0.3946195461191934	1.0	1	1	0.3946195461191934	1.0
26144142136	3	2.53201053028629	0.0	0	3	0.8440035100954301	0.0
26144142137	1	0.8440338124962186	0.0	0	1	0.8440338124962186	0.0
26144142138	4	2.222615072272741	1.0	1	3	0.7408716907575803	0.3333333333333333
26144142139	2	0.0	2.0	2	0	0.0	inf
26144142140	3	0.0	3.0	3	0	0.0	inf
26144142141	2	0.0	2.0	2	0	0.0	inf
26144142142	3	0.0	3.0	3	0	0.0	inf
26144142143	2	0.0	2.0	2	0	0.0	inf
26144142144	2	0.0	2.0	2	0	0.0	inf
26144142145	5	0.44124069880433797	4.0	4	1	0.11031017470108449	4.0
26144142146	1	0.0	1.0	1	0	0.0	inf
26144142147	6	0.48896704738490787	5.0	5	1	0.09779340947698158	5.0
26144142148	3	0.41605320859159256	2.0	2	1	0.1386844028638642	2.0
26144142149	4	0.0	4.0	4	0	0.0	inf
26144142150	1	0.0	1.0	1	0	0.0	inf
26144142151	4	0.0	4.0	4	0	0.0	inf
26144142152	9	1.9501108680671515	5.0	5	4	0.2166789853407946	1.25
26144142153	2	0.0	2.0	2	0	0.0	inf
26144142154	4	0.0	4.0	4	0	0.0	inf
26144142155	1	0.0	1.0	1	0	0.0	inf
26144142156	4	0.0	4.0	4	0	0.0	inf
26144142157	1	0.0	1.0	1	0	0.0	inf
26144142158	2	0.0	2.0	2	0	0.0	inf
26144142159	3	0.0	3.0	3	0	0.0	inf
26144142160	4	0.0	4.0	4	0	0.0	inf
26144142161	1	0.0	1.0	1	0	0.0	inf
26144142162	3	0.0	3.0	3	0	0.0	inf
26144142163	2	0.7667480443251398	1.0	1	1	0.3833740221625699	1.0
26144142164	4	0.0	4.0	4	0	0.0	inf
26144142165	6	0.2869340054450721	5.0	5	1	0.047822334240845345	5.0
26144142166	3	0.0	3.0	3	0	0.0	inf
26144142167	5	0.06458380982455685	4.0	4	1	0.01614595245613921	4.0
26144142168	4	0.0	4.0	4	0	0.0	inf
26144142169	1	0.0	1.0	1	0	0.0	inf
26144142170	3	0.0	3.0	3	0	0.0	inf
26144142171	20	6.201143498130023	0.0	0	20	0.3445079721183346	0.0
26144142172	4	0.0	4.0	4	0	0.0	inf
26144142173	7	0.36533035660504964	5.0	5	2	0.12177678553501654	2.5
26144142174	15	0.7846241712756337	7.0	7	8	0.09807802140945421	0.875
26144142175	13	3.215542054227358	6.0	6	7	0.45936315060390825	0.8571428571428571
26144142176	8	1.0272055290972575	5.0	5	3	0.2054411058194515	1.6666666666666667
26144142177	15	0.4246123910489805	8.0	8	7	0.053076548881122565	1.1428571428571428
26144142178	9	0.2039318577119122	5.0	5	4	0.04078637154238244	1.25
26144142179	8	2.502599491451642	2.0	3	5	0.6256498728629105	0.6
26144142180	1	0.43168190748360546	0.0	0	1	0.43168190748360546	0.0
26144142181	4	0.5498763544205159	0.5	1	3	0.27493817721025793	0.3333333333333333
26144142183	3	1.6232522038178532	0.0	0	3	0.8116261019089266	0.0
26144142184	1	0.361449629144068	0.0	0	1	0.361449629144068	0.0
26144142185	3	0.0	3.0	3	0	0.0	inf
26144142186	1	0.0	1.0	1	0	0.0	inf
26144142187	1	0.0	1.0	1	0	0.0	inf
26144142188	6	1.088265237048779	4.0	4	2	0.21765304740975583	2.0
26144142190	1	0.0	1.0	1	0	0.0	inf
26144142191	1	0.0	1.0	1	0	0.0	inf
26144142193	7	0.0	7.0	7	0	0.0	inf
26144142194	5	0.19024611508912423	4.0	4	1	0.038049223017824846	4.0
26144142195	13	0.7368981930577401	6.0	6	7	0.10527117043682001	0.8571428571428571
26144142196	16	2.0928102268043793	6.0	7	9	0.2616012783505474	0.7777777777777778
26144142197	9	0.8396913437858884	5.0	5	4	0.16793826875717768	1.25
26144142198	14	3.6783696446440826	6.0	6	8	0.4597962055805103	0.75
26144142199	9	1.5602811214325953	4.0	4	5	0.3120562242865191	0.8
26144142200	7	0.9821572393597076	3.0	3	4	0.2455393098399269	0.75
26144142201	2	0.18471818279061342	1.0	1	1	0.18471818279061342	1.0
26144142203	2	0.28322071558311396	1.0	1	1	0.28322071558311396	1.0
26144142205	1	0.0	1.0	1	0	0.0	inf
26144142206	2	0.0	2.0	2	0	0.0	inf
26144142207	4	0.0	4.0	4	0	0.0	inf
26144142209	2	0.0	2.0	2	0	0.0	inf
26144142210	3	0.0	3.0	3	0	0.0	inf
26144142212	1	0.9062215104824254	0.0	0	1	0.9062215104824254	0.0
26144142213	4	0.0	4.0	4	0	0.0	inf
26144142215	14	5.089840120156427	1.5	3	11	0.7271200171652038	0.2727272727272727
26144142217	1	0.0	1.0	1	0	0.0	inf
26144142218	6	0.9936770000434672	2.0	2	4	0.16561283334057786	0.5
26144142219	1	0.0	1.0	1	0	0.0	inf
26144142220	5	0.0	5.0	5	0	0.0	inf
26144142221	5	0.0	5.0	5	0	0.0	inf
26144142222	4	0.0	4.0	4	0	0.0	inf
26144142223	7	0.0	7.0	7	0	0.0	inf
26144142224	4	0.0	4.0	4	0	0.0	inf
26144142225	5	0.2730392435955118	3.0	3	2	0.09101308119850393	1.5
26144142226	4	0.4962447076436156	2.0	2	2	0.1240611769109039	1.0
26144142227	2	0.0	2.0	2	0	0.0	inf
26144142228	1	0.0	1.0	1	0	0.0	inf
26144142229	2	0.2974348310676509	1.0	1	1	0.2974348310676509	1.0
26144142230	10	2.2477099718164104	5.0	5	5	0.3746183286360684	1.0
26144142231	7	0.8041158875588341	3.0	3	4	0.16082317751176683	0.75
26144142232	8	0.3065133630052197	3.0	3	5	0.05108556050086995	0.6
26144142233	5	0.0	5.0	5	0	0.0	inf
26144142234	3	1.631419576233046	1.0	1	2	0.5438065254110153	0.5
26144142236	4	0.0	4.0	4	0	0.0	inf
26144142237	8	0.993501919505578	4.0	4	4	0.12418773993819725	1.0
26144142238	4	0.6931039850114898	2.0	2	2	0.3465519925057449	1.0
26144142239	3	0.0	3.0	3	0	0.0	inf
26144142240	6	0.5250572740626904	3.0	3	3	0.10501145481253808	1.0
26144142241	6	0.660957986159008	3.0	3	3	0.165239496539752	1.0
26144142242	2	0.5020069785082243	1.0	1	1	0.5020069785082243	1.0
26144142243	4	0.0	4.0	4	0	0.0	inf
26144142244	3	0.0	3.0	3	0	0.0	inf
26144142245	4	0.0	4.0	4	0	0.0	inf
26144142246	8	1.6896290740357347	0.0	0	8	0.21120363425446684	0.0
26144142247	5	0.671687897931548	4.0	4	1	0.167921974482887	4.0
26144142248	2	0.7520610767109653	1.0	1	1	0.37603053835548267	1.0
26144142249	3	0.0	3.0	3	0	0.0	inf
26144142250	2	0.0	2.0	2	0	0.0	inf
26144142251	12	2.560401186278386	6.0	6	6	0.36577159803976944	1.0
26144142252	5	3.9222068349623846	0.0	0	5	0.7844413669924769	0.0
26144142253	10	5.503960203924383	0.5	1	9	0.6879950254905479	0.1111111111111111
26144142254	1	0.7212575752214171	0.0	0	1	0.7212575752214171	0.0
26144142255	2	0.5176522763820024	1.0	1	1	0.2588261381910012	1.0
26144142257	1	0.0	1.0	1	0	0.0	inf
26144142258	1	0.38649311561439953	0.0	0	1	0.38649311561439953	0.0
26144142259	2	0.6102389388072308	1.0	1	1	0.6102389388072308	1.0
26144142261	5	0.0	5.0	5	0	0.0	inf
26144142263	10	0.19770912503265506	5.0	5	5	0.032951520838775845	1.0
26144142264	3	0.1340380235198481	1.0	1	2	0.06701901175992404	0.5
26144142265	1	0.0	1.0	1	0	0.0	inf
26144142266	1	0.7481277577499484	0.0	0	1	0.7481277577499484	0.0
26144142268	16	2.607444821769191	8.0	8	8	0.21728706848076593	1.0
26144142269	1	0.0	1.0	1	0	0.0	inf
26144142270	4	0.0	4.0	4	0	0.0	inf
26144142271	23	11.236707877146122	0.0	0	23	0.5618353938573061	0.0
26144142272	7	0.0	7.0	7	0	0.0	inf
26144142273	4	2.141446085109949	1.0	1	3	0.5353615212774873	0.3333333333333333
26144142274	1	0.0	1.0	1	0	0.0	inf
26144142275	5	0.12157265958481603	4.0	4	1	0.030393164896204007	4.0
26144142277	4	0.4193672811578291	2.0	2	2	0.20968364057891456	1.0
26144142278	1	0.0	1.0	1	0	0.0	inf
26144142279	32	5.865490605801219	17.0	17	15	0.23461962423204877	1.1333333333333333
26144142280	8	1.3040892382808074	3.0	3	5	0.21734820638013455	0.6
26144142282	33	9.421053879116382	9.0	9	24	0.39254391162984925	0.375
26144142283	46	12.03420928932217	15.0	15	31	0.38820029965555386	0.4838709677419355
26144142284	49	14.064217117105684	11.0	11	38	0.36062095172065856	0.2894736842105263
26144142285	2	0.7786330836157377	0.0	0	2	0.38931654180786884	0.0
26144142286	15	7.004690912650064	0.0	0	15	0.5388223778961587	0.0
26144142287	4	0.0	4.0	4	0	0.0	inf
26144142290	5	0.0	5.0	5	0	0.0	inf
26144142292	2	0.6516457890420256	1.0	1	1	0.6516457890420256	1.0
26144142294	2	0.0	2.0	2	0	0.0	inf
26144142295	3	0.0	3.0	3	0	0.0	inf
26144142296	1	0.0	1.0	1	0	0.0	inf
26144142297	10	2.170346898853987	1.0	3	7	0.7234489662846624	0.42857142857142855
26144142298	2	0.0	2.0	2	0	0.0	inf
26144142301	6	1.6290475716379897	4.0	4	2	0.2715079286063316	2.0
26144142302	9	2.5150134759826708	4.0	4	5	0.5030026951965342	0.8
26144142303	4	0.0	4.0	4	0	0.0	inf
26144142305	4	0.0	4.0	4	0	0.0	inf
26144142308	17	10.826568114729737	4.0	4	13	0.6368569479252786	0.3076923076923077
26144142310	1	0.0	1.0	1	0	0.0	inf
26144142311	5	0.0	5.0	5	0	0.0	inf
26144142312	2	0.0	2.0	2	0	0.0	inf
26144142313	4	0.0	4.0	4	0	0.0	inf
26144142314	1	0.0	1.0	1	0	0.0	inf
26144142315	3	0.0	3.0	3	0	0.0	inf
26144142317	4	0.0	4.0	4	0	0.0	inf
26144142319	2	0.0	2.0	2	0	0.0	inf
26144142320	2	0.0	2.0	2	0	0.0	inf
26144142321	2	0.0	2.0	2	0	0.0	inf
26144142322	2	0.0	2.0	2	0	0.0	inf
26144142325	9	1.0778172049422408	5.0	5	4	0.11975746721580453	1.25
26144142326	5	4.125246589995084	0.0	0	5	0.8250493179990167	0.0
26144142327	10	0.2861786002627488	5.0	5	5	0.04769643337712479	1.0
26144142328	4	0.0	4.0	4	0	0.0	inf
26144142329	1	0.0	1.0	1	0	0.0	inf
26144142330	2	0.0	2.0	2	0	0.0	inf
26144142331	3	0.0	3.0	3	0	0.0	inf
26144142332	4	2.7615235737358588	0.0	0	4	0.6903808934339647	0.0
26144142334	5	0.0	5.0	5	0	0.0	inf
26144142335	4	1.9960104869201878	1.0	1	3	0.665336828973396	0.3333333333333333
26144142336	1	0.0	1.0	1	0	0.0	inf
26144142337	2	0.0	2.0	2	0	0.0	inf
26144142338	4	0.0	4.0	4	0	0.0	inf
26144142339	2	0.5433716410672546	1.0	1	1	0.5433716410672546	1.0
26144142342	4	0.0	4.0	4	0	0.0	inf
26144142344	2	0.0	2.0	2	0	0.0	inf
26144142345	4	0.0	4.0	4	0	0.0	inf
26144142346	2	0.0	2.0	2	0	0.0	inf
26144142347	4	0.0	4.0	4	0	0.0	inf
26144142350	4	0.0	4.0	4	0	0.0	inf
26144142352	12	2.745690198961187	6.0	6	6	0.34321127487014835	1.0
26144142353	5	0.0	5.0	5	0	0.0	inf
26144142354	2	0.0	2.0	2	0	0.0	inf
26144142355	2	0.6224260930336902	1.0	1	1	0.3112130465168451	1.0
26144142356	2	0.0	2.0	2	0	0.0	inf
26144142357	4	0.0	4.0	4	0	0.0	inf
26144142358	3	1.0182374325758956	0.0	0	3	0.3394124775252985	0.0
26144142360	4	0.0	4.0	4	0	0.0	inf
26144142362	2	0.0	2.0	2	0	0.0	inf
26144142363	4	0.0	4.0	4	0	0.0	inf
26144142364	1	0.0	1.0	1	0	0.0	inf
26144142365	2	0.0	2.0	2	0	0.0	inf
26144142367	5	4.378846910823435	0.0	0	5	0.8757693821646869	0.0
26144142368	5	0.0	5.0	5	0	0.0	inf
26144142370	1	0.0	1.0	1	0	0.0	inf
26144142371	2	0.0	2.0	2	0	0.0	inf
26144142372	4	0.0	4.0	4	0	0.0	inf
26144142373	1	0.0	1.0	1	0	0.0	inf
26144142374	2	0.0	2.0	2	0	0.0	inf
26144142376	5	0.0	5.0	5	0	0.0	inf
26144142377	1	0.7036519140326277	0.0	0	1	0.7036519140326277	0.0
26144142378	2	0.0	2.0	2	0	0.0	inf
26144142379	2	0.22407292077467617	1.0	1	1	0.22407292077467617	1.0
26144142380	10	0.41582233796691837	5.0	5	5	0.08316446759338367	1.0
26144142382	4	0.0	4.0	4	0	0.0	inf
26144142384	1	0.0	1.0	1	0	0.0	inf
26144142385	8	0.0	8.0	8	0	0.0	inf
26144142386	4	0.0	4.0	4	0	0.0	inf
26144142387	4	0.10582429987902271	2.0	2	2	0.052912149939511356	1.0
26144142389	12	1.2553560755993722	6.0	6	6	0.20922601259989537	1.0
26144142390	4	0.0	4.0	4	0	0.0	inf
26144142391	5	0.0	5.0	5	0	0.0	inf
26144142392	8	0.48071698308489685	6.0	6	2	0.09614339661697938	3.0
26144142393	6	0.10572049732165496	5.0	5	1	0.017620082886942494	5.0
26144142394	4	0.0	4.0	4	0	0.0	inf
26144142395	6	0.5504031111542228	5.0	5	1	0.11008062223084455	5.0
26144142396	1	0.3891106033251767	0.0	0	1	0.3891106033251767	0.0
26144142397	3	0.0	3.0	3	0	0.0	inf
26144142398	6	0.35050945237938996	3.0	3	3	0.07010189047587799	1.0
26144142399	4	0.25983716095864273	1.0	2	2	0.25983716095864273	1.0
26144142400	5	1.9983782491791333	2.0	2	3	0.49959456229478333	0.6666666666666666
26144142401	1	0.0	1.0	1	0	0.0	inf
26144142402	3	0.6478525008419859	0.5	1	2	0.6478525008419859	0.5
26144142403	1	0.9396349240825536	0.0	0	1	0.9396349240825536	0.0
26144142404	3	0.0	3.0	3	0	0.0	inf
26144142405	2	0.0	2.0	2	0	0.0	inf
26144142406	9	0.19548957518289942	3.0	3	6	0.03258159586381657	0.5
26144142407	9	1.13640487670677	5.0	5	4	0.227280975341354	1.25
26144142408	9	2.754480386720586	4.0	4	5	0.45908006445343097	0.8
26144142409	8	0.19115394134741376	5.0	5	3	0.03823078826948275	1.6666666666666667
26144142410	7	0.9800324013470831	2.0	3	4	0.19600648026941664	0.75
26144142411	7	2.799594836699857	2.0	2	5	0.5599189673399714	0.4
26144142412	4	1.697622948371746	1.0	1	3	0.5658743161239154	0.3333333333333333
26144142413	4	0.25501675604920937	1.0	2	2	0.25501675604920937	1.0
26144142414	6	1.512128451742265	2.0	2	4	0.37803211293556627	0.5
26144142415	2	1.2741750112463994	0.0	0	2	0.6370875056231997	0.0
26144142416	4	0.0	4.0	4	0	0.0	inf
26144142417	5	0.0	5.0	5	0	0.0	inf
26144142418	3	1.116267651948106	1.0	1	2	0.558133825974053	0.5
26144142419	15	1.7796618501225074	8.0	8	7	0.22245773126531343	1.1428571428571428
26144142420	8	0.39972277343598617	3.0	3	5	0.06662046223933103	0.6
26144142421	12	0.7626721357337459	5.0	5	7	0.09533401696671824	0.7142857142857143
26144142422	10	0.9146291135972024	5.0	5	5	0.1829258227194405	1.0
26144142423	12	1.7624015352947044	5.0	6	6	0.2937335892157841	1.0
26144142424	2	1.6890193223932015	0.0	0	2	0.8445096611966008	0.0
26144142425	8	2.3835848595333893	3.0	3	5	0.3405121227904842	0.6
26144142426	6	4.147542524116586	1.0	1	5	0.8295085048233173	0.2
26144142427	2	0.8445109743006349	1.0	1	1	0.42225548715031747	1.0
26144142428	5	0.0	5.0	5	0	0.0	inf
26144142429	7	0.38226670509908933	5.0	5	2	0.07645334101981786	2.5
26144142430	7	0.6007713913822059	4.0	4	3	0.12015427827644118	1.3333333333333333
26144142431	7	0.4268391798055913	5.0	5	2	0.08536783596111826	2.5
26144142432	16	2.1359545830310527	8.0	8	8	0.2669943228788816	1.0
26144142433	16	1.7973194294246482	8.0	8	8	0.22466492867808102	1.0
26144142434	8	6.607042641572059	0.0	0	8	0.8258803301965074	0.0
26144142435	7	2.0669334579816976	3.0	3	4	0.4133866915963395	0.75
26144142436	2	0.3218978918855457	1.0	1	1	0.3218978918855457	1.0
26144142437	4	0.0	4.0	4	0	0.0	inf
26144142438	8	0.4811305435169916	4.0	4	4	0.09622610870339832	1.0
26144142439	9	1.8047218008972676	5.0	5	4	0.3609443601794535	1.25
26144142440	6	0.75051124358797	3.0	3	3	0.1876278108969925	1.0
26144142441	1	0.7533695343770132	0.0	0	1	0.7533695343770132	0.0
26144142442	13	5.572018285007346	1.5	2	11	0.619113142778594	0.18181818181818182
26144142443	2	1.5068106160892212	0.0	0	2	0.7534053080446106	0.0
26144142444	4	1.6418661268888792	1.0	1	3	0.5472887089629598	0.3333333333333333
26144142445	2	0.9846232824052106	0.0	0	2	0.4923116412026053	0.0
26144142446	2	0.3807129326639915	1.0	1	1	0.3807129326639915	1.0
26144142448	6	0.7900378298538377	5.0	5	1	0.15800756597076754	5.0
26144142449	3	0.0	3.0	3	0	0.0	inf
26144142450	8	0.3204613897414993	7.0	7	1	0.0457801985344999	7.0
26144142451	12	0.9282020639503887	6.0	6	6	0.15470034399173146	1.0
26144142452	9	0.739854461609333	5.0	5	4	0.1479708923218666	1.25
26144142453	5	0.05135768728306217	4.0	4	1	0.010271537456612434	4.0
26144142454	8	1.271989433754861	3.0	3	5	0.2543978867509722	0.6
26144142455	14	1.8290304878178123	7.0	7	7	0.22862881097722654	1.0
26144142456	6	2.55203462608201	2.0	2	4	0.6380086565205025	0.5
26144142457	3	0.642405576961583	0.5	1	2	0.642405576961583	0.5
26144142459	1	0.9045149129393507	0.0	0	1	0.9045149129393507	0.0
26144142460	2	0.6182798155337985	1.0	1	1	0.6182798155337985	1.0
26144142461	1	0.9045461580814971	0.0	0	1	0.9045461580814971	0.0
26144142462	2	0.0	2.0	2	0	0.0	inf
26144142463	11	2.725872630861507	3.0	4	7	0.5451745261723013	0.5714285714285714
26144142465	4	0.0	4.0	4	0	0.0	inf
26144142467	1	0.0	1.0	1	0	0.0	inf
26144142468	1	0.0	1.0	1	0	0.0	inf
26144142470	8	4.086805806088137	2.0	2	6	0.5838294008697338	0.3333333333333333
26144142471	4	1.842081462482749	0.0	0	4	0.46052036562068727	0.0
26144142472	4	0.0	4.0	4	0	0.0	inf
26144142473	25	3.7654024830527932	10.0	10	15	0.25102683220351957	0.6666666666666666
26144142474	15	2.4779741107735234	6.0	6	9	0.20649784256446027	0.6666666666666666
26144142475	1	0.0	1.0	1	0	0.0	inf
26144142476	19	10.541960390923865	0.0	0	19	0.5548400205749403	0.0
26144142477	4	0.0	4.0	4	0	0.0	inf
26144142478	2	0.0	2.0	2	0	0.0	inf
26144142479	2	0.0	2.0	2	0	0.0	inf
26144142480	2	0.0	2.0	2	0	0.0	inf
26144142481	1	0.5168900699941688	0.0	0	1	0.5168900699941688	0.0
26144142482	6	2.507522385814409	1.0	1	5	0.6268805964536023	0.2
26144142483	4	0.0	4.0	4	0	0.0	inf
26144142484	5	3.221066720600451	1.0	1	4	0.6442133441200901	0.25
26144142485	4	0.0	4.0	4	0	0.0	inf
26144142486	5	0.0	5.0	5	0	0.0	inf
26144142488	4	0.0	4.0	4	0	0.0	inf
26144142489	1	0.0	1.0	1	0	0.0	inf
26144142490	5	0.0	5.0	5	0	0.0	inf
26144142491	2	0.13519315103790605	1.0	1	1	0.06759657551895303	1.0
26144142492	2	0.0	2.0	2	0	0.0	inf
26144142493	26	4.0681328606742415	10.0	10	16	0.22600738114856897	0.625
26144142494	23	3.7688529837612466	10.0	10	13	0.22169723433889685	0.7692307692307693
26144142495	3	0.5894200783774963	1.0	1	2	0.29471003918874816	0.5
26144142496	3	0.10395342965434018	2.0	2	1	0.10395342965434018	2.0
26144142497	10	2.565337481036168	4.0	5	5	0.4275562468393614	1.0
26144142499	4	0.0	4.0	4	0	0.0	inf
26144142500	3	0.0	3.0	3	0	0.0	inf
26144142501	4	0.0	4.0	4	0	0.0	inf
26144142502	5	0.6563392605614894	4.0	4	1	0.16408481514037235	4.0
26144142503	5	0.45485923743604384	4.0	4	1	0.11371480935901096	4.0
26144142504	5	2.1384253397833453	0.0	0	5	0.42768506795666905	0.0
26144142505	8	0.6430825662645325	7.0	7	1	0.08038532078306657	7.0
26144142506	3	0.4471015198101777	2.0	2	1	0.1490338399367259	2.0
26144142507	2	0.278120181813058	1.0	1	1	0.139060090906529	1.0
26144142508	4	0.0	4.0	4	0	0.0	inf
26144142509	3	1.0462478944460984	1.0	1	2	0.3487492981486995	0.5
26144142510	14	0.0	14.0	14	0	0.0	inf
26144142511	4	0.05416244383071234	3.0	3	1	0.013540610957678084	3.0
26144142512	4	0.07586128597934515	3.0	3	1	0.018965321494836287	3.0
26144142513	4	2.0188607192907813	1.0	1	3	0.672953573096927	0.3333333333333333
26144142514	8	0.78169988859154	3.0	3	5	0.13028331476525667	0.6
26144142515	8	0.10735305599880299	5.0	5	3	0.021470611199760598	1.6666666666666667
26144142516	9	0.907173409899195	5.0	5	4	0.181434681979839	1.25
26144142517	15	1.6869853579136085	7.0	7	8	0.21087316973920106	0.875
26144142518	8	1.0574134537339746	4.0	4	4	0.2114826907467949	1.0
26144142519	6	1.4886193441705267	2.0	2	4	0.37215483604263166	0.5
26144142520	6	2.818828006165663	2.0	2	4	0.5637656012331326	0.5
26144142521	5	0.738773305618533	1.0	2	3	0.3693866528092665	0.6666666666666666
26144142522	1	0.0	1.0	1	0	0.0	inf
26144142523	1	0.0	1.0	1	0	0.0	inf
26144142525	3	0.6705198750584879	2.0	2	1	0.22350662501949595	2.0
26144142526	1	0.0	1.0	1	0	0.0	inf
26144142527	10	0.583687907897671	4.5	5	5	0.1167375815795342	1.0
26144142528	1	0.0	1.0	1	0	0.0	inf
26144142529	14	0.805325323712972	7.0	7	7	0.1006656654641215	1.0
26144142530	5	0.11851706649730542	4.0	4	1	0.029629266624326356	4.0
26144142531	14	0.8393132371627161	7.0	7	7	0.10491415464533951	1.0
26144142532	10	0.23410692107844092	4.5	5	5	0.05852673026961023	1.0
26144142533	8	1.3918809834825991	4.0	4	4	0.2783761966965198	1.0
26144142534	14	1.0363935873790098	6.0	6	8	0.12954919842237622	0.75
26144142535	17	1.3025832426309525	7.0	8	9	0.16282290532886906	0.8888888888888888
26144142536	2	0.4894817168276336	1.0	1	1	0.4894817168276336	1.0
26144142537	9	4.6119750980257415	1.0	1	8	0.6588535854322488	0.125
26144142538	7	3.2350658910553944	1.0	1	6	0.5391776485092324	0.16666666666666666
26144142539	5	3.2290998870494847	1.0	1	4	0.8072749717623712	0.25
26144142540	3	0.9789827598531033	1.0	1	2	0.4894913799265517	0.5
26144142541	106	24.826716327138932	25.5	35	71	0.47743685244497946	0.49295774647887325
26144142542	2	0.4894892250891623	1.0	1	1	0.24474461254458116	1.0
26144142544	12	0.0	12.0	12	0	0.0	inf
26144142545	5	3.9045573699697886	1.0	1	4	0.7809114739939578	0.25
26144142546	9	0.4277818201554533	4.5	5	4	0.08555636403109065	1.25
26144142547	3	0.164128240164169	2.0	2	1	0.05470941338805633	2.0
26144142548	9	0.484415020738458	3.0	3	6	0.080735836789743	0.5
26144142549	6	0.18357652300623922	2.0	2	4	0.03671530460124785	0.5
26144142550	9	0.9927868501856376	4.0	5	4	0.2481967125464094	1.25
26144142551	5	0.657551390262364	3.0	3	2	0.21918379675412134	1.5
26144142552	9	1.3026783585000943	5.0	5	4	0.26053567170001884	1.25
26144142553	4	2.829618320723775	1.0	1	3	0.7074045801809438	0.3333333333333333
26144142555	4	1.7494458111762459	1.0	1	3	0.43736145279406147	0.3333333333333333
26144142556	12	2.060226964308519	6.0	6	6	0.29431813775835985	1.0
26144142557	1	0.0	1.0	1	0	0.0	inf
26144142558	1	0.0	1.0	1	0	0.0	inf
26144142559	1	0.0	1.0	1	0	0.0	inf
26144142560	10	2.658465782040824	5.0	5	5	0.2953850868934249	1.0
26144142562	5	1.0882622404780344	3.0	3	2	0.2720655601195086	1.5
26144142563	7	0.28934031909168756	3.0	3	4	0.05786806381833751	0.75
26144142564	15	0.43651120109727015	8.0	8	7	0.05456390013715877	1.1428571428571428
26144142565	17	2.42643420505372	8.0	8	9	0.24264342050537202	0.8888888888888888
26144142566	1	0.7814208708189463	0.0	0	1	0.7814208708189463	0.0
26144142567	11	0.5634136152794401	6.0	6	5	0.11268272305588803	1.2
26144142568	9	2.3849235522615575	4.0	4	5	0.4769847104523115	0.8
26144142569	3	0.8095432158867272	0.5	1	2	0.8095432158867272	0.5
26144142570	8	2.730163484482494	1.5	2	6	0.5460326968964988	0.3333333333333333
26144142571	1	0.9747672582020771	0.0	0	1	0.9747672582020771	0.0
26144142572	2	0.7004218464552436	1.0	1	1	0.7004218464552436	1.0
26144142573	1	0.9747476626495671	0.0	0	1	0.9747476626495671	0.0
26144142574	11	0.0	11.0	11	0	0.0	inf
26144142575	2	0.0	2.0	2	0	0.0	inf
26144142576	12	0.24072274323459342	8.0	8	4	0.030090342904324177	2.0
26144142578	3	0.625137551856246	1.0	1	2	0.312568775928123	0.5
26144142579	6	0.1782063988771681	4.0	4	2	0.03564127977543362	2.0
26144142580	9	1.6560137454383523	3.0	3	6	0.2365733922054789	0.5
26144142581	14	2.40501165346161	7.0	7	7	0.30062645668270127	1.0
26144142582	7	0.33078457595678906	4.0	4	3	0.08269614398919727	1.3333333333333333
26144142583	5	3.950552441385309	0.0	0	5	0.7901104882770618	0.0
26144142584	6	3.2304487142472498	1.0	1	5	0.64608974284945	0.2
26144142585	3	1.5967900936199406	0.0	0	3	0.7983950468099703	0.0
26144142586	9	4.356750299160452	2.0	2	7	0.6223928998800645	0.2857142857142857
26144142587	2	0.5990064785522806	1.0	1	1	0.2995032392761403	1.0
26144142588	1	0.03219111576032242	0.0	0	1	0.03219111576032242	0.0
26144142590	2	0.7402031749037402	0.0	0	2	0.7402031749037402	0.0
26144142591	4	0.5645875976246555	2.0	2	2	0.14114689940616387	1.0
26144142592	1	0.0	1.0	1	0	0.0	inf
26144142593	15	3.048484851341641	7.0	7	8	0.3387205390379601	0.875
26144142594	2	0.0	2.0	2	0	0.0	inf
26144142595	15	0.0	15.0	15	0	0.0	inf
26144142596	11	1.091031374870091	5.0	6	5	0.2182062749740182	1.2
26144142597	13	1.8740166239644112	5.0	5	8	0.2342520779955514	0.625
26144142598	6	2.215077787777944	2.0	2	4	0.44301555755558886	0.5
26243356736	4	0.47365002551967184	2.0	2	2	0.23682501275983592	1.0
26243356737	2	0.23683679702680924	1.0	1	1	0.23683679702680924	1.0
26358096819	31	1.1023547086580725	10.0	10	21	0.05249308136467012	0.47619047619047616
26358096820	8	0.44951163809155886	3.0	3	5	0.08990232761831177	0.6
26358096821	7	0.5603104137533574	2.0	2	5	0.11206208275067149	0.4
26358096822	14	1.5733531057620789	6.0	6	8	0.19666913822025986	0.75
26358096823	15	5.0692136799717	5.0	5	10	0.5632459644412999	0.5
26358096824	9	1.6824076415651568	4.0	4	5	0.33648152831303135	0.8
26358096825	3	0.8525476423604263	0.0	0	3	0.8525476423604263	0.0
26358096826	18	3.9495070758967734	7.0	8	10	0.4936883844870967	0.8
26358096827	4	0.5677184416741241	0.3333333333333333	1	3	0.5677184416741241	0.3333333333333333
26503622691	1	0.8450041290388007	0.0	0	1	0.8450041290388007	0.0
26503622692	2	1.6900516915187318	0.0	0	2	0.8450258457593659	0.0
26503622693	1	0.845022007455266	0.0	0	1	0.845022007455266	0.0
26503622694	2	1.6905834649832359	0.0	0	2	0.8452917324916179	0.0
26503622695	1	0.845288365558197	0.0	0	1	0.845288365558197	0.0
26503622696	1	0.8452934832969968	0.0	0	1	0.8452934832969968	0.0
26503622697	1	0.8452995774464888	0.0	0	1	0.8452995774464888	0.0
26503622698	1	0.8455765077203615	0.0	0	1	0.8455765077203615	0.0
26503622699	1	0.8455843526752324	0.0	0	1	0.8455843526752324	0.0
26503622700	3	2.579873677371753	0.0	0	3	0.859957892457251	0.0
26503622701	1	0.8456079548785131	0.0	0	1	0.8456079548785131	0.0
26503622702	1	0.8458139438652066	0.0	0	1	0.8458139438652066	0.0
26503622703	1	0.8458251557534984	0.0	0	1	0.8458251557534984	0.0
26503622704	1	0.8459610115170335	0.0	0	1	0.8459610115170335	0.0
26503622705	1	0.8460807733388165	0.0	0	1	0.8460807733388165	0.0
26503622706	1	0.8460810426934902	0.0	0	1	0.8460810426934902	0.0
26503622707	5	4.4290576859059865	0.0	0	5	0.8858115371811973	0.0
26503622708	2	1.692732208223149	0.0	0	2	0.8463661041115745	0.0
26503622709	1	0.8463672657036048	0.0	0	1	0.8463672657036048	0.0
26503622710	1	0.8468252359875218	0.0	0	1	0.8468252359875218	0.0
26503622711	3	2.7337578542560244	0.0	0	3	0.9112526180853414	0.0
26503622712	2	1.734201649750239	0.0	0	2	0.8671008248751195	0.0
26503622713	2	1.6945708568949933	0.0	0	2	0.8472854284474967	0.0
26503622714	1	0.8472839133274571	0.0	0	1	0.8472839133274571	0.0
26503622715	1	0.8473042832746539	0.0	0	1	0.8473042832746539	0.0
26503622716	1	0.8473154951629456	0.0	0	1	0.8473154951629456	0.0
26503622717	1	0.8477855190685096	0.0	0	1	0.8477855190685096	0.0
26503622718	1	0.8477967309568013	0.0	0	1	0.8477967309568013	0.0
26503622719	1	0.8478204341680848	0.0	0	1	0.8478204341680848	0.0
26503622720	1	0.8478207035227585	0.0	0	1	0.8478207035227585	0.0
26503622721	2	1.6961931464252071	0.0	0	2	0.8480965732126036	0.0
26503622722	2	1.6962888683423647	0.0	0	2	0.8481444341711823	0.0
26503622723	2	1.696331022348795	0.0	0	2	0.8481655111743975	0.0
26696028237	15	2.2367717142037824	5.0	5	10	0.22367717142037824	0.5
26696028238	11	1.4696350247538628	1.5	3	8	0.29392700495077256	0.375
26696028239	2	0.21233845074666294	1.0	1	1	0.21233845074666294	1.0
26696028240	28	4.4385752996309815	8.0	8	20	0.22192876498154906	0.4
26696028241	1	0.212416260578021	0.0	0	1	0.212416260578021	0.0
26696028242	8	4.71230671739917	0.5	1	7	0.7853844528998617	0.14285714285714285
26696028243	4	0.9278107926175405	1.0	1	3	0.46390539630877026	0.3333333333333333
26696028244	4	2.233730127559303	0.0	0	4	0.7445767091864344	0.0
26696028245	1	0.2124593909951433	0.0	0	1	0.2124593909951433	0.0
26696028246	7	1.0626131100239433	2.0	2	5	0.21252262200478866	0.4
26696028247	12	3.188663218679935	5.0	5	7	0.45552331695427645	0.7142857142857143
26696028248	4	0.42509716212292825	2.0	2	2	0.21254858106146413	1.0
26696028249	31	4.945967654476672	9.0	9	22	0.22481671156712146	0.4090909090909091
26696028250	9	2.3084722112001916	4.0	4	5	0.4616944422400383	0.8
26696028251	3	0.2900434021286494	0.5	1	2	0.2900434021286494	0.5
26696028252	1	0.2126802618275573	0.0	0	1	0.2126802618275573	0.0
26696028253	1	0.2126909013371675	0.0	0	1	0.2126909013371675	0.0
26696028254	2	0.8143223758617539	0.0	0	2	0.40716118793087697	0.0
26696028255	2	0.5678284057196522	0.0	0	2	0.2839142028598261	0.0
26696028256	9	1.0639535198881558	4.0	4	5	0.21279070397763117	0.8
26696028257	3	0.6383797683394927	0.0	0	3	0.21279325611316424	0.0
26696028258	2	0.2128184071058187	1.0	1	1	0.2128184071058187	1.0
26696028259	23	3.2323798189108324	8.0	8	15	0.21549198792738883	0.5333333333333333
26696028260	7	5.474595022722928	0.0	0	7	0.7820850032461326	0.0
26696028261	3	0.42586563100692487	1.0	1	2	0.21293281550346244	0.5
26696028262	4	0.6554340605112682	0.3333333333333333	1	3	0.6554340605112682	0.3333333333333333
26696028263	1	0.21292924655403622	0.0	0	1	0.21292924655403622	0.0
26696028264	1	0.21293648546089128	0.0	0	1	0.21293648546089128	0.0
26696028265	1	0.21293705783957284	0.0	0	1	0.21293705783957284	0.0
26696028266	13	2.3195584455366696	3.0	3	10	0.23195584455366697	0.3
26696028267	3	0.6390740636802259	0.0	0	3	0.21302468789340864	0.0
26696028268	2	0.2130483686584693	1.0	1	1	0.2130483686584693	1.0
26696028269	27	4.0284245610116445	9.0	9	18	0.22380136450064692	0.5
26696028270	11	1.4556778736280127	5.0	5	6	0.24261297893800213	0.8333333333333334
26696028271	3	0.6395626057196051	0.0	0	3	0.21318753523986836	0.0
26696028272	2	0.21321095787336675	1.0	1	1	0.21321095787336675	1.0
26696028273	30	4.420045684572815	10.0	10	20	0.22100228422864077	0.5
26696028274	3	0.21757537898960147	0.5	1	2	0.21757537898960147	0.5
26696028275	2	0.9292507290336763	0.0	0	2	0.46462536451683817	0.0
26696028276	3	0.7347453084897193	0.5	1	2	0.7347453084897193	0.5
26696028277	2	0.48451592773308383	0.0	0	2	0.24225796386654191	0.0
26696028278	11	1.4570902011900966	5.0	5	6	0.2428483668650161	0.8333333333333334
26696028279	3	0.6403090885283629	0.0	0	3	0.21343636284278764	0.0
26696028280	3	0.4269246325758148	1.0	1	2	0.2134623162879074	0.5
26696028281	4	0.8543328577988801	0.0	0	4	0.21358321444972003	0.0
26696028282	6	4.192567615682866	0.0	0	6	0.6987612692804777	0.0
26696028283	14	5.48279885902707	2.0	2	12	0.45689990491892246	0.16666666666666666
26696028284	4	2.3734321074878677	0.0	0	4	0.5933580268719669	0.0
26696028285	24	4.522323963842233	3.0	3	21	0.21534876018296348	0.14285714285714285
26696028286	4	0.8572626959231184	0.0	0	4	0.2143156739807796	0.0
26696028287	31	5.5949619161110355	5.0	5	26	0.21519084292734753	0.19230769230769232
26696028288	21	4.318079486362186	1.0	1	20	0.21590397431810932	0.05
26696028289	24	4.32362129042639	4.0	4	20	0.2161810645213195	0.2
26696028290	3	0.651846626620585	0.0	0	3	0.21728220887352834	0.0
26696028291	22	4.160283707237462	3.0	3	19	0.21896230038091904	0.15789473684210525
26696028292	1	0.2172845769500344	0.0	0	1	0.2172845769500344	0.0
26696028293	2	0.21729578883832615	1.0	1	1	0.21729578883832615	1.0
26696028294	2	0.44372492329031415	0.0	0	2	0.44372492329031415	0.0
26696028295	6	2.073278107320127	2.0	2	4	0.5183195268300318	0.5
26696028296	2	0.21758100176841444	1.0	1	1	0.21758100176841444	1.0
26696028297	1	0.21758271890445913	0.0	0	1	0.21758271890445913	0.0
26696028298	2	0.21758827434460368	1.0	1	1	0.21758827434460368	1.0
26696028299	1	0.21758854369927735	0.0	0	1	0.21758854369927735	0.0
26696028300	16	3.2821755857799184	8.0	8	8	0.4102719482224898	1.0
26696028301	1	0.21793463078561634	0.0	0	1	0.21793463078561634	0.0
26696028302	2	0.5987339252918551	0.0	0	2	0.5987339252918551	0.0
26696028303	7	4.867126666089125	0.0	0	7	0.6953038094413035	0.0
26696028304	7	1.2249757976408369	1.0	2	5	0.6124878988204184	0.4
26696028305	1	0.21798702026964625	0.0	0	1	0.21798702026964625	0.0
26696028306	2	0.447741506514831	0.0	0	2	0.2238707532574155	0.0
26696028307	2	0.21800473033944043	1.0	1	1	0.21800473033944043	1.0
26696028308	9	1.5273284390017892	2.0	2	7	0.2181897770002556	0.2857142857142857
26696028309	3	0.6553961488409483	0.0	0	3	0.21846538294698278	0.0
26696028310	1	0.21863525596118089	0.0	0	1	0.21863525596118089	0.0
26696028311	5	1.4760236125734356	0.0	0	5	0.2952047225146871	0.0
26696028312	2	0.21936625087620235	1.0	1	1	0.21936625087620235	1.0
26696028313	2	0.44010203559070843	0.0	0	2	0.22005101779535421	0.0
26696028314	24	16.69489539560744	0.0	0	24	0.75885888161852	0.0
26696028315	15	2.5499596523533503	4.0	4	11	0.28332885026148336	0.36363636363636365
26696028316	1	0.2210313677995309	0.0	0	1	0.2210313677995309	0.0
26696028317	12	1.1191169530249152	5.0	6	6	0.22382339060498305	1.0
26696028318	16	2.78416902921579	3.0	4	12	0.34802112865197377	0.3333333333333333
26696028319	7	1.560388324592718	2.0	2	5	0.3120776649185436	0.4
26696028320	2	0.2210947671558473	1.0	1	1	0.2210947671558473	1.0
26696028321	11	1.4956873454851123	5.0	5	6	0.24928122424751872	0.8333333333333334
26696028322	3	0.44231798282170365	1.0	1	2	0.22115899141085182	0.5
26696028323	2	0.22116318324296091	1.0	1	1	0.22116318324296091	1.0
26696028324	38	5.981347222517297	9.0	11	27	0.27187941920533165	0.4074074074074074
26696028325	11	4.430676978865455	3.0	3	8	0.5538346223581819	0.375
26696028326	7	3.966339386148106	0.5	1	6	0.7932678772296212	0.16666666666666666
26696028327	3	0.5424298087814136	0.5	1	2	0.5424298087814136	0.5
26696028328	2	0.22131321379619823	1.0	1	1	0.22131321379619823	1.0
26696028329	3	1.682659555523712	0.0	0	3	0.560886518507904	0.0
26696028330	9	6.774529162138283	0.0	0	9	0.8468161452672853	0.0
26696028331	2	0.7729763324445414	0.0	0	2	0.7729763324445414	0.0
26696028332	1	0.22132099141240064	0.0	0	1	0.22132099141240064	0.0
26696028333	2	0.2213283986659267	1.0	1	1	0.2213283986659267	1.0
26696028334	1	0.22132984644729772	0.0	0	1	0.22132984644729772	0.0
26696028335	2	1.187671050739451	0.0	0	2	0.5938355253697255	0.0
26696028336	10	1.275616900483919	5.0	5	5	0.2551233800967838	1.0
26696028337	1	0.2213984982197508	0.0	0	1	0.2213984982197508	0.0
26696028338	2	0.22144146029020206	1.0	1	1	0.22144146029020206	1.0
26696028339	33	5.426716185727725	6.0	8	25	0.31921859916045436	0.32
26696028340	4	0.28290849984698974	1.0	2	2	0.28290849984698974	1.0
26696028341	9	1.1081213565361285	4.0	4	5	0.2216242713072257	0.8
26696028342	8	2.9602004564416964	2.0	2	6	0.49336674274028275	0.3333333333333333
26696028343	35	5.396199109264296	8.0	10	25	0.25696186234591883	0.4
26696028344	9	1.277615747847932	4.0	4	5	0.2555231495695864	0.8
26696028345	15	5.814614827698697	2.5	4	11	0.7268268534623371	0.36363636363636365
26696028346	29	4.602965083183289	9.0	9	20	0.23014825415916446	0.45
26696028347	2	0.221991852896524	1.0	1	1	0.221991852896524	1.0
26696028348	1	0.2219921222511977	0.0	0	1	0.2219921222511977	0.0
26696028349	2	0.6091490287895366	0.0	0	2	0.3045745143947683	0.0
26696028350	1	0.22200700409691826	0.0	0	1	0.22200700409691826	0.0
26696028351	11	1.5007482167794695	5.0	5	6	0.2501247027965782	0.8333333333333334
26696028352	3	0.6662230956346799	0.0	0	3	0.22207436521155996	0.0
26696028353	8	3.128897120218075	2.0	2	6	0.5214828533696791	0.3333333333333333
26696028354	9	2.001015904821102	1.0	1	8	0.333502650803517	0.125
26696028355	13	2.2832252609432317	4.0	4	9	0.2536916956603591	0.4444444444444444
26696028356	3	0.6668852704305772	0.0	0	3	0.22229509014352575	0.0
26696028357	3	0.444643086034206	1.0	1	2	0.222321543017103	0.5
26696028358	5	0.8898217501676817	1.0	1	4	0.22245543754192043	0.25
26696028359	1	0.22244999152711203	0.0	0	1	0.22244999152711203	0.0
26696028360	2	0.2224629542207827	1.0	1	1	0.2224629542207827	1.0
26696028361	9	1.1139075999666943	4.0	4	5	0.22278151999333887	0.8
26696028362	2	0.4449957386407158	0.0	0	2	0.2224978693203579	0.0
26696028363	2	0.445020687617365	0.0	0	2	0.2225103438086825	0.0
26696028364	36	6.712235136394639	6.0	6	30	0.22374117121315465	0.2
26696028365	4	2.0040681309751913	0.0	0	4	0.5010170327437978	0.0
26696028366	1	0.2225292828091753	0.0	0	1	0.2225292828091753	0.0
26696028367	2	1.0898566517995232	0.0	0	2	0.5449283258997616	0.0
26696028368	2	0.6582654158329438	0.0	0	2	0.3291327079164719	0.0
26696028369	4	0.44512994460687466	2.0	2	2	0.22256497230343733	1.0
26696028370	3	1.4120181072332605	0.0	0	3	0.47067270241108683	0.0
26696028371	6	2.9060140063756927	0.0	0	6	0.4843356677292821	0.0
26696028372	1	0.22260520715781762	0.0	0	1	0.22260520715781762	0.0
26696028373	1	0.22261386017670945	0.0	0	1	0.22261386017670945	0.0
26696028374	2	0.44690620400242864	0.0	0	2	0.22345310200121432	0.0
26696028375	4	0.44535886241016476	2.0	2	2	0.22267943120508238	1.0
26696028376	5	2.252960670817041	1.0	1	4	0.5632401677042602	0.25
26696028377	26	4.4853394796478465	6.0	6	20	0.22426697398239231	0.3
26696028378	18	3.3605675262571144	3.0	3	15	0.22403783508380762	0.2
26696028379	24	4.042912946892652	6.0	6	18	0.22460627482736953	0.3333333333333333
26696028380	28	4.716211821458119	7.0	7	21	0.22458151530752946	0.3333333333333333
26696028381	20	3.597136988770301	4.0	4	16	0.22482106179814382	0.25
26696028382	22	3.826241353841236	5.0	5	17	0.22507302081419034	0.29411764705882354
26696028383	14	2.4752189154858293	3.0	3	11	0.22501990140780267	0.2727272727272727
26696028384	14	2.4765537362405636	3.0	3	11	0.22514124874914215	0.2727272727272727
26696028385	4	1.8487905150253274	0.0	0	4	0.46219762875633186	0.0
26696028386	2	0.4481767836674908	0.0	0	2	0.2240883918337454	0.0
26696028387	2	0.4481623395231149	0.0	0	2	0.22408116976155745	0.0
26696028388	2	0.44814806372541016	0.0	0	2	0.22407403186270508	0.0
26696028389	1	0.2240858834683468	0.0	0	1	0.2240858834683468	0.0
26696028390	1	0.22409709535663855	0.0	0	1	0.22409709535663855	0.0
26696028391	1	0.22411531046644587	0.0	0	1	0.22411531046644587	0.0
26696028392	1	0.22412315542131667	0.0	0	1	0.22412315542131667	0.0
26696028393	1	0.22413702718701095	0.0	0	1	0.22413702718701095	0.0
26696028394	4	0.987672882351232	1.0	1	3	0.3292242941170773	0.3333333333333333
26696028395	1	0.2242029854127273	0.0	0	1	0.2242029854127273	0.0
26696028396	3	1.0971028649000794	0.0	0	3	0.36570095496669314	0.0
26696028397	2	0.4484560034560898	0.0	0	2	0.2242280017280449	0.0
26696028398	2	0.6710902672493302	0.0	0	2	0.3355451336246651	0.0
26696028399	2	0.6151713279222448	0.0	0	2	0.3075856639611224	0.0
26696028400	3	0.7470650188849612	0.0	0	3	0.24902167296165376	0.0
26696028401	2	0.8355413626592336	0.0	0	2	0.4177706813296168	0.0
26696028402	1	0.2242970912018427	0.0	0	1	0.2242970912018427	0.0
26696028403	1	0.22430830309013447	0.0	0	1	0.22430830309013447	0.0
26696028404	3	1.1185579410690356	0.0	0	3	0.37285264702301185	0.0
26696028405	1	0.2243665173689826	0.0	0	1	0.2243665173689826	0.0
26696028406	6	1.8052178848675098	0.0	0	6	0.45130447121687745	0.0
26696028407	3	0.8185286184458727	0.0	0	3	0.2728428728152909	0.0
26696028408	3	0.8406432768719923	0.0	0	3	0.2802144256239974	0.0
26696028409	1	0.22445658283799289	0.0	0	1	0.22445658283799289	0.0
26696028410	2	0.4489621208879263	0.0	0	2	0.22448106044396315	0.0
26696028411	4	2.3677389597663914	0.0	0	4	0.5919347399415978	0.0
26696028412	2	0.5952691487856969	0.0	0	2	0.29763457439284846	0.0
26696028413	2	0.4491784126908879	0.0	0	2	0.22458920634544394	0.0
26696028414	3	1.351905214629043	0.0	0	3	0.4506350715430143	0.0
26696028415	1	0.2246407204267844	0.0	0	1	0.2246407204267844	0.0
26696028416	2	1.0402817220935174	0.0	0	2	0.5201408610467587	0.0
26696028417	3	0.8191708273265839	0.0	0	3	0.27305694244219464	0.0
26696028418	1	0.22469102241209332	0.0	0	1	0.22469102241209332	0.0
26696028419	2	0.44958372413610126	0.0	0	2	0.22479186206805063	0.0
26696028420	2	0.44953588001218964	0.0	0	2	0.22476794000609482	0.0
26696028421	4	2.200809161641322	0.0	0	4	0.5502022904103305	0.0
26696028422	2	0.4495531523806391	0.0	0	2	0.22477657619031954	0.0
26696028423	1	0.22479677779084523	0.0	0	1	0.22479677779084523	0.0
26696028424	1	0.22480502677772654	0.0	0	1	0.22480502677772654	0.0
26696028425	7	1.5334923850235165	1.0	2	5	0.5111641283411722	0.4
26696028426	6	2.0857476462526012	0.0	0	6	0.34762460770876685	0.0
26696028427	3	2.1594396170288315	0.0	0	3	0.7198132056762772	0.0
26696028428	1	0.22487058097143234	0.0	0	1	0.22487058097143234	0.0
26696028429	1	0.22491583255660985	0.0	0	1	0.22491583255660985	0.0
26696028430	1	0.22492744847691212	0.0	0	1	0.22492744847691212	0.0
26696028431	4	2.92017357753881	0.0	0	4	0.7300433943847024	0.0
26696028432	2	0.45002523011558987	0.0	0	2	0.22501261505779493	0.0
26696028433	1	0.22498913069718382	0.0	0	1	0.22498913069718382	0.0
26696028434	2	0.9287727591652388	0.0	0	2	0.4643863795826194	0.0
26696028435	2	0.4500388325266105	0.0	0	2	0.22501941626330524	0.0
26696028436	3	1.5787547443879704	0.0	0	3	0.5262515814626568	0.0
26696028437	6	3.256911969202525	0.0	0	6	0.5428186615337541	0.0
26696028438	1	0.2250848862836755	0.0	0	1	0.2250848862836755	0.0
26696028439	4	2.0793116183411273	0.0	0	4	0.5198279045852818	0.0
26696028440	1	0.22510882518029846	0.0	0	1	0.22510882518029846	0.0
26696028441	13	3.412384530597462	5.0	5	8	0.42654806632468273	0.625
26696028442	14	2.708674637971326	2.0	4	10	0.451445772995221	0.4
26696028443	3	1.340116941004963	0.0	0	3	0.4467056470016543	0.0
26696028444	2	0.22525848537085946	1.0	1	1	0.22525848537085946	1.0
26696028445	2	0.22532851758601513	1.0	1	1	0.22532851758601513	1.0
26696028446	2	0.22544319533833254	1.0	1	1	0.22544319533833254	1.0
26696028447	3	0.6549122868390242	1.0	1	2	0.3274561434195121	0.5
26696028448	4	0.717941314148457	2.0	2	2	0.3589706570742285	1.0
26696028449	2	0.22559578476096978	1.0	1	1	0.22559578476096978	1.0
26696028450	2	0.225647096826305	1.0	1	1	0.225647096826305	1.0
26696028451	2	0.22568941917940627	1.0	1	1	0.22568941917940627	1.0
26696028452	2	0.22575103406100958	1.0	1	1	0.22575103406100958	1.0
26696028453	2	0.2257966560088634	1.0	1	1	0.2257966560088634	1.0
26696028454	3	0.7038986092443804	1.0	1	2	0.3519493046221902	0.5
26696028455	2	0.22597200590142622	1.0	1	1	0.22597200590142622	1.0
26696028456	5	1.1202221825896748	1.0	1	4	0.2800555456474187	0.25
26696028457	2	0.22608705401641993	1.0	1	1	0.22608705401641993	1.0
26696028458	4	1.7544754036591228	1.0	1	3	0.584825134553041	0.3333333333333333
26696028459	2	0.22620459366214513	1.0	1	1	0.22620459366214513	1.0
26696028460	2	0.22625311117274097	1.0	1	1	0.22625311117274097	1.0
26696028461	3	0.45273032543398006	1.0	1	2	0.22636516271699003	0.5
26696028462	2	0.22631297524896538	1.0	1	1	0.22631297524896538	1.0
26696028463	3	0.8993191622921504	1.0	1	2	0.4496595811460752	0.5
26696028464	4	0.4529567517065386	2.0	2	2	0.2264783758532693	1.0
26696028465	2	0.22642980783867217	1.0	1	1	0.22642980783867217	1.0
26696028466	2	0.22649122070427022	1.0	1	1	0.22649122070427022	1.0
26696028467	3	0.45320364893429654	1.0	1	2	0.22660182446714827	0.5
26696028468	2	0.22655088276448937	1.0	1	1	0.22655088276448937	1.0
26696028469	2	0.22661037647803747	1.0	1	1	0.22661037647803747	1.0
26696028470	8	0.5087115530293529	2.0	4	4	0.25435577651467645	1.0
26696028471	16	6.665393045538415	0.0	0	16	0.4165870653461509	0.0
26696028472	39	7.151018445172367	8.0	8	31	0.23067801436039895	0.25806451612903225
26696028473	3	0.22991737848409008	0.5	1	2	0.22991737848409008	0.5
26696028474	3	0.45351067959295255	1.0	1	2	0.22675533979647627	0.5
26696028475	1	0.2267482524016252	0.0	0	1	0.2267482524016252	0.0
26696028476	2	0.556807018520861	0.0	0	2	0.2784035092604305	0.0
26696028477	1	0.22676202315931687	0.0	0	1	0.22676202315931687	0.0
26696028478	3	0.4535365376416254	1.0	1	2	0.2267682688208127	0.5
26696028479	2	1.1244678182948185	0.0	0	2	0.5622339091474092	0.0
26696028480	5	0.9180088413651475	2.0	2	3	0.30600294712171583	0.6666666666666666
26696028481	2	0.22683000154508576	1.0	1	1	0.22683000154508576	1.0
26696028482	11	1.5249830668500928	5.0	5	6	0.25416384447501544	0.8333333333333334
26696028483	2	0.45374575888440294	0.0	0	2	0.22687287944220147	0.0
26696028484	3	0.45380511792061423	1.0	1	2	0.22690255896030712	0.5
26696028485	3	1.1966737256670459	1.0	1	2	0.5983368628335229	0.5
26696028486	49	7.957131395620502	15.0	15	34	0.23403327634177948	0.4411764705882353
26696028487	3	0.45404275608146455	1.0	1	2	0.22702137804073227	0.5
26696028488	4	0.46252547548086287	2.0	2	2	0.23126273774043143	1.0
26696028489	2	0.22705686551898904	1.0	1	1	0.22705686551898904	1.0
26696028490	9	1.300520255185271	4.0	4	5	0.2601040510370542	0.8
26696028491	3	0.6412806508363109	0.5	1	2	0.6412806508363109	0.5
26696028492	4	1.7907048867031954	0.0	0	4	0.5969016289010651	0.0
26696028493	3	0.8533352690955881	1.0	1	2	0.42666763454779405	0.5
26696028494	3	0.45452227473927564	1.0	1	2	0.22726113736963782	0.5
26696028495	1	0.22727083413789012	0.0	0	1	0.22727083413789012	0.0
26696028496	3	1.192485597184732	0.0	0	3	0.3974951990615773	0.0
26696028497	6	0.9180808937403556	2.0	2	4	0.2295202234350889	0.5
26696028498	3	0.4546281311260301	1.0	1	2	0.22731406556301506	0.5
26696028499	4	0.4547781280099332	2.0	2	2	0.2273890640049666	1.0
26696028500	49	8.21601557974368	14.0	14	35	0.23474330227839083	0.4
26696028501	2	0.9566657823977193	0.0	0	2	0.9566657823977193	0.0
26696028502	3	0.5179768150944474	0.5	1	2	0.5179768150944474	0.5
26696028503	2	0.22753513841143436	1.0	1	1	0.22753513841143436	1.0
26696028504	2	0.9566802938807635	0.0	0	2	0.9566802938807635	0.0
26696028505	1	0.22753079506732132	0.0	0	1	0.22753079506732132	0.0
26696028506	1	0.22753136744600289	0.0	0	1	0.22753136744600289	0.0
26696028507	4	1.0702168577844695	1.0	1	3	0.3567389525948232	0.3333333333333333
26696028508	2	0.2276326111339707	1.0	1	1	0.2276326111339707	1.0
26696028509	11	1.9686378232479145	4.5	5	6	0.3937275646495829	0.8333333333333334
26696028510	5	3.707688867204341	0.0	0	5	0.7415377734408681	0.0
26696028511	14	4.337671503591997	6.0	6	8	0.5422089379489996	0.75
26696028512	2	0.22775169956906957	1.0	1	1	0.22775169956906957	1.0
26696028513	6	0.9196651032535789	2.0	2	4	0.22991627581339472	0.5
26696028514	32	6.109318368705943	8.0	8	24	0.2545549320294143	0.3333333333333333
26696028515	14	2.010388302707651	7.0	7	7	0.2871983289582358	1.0
26696028516	2	0.2278632797426397	1.0	1	1	0.2278632797426397	1.0
26696028517	11	5.350772847580911	0.5	1	10	0.6688466059476139	0.1
26696028518	3	0.5896231044627793	1.0	1	2	0.29481155223138966	0.5
26696028519	2	0.22796795770269687	1.0	1	1	0.22796795770269687	1.0
26696028520	3	0.3420127265369605	0.5	1	2	0.3420127265369605	0.5
26696028521	1	0.22797677906825975	0.0	0	1	0.22797677906825975	0.0
26696028522	1	0.2279773177776071	0.0	0	1	0.2279773177776071	0.0
26696028523	6	0.9204761301760161	2.0	2	4	0.23011903254400404	0.5
26696028524	2	0.2280193371067005	1.0	1	1	0.2280193371067005	1.0
26696028525	11	1.5344908491294977	5.0	5	6	0.2557484748549163	0.8333333333333334
26696028526	4	0.45617227413154415	2.0	2	2	0.22808613706577208	1.0
26696028527	44	7.038124056480038	14.0	14	30	0.23460413521600126	0.4666666666666667
26696028528	3	0.5716477539843701	0.5	1	2	0.5716477539843701	0.5
26696028529	3	0.5399397258312849	0.5	1	2	0.5399397258312849	0.5
26696028530	1	0.2282147539224522	0.0	0	1	0.2282147539224522	0.0
26696028531	2	0.22825091478739315	1.0	1	1	0.22825091478739315	1.0
26696028532	11	1.5357365471565794	5.0	5	6	0.25595609119276325	0.8333333333333334
26696028533	3	0.45665307222405516	1.0	1	2	0.22832653611202758	0.5
26696028534	8	1.2582876308596551	4.0	4	4	0.3145719077149138	1.0
26696028535	10	4.823124448896129	2.0	2	8	0.6028905561120161	0.25
26696028536	7	3.8603126325624815	0.5	1	6	0.7720625265124963	0.16666666666666666
26696028537	11	3.438720650146763	3.5	4	7	0.5731201083577938	0.5714285714285714
26696028538	12	4.26757417194397	4.0	4	8	0.5334467714929962	0.5
26696028539	9	7.393398292028749	0.0	0	9	0.9241747865035936	0.0
26696028540	8	4.051145334792203	0.5	1	7	0.8102290669584405	0.14285714285714285
26696028541	11	7.320085572633053	0.0	0	11	0.9150106965791316	0.0
26696028542	10	6.109484459531599	0.5	1	9	0.8727834942187999	0.1111111111111111
26696028543	3	0.45711430843339046	1.0	1	2	0.22855715421669523	0.5
26696028544	11	1.5381699309478991	5.0	5	6	0.2563616551579832	0.8333333333333334
26696028545	2	0.4572055523290981	0.0	0	2	0.22860277616454905	0.0
26696028546	3	0.4572796585336931	1.0	1	2	0.22863982926684656	0.5
26696028547	48	7.9803128332317135	14.0	14	34	0.23471508333034452	0.4117647058823529
26696028548	11	6.016764500212235	0.5	1	10	0.7520955625265294	0.1
26696028549	3	0.2849835745836526	0.5	1	2	0.2849835745836526	0.5
26696028550	1	0.2287372683200487	0.0	0	1	0.2287372683200487	0.0
26696028551	4	1.1212184245195984	1.0	1	3	0.5606092122597992	0.3333333333333333
26696028552	1	0.22874501226691688	0.0	0	1	0.22874501226691688	0.0
26696028553	1	0.22874558464559844	0.0	0	1	0.22874558464559844	0.0
26696028554	5	0.6940564568069411	2.0	2	3	0.23135215226898034	0.6666666666666666
26696028555	8	3.887872767087633	1.0	1	7	0.5554103952982333	0.14285714285714285
26696028556	8	1.144128318950411	3.0	3	5	0.2288256637900822	0.6
26696028557	2	0.2288515757096898	1.0	1	1	0.2288515757096898	1.0
26696028558	8	1.9505351016781907	4.0	4	4	0.48763377541954767	1.0
26696028559	3	0.24924074809624325	0.5	1	2	0.24924074809624325	0.5
26696028560	3	0.7818029504235553	0.0	0	3	0.26060098347451843	0.0
26696028561	1	0.22898669074787234	0.0	0	1	0.22898669074787234	0.0
26696028562	6	0.9239894241927702	2.0	2	4	0.23099735604819255	0.5
26696028563	32	5.219814356045197	10.0	10	22	0.23726428891114534	0.45454545454545453
26696028564	13	1.4893279489782991	4.5	6	7	0.2978655897956598	0.8571428571428571
26696028565	4	0.4582477865695518	2.0	2	2	0.2291238932847759	1.0
26696028566	6	0.9248476555217692	2.0	2	4	0.2312119138804423	0.5
26696028567	7	3.165958841865137	1.0	1	6	0.6331917683730274	0.16666666666666666
26696028568	10	1.5421106571624421	4.0	4	6	0.25701844286040704	0.6666666666666666
26696028569	12	2.9457364471586565	4.5	5	7	0.49095607452644274	0.7142857142857143
26696028570	4	0.8026176695251819	0.5	1	3	0.40130883476259094	0.3333333333333333
26696028571	14	5.111981276348569	6.0	6	8	0.6389976595435711	0.75
26696028572	1	0.22946654609902548	0.0	0	1	0.22946654609902548	0.0
26696028573	2	0.22946826323507016	1.0	1	1	0.22946826323507016	1.0
26696028574	2	1.0973695596963524	0.0	0	2	0.5486847798481762	0.0
26696028575	2	0.2294998114012244	1.0	1	1	0.2294998114012244	1.0
26696028576	3	1.7183225183503765	0.0	0	3	0.5727741727834589	0.0
26696028577	21	3.574930076368448	6.0	6	15	0.23832867175789654	0.4
26696028578	2	0.2295399452476021	1.0	1	1	0.2295399452476021	1.0
26696028579	9	1.3139583935242827	4.0	4	5	0.26279167870485654	0.8
26696028580	7	3.878503870811842	1.0	1	6	0.6464173118019737	0.16666666666666666
26696028581	31	5.016406224826913	10.0	10	21	0.23887648689651964	0.47619047619047616
26696028582	5	3.1452886988846056	0.0	0	5	0.6290577397769211	0.0
26696028583	1	0.22972603565777774	0.0	0	1	0.22972603565777774	0.0
26696028584	5	1.2061328557585185	0.5	1	4	0.6030664278792592	0.25
26696028585	3	0.8276938489190309	0.0	0	3	0.8276938489190309	0.0
26696028586	2	0.4650283527779911	0.0	0	2	0.4650283527779911	0.0
26696028587	2	0.8276910543642915	0.0	0	2	0.8276910543642915	0.0
26696028588	4	1.057444867222792	1.0	1	3	0.528722433611396	0.3333333333333333
26696028589	10	1.1017303781938268	4.0	5	5	0.2754325945484567	1.0
26696028590	3	0.6894840938826288	0.0	0	3	0.2298280312942096	0.0
26696028591	5	0.7574432881310176	2.0	2	3	0.2524810960436725	0.6666666666666666
26696028592	26	4.254431279996641	8.0	8	18	0.23635729333314673	0.4444444444444444
26696028593	5	1.6622487337552618	0.5	1	4	0.8311243668776309	0.25
26696028594	3	0.3001393203380253	0.5	1	2	0.3001393203380253	0.5
26696028595	5	1.508545361195695	0.3333333333333333	1	4	0.7542726805978475	0.25
26696028596	3	1.567975944742158	0.0	0	3	0.783987972371079	0.0
26696028597	3	0.5763954668012452	0.5	1	2	0.5763954668012452	0.5
26696028598	11	1.3253021309287951	4.5	5	6	0.26506042618575903	0.8333333333333334
26696028599	3	0.6901947861891219	0.0	0	3	0.2300649287297073	0.0
26696028600	14	2.6810978371257406	3.0	3	11	0.24373616701143097	0.2727272727272727
26696028601	16	2.646734544268895	5.0	5	11	0.2406122312971723	0.45454545454545453
26696028602	9	1.151561127501156	4.0	4	5	0.23031222550023117	0.8
26696028603	3	0.6909378683951246	0.0	0	3	0.23031262279837486	0.0
26696028604	4	0.46067881350747697	2.0	2	2	0.23033940675373848	1.0
26696028605	30	5.067279309382698	9.0	9	21	0.24129901473250945	0.42857142857142855
26696028606	6	1.0023541261785909	1.0	2	4	0.5011770630892954	0.5
26696028607	2	0.2304374013509551	1.0	1	1	0.2304374013509551	1.0
26696028608	1	0.23045191283399938	0.0	0	1	0.23045191283399938	0.0
26696028609	3	0.5693817404534054	0.5	1	2	0.5693817404534054	0.5
26696028610	16	5.643800362800544	5.0	5	11	0.5130727602545949	0.45454545454545453
26696028611	3	0.6915903464227695	0.0	0	3	0.2305301154742565	0.0
26696028612	3	0.4991004732325931	1.0	1	2	0.24955023661629655	0.5
26696028613	29	4.498507791942504	10.0	10	19	0.23676356799697387	0.5263157894736842
26696028614	4	1.0767097195320892	1.0	1	3	0.5383548597660446	0.3333333333333333
26696028615	2	0.23063423227874358	1.0	1	1	0.23063423227874358	1.0
26696028616	1	0.23064948448714045	0.0	0	1	0.23064948448714045	0.0
26696028617	1	0.23065120162318514	0.0	0	1	0.23065120162318514	0.0
26696028618	1	0.23065005686582202	0.0	0	1	0.23065005686582202	0.0
26696028619	3	1.0311204982711302	0.0	0	3	0.5155602491355651	0.0
26696028620	10	2.010458772624151	4.0	4	6	0.3350764621040252	0.6666666666666666
26696028621	3	0.69217487973398	0.0	0	3	0.23072495991132666	0.0
26696028622	3	0.49909047344033297	1.0	1	2	0.24954523672016649	0.5
26696028623	20	3.611077540914385	5.0	5	15	0.24073850272762568	0.3333333333333333
26696028624	10	1.7294436677864302	3.0	3	7	0.24706338111234719	0.42857142857142855
26696028625	2	0.4617967364112335	0.0	0	2	0.23089836820561674	0.0
26696028626	3	0.4990669722450547	1.0	1	2	0.24953348612252735	0.5
26696028627	31	5.3481550231767905	9.0	9	22	0.243097955598945	0.4090909090909091
26696028628	2	0.6910574618702365	0.0	0	2	0.6910574618702365	0.0
26696028629	3	0.3180561535135785	0.5	1	2	0.3180561535135785	0.5
26696028630	3	0.691082915886899	0.5	1	2	0.691082915886899	0.5
26696028631	1	0.23107930720765835	0.0	0	1	0.23107930720765835	0.0
26696028632	16	5.612889927505547	5.0	5	11	0.5102627206823225	0.45454545454545453
26696028633	2	0.4622856151439547	0.0	0	2	0.23114280757197736	0.0
26696028634	6	1.2713217371881533	2.0	2	4	0.31783043429703833	0.5
26696028635	28	4.814482406207252	8.0	8	20	0.24072412031036258	0.4
26696028636	8	5.425782871783438	0.0	0	8	0.6782228589729298	0.0
26696028637	18	4.4488185211775235	7.5	8	10	0.49431316901972483	0.8
26696028638	2	0.231299639330725	1.0	1	1	0.231299639330725	1.0
26696028639	2	1.2151189653736822	0.0	0	2	0.6075594826868411	0.0
26696028640	6	3.1818826188021614	1.0	1	5	0.6363765237604323	0.2
26696028641	2	0.23131832581121126	1.0	1	1	0.23131832581121126	1.0
26696028642	5	0.6941687103671954	2.0	2	3	0.23138957012239847	0.6666666666666666
26696028643	10	1.3241093947644251	5.0	5	5	0.264821878952885	1.0
26696028644	4	0.4628501152013105	2.0	2	2	0.23142505760065524	1.0
26696028645	23	3.547658185013463	8.0	8	15	0.2365105456675642	0.5333333333333333
26696028646	11	1.9659780468533696	3.0	3	8	0.2457472558566712	0.375
26696028647	3	0.6948099428372145	0.0	0	3	0.23160331427907152	0.0
26696028648	4	0.4632470093129715	2.0	2	2	0.23162350465648576	1.0
26696028649	27	4.32461581522027	9.0	9	18	0.24025643417890385	0.5
26696028650	3	0.6955627218114695	0.0	0	3	0.23185424060382318	0.0
26696028651	3	0.49920292901659247	1.0	1	2	0.24960146450829623	0.5
26696028652	30	5.096398805452425	9.0	9	21	0.24268565740249645	0.42857142857142855
26696028653	7	2.2880481573833973	2.0	2	5	0.45760963147667943	0.4
26696028654	5	2.544347109017971	1.0	1	4	0.6360867772544927	0.25
26696028655	2	0.5909430433717926	0.0	0	2	0.5909430433717926	0.0
26696028656	2	0.5909481274412582	0.0	0	2	0.5909481274412582	0.0
26696028657	14	3.501144033472436	5.0	5	9	0.38901600371915956	0.5555555555555556
26696028658	3	0.6961991395666965	0.0	0	3	0.23206637985556552	0.0
26696028659	25	4.023931253684057	8.0	8	17	0.23670183845200335	0.47058823529411764
26696028660	4	0.23458940263766237	1.0	2	2	0.23458940263766237	1.0
26696028661	5	2.311345350165621	1.0	1	4	0.5778363375414053	0.25
26696028662	3	1.9614085458224655	0.0	0	3	0.6538028486074885	0.0
26696028663	1	0.23220861034637766	0.0	0	1	0.23220861034637766	0.0
26696028664	9	1.328813000753486	4.0	4	5	0.2657626001506972	0.8
26696028665	3	0.6968200694281873	0.0	0	3	0.23227335647606243	0.0
26696028666	4	0.4645947254227075	2.0	2	2	0.23229736271135376	1.0
26696028667	14	2.3712966299656335	4.0	4	10	0.23712966299656335	0.4
26696028668	2	0.2324182356211657	1.0	1	1	0.2324182356211657	1.0
26696028669	26	5.521411255530483	5.0	5	21	0.26292434550145155	0.23809523809523808
26696028670	5	1.4577790420986876	0.0	0	5	0.3644447605246719	0.0
26696028671	1	0.232466988817101	0.0	0	1	0.232466988817101	0.0
26696028672	6	3.2110193872403388	0.0	0	6	0.5351698978733898	0.0
26696028673	2	0.46723978831820223	0.0	0	2	0.23361989415910112	0.0
26696028674	1	0.23252904140004904	0.0	0	1	0.23252904140004904	0.0
26696028675	2	0.7958396285168083	0.0	0	2	0.39791981425840417	0.0
26696028676	2	0.6797826119235166	0.0	0	2	0.3398913059617583	0.0
26696028677	4	0.46518902284083863	2.0	2	2	0.23259451142041931	1.0
26696028678	3	0.46651758109940944	1.0	1	2	0.23325879054970472	0.5
26696028679	12	2.1212087950900145	3.0	3	9	0.23568986612111273	0.3333333333333333
26696028680	1	0.23393251392723594	0.0	0	1	0.23393251392723594	0.0
26696028681	5	3.8707264566254636	0.0	0	5	0.7741452913250927	0.0
26696028682	2	0.9776794535951896	0.0	0	2	0.4888397267975948	0.0
26696028683	1	0.23397318648296095	0.0	0	1	0.23397318648296095	0.0
26696028684	2	1.2026242754485539	0.0	0	2	0.6013121377242769	0.0
26696028685	2	0.5104290594367114	0.0	0	2	0.2552145297183557	0.0
26696028686	1	0.2340299866497723	0.0	0	1	0.2340299866497723	0.0
26696028687	2	0.5351076039935467	0.0	0	2	0.26755380199677337	0.0
26696028688	1	0.23405379086905836	0.0	0	1	0.23405379086905836	0.0
26696028689	12	3.3268369811980674	3.0	3	9	0.3696485534664519	0.3333333333333333
26696028690	1	0.23413527065784526	0.0	0	1	0.23413527065784526	0.0
26696028691	1	0.2341553039116999	0.0	0	1	0.2341553039116999	0.0
26696028692	1	0.2341635528985812	0.0	0	1	0.2341635528985812	0.0
26696028693	2	0.4686456513681181	0.0	0	2	0.23432282568405904	0.0
26696028694	1	0.2342009931982221	0.0	0	1	0.2342009931982221	0.0
26696028695	1	0.23420924218510342	0.0	0	1	0.23420924218510342	0.0
26696028696	1	0.23422045407339517	0.0	0	1	0.23422045407339517	0.0
26696028697	3	0.9659834676161778	0.0	0	3	0.3219944892053926	0.0
26696028698	1	0.2342786346829091	0.0	0	1	0.2342786346829091	0.0
26696028699	1	0.23428688366979042	0.0	0	1	0.23428688366979042	0.0
26696028700	1	0.23429557035801646	0.0	0	1	0.23429557035801646	0.0
26696028701	1	0.23430833103568185	0.0	0	1	0.23430833103568185	0.0
26696028702	2	0.46874534626671227	0.0	0	2	0.23437267313335614	0.0
26696028703	2	0.4688297889569095	0.0	0	2	0.23441489447845476	0.0
26696028704	2	0.46880877929236286	0.0	0	2	0.23440438964618143	0.0
26696028705	3	2.1297424225227375	0.0	0	3	0.7099141408409125	0.0
26696028706	4	2.505825821732929	0.0	0	4	0.6264564554332323	0.0
26696028707	8	1.5061668584191366	2.0	2	6	0.2510278097365228	0.3333333333333333
26696028708	1	0.23448361358957628	0.0	0	1	0.23448361358957628	0.0
26696028709	2	0.46905651825347605	0.0	0	2	0.23452825912673803	0.0
26696028710	3	0.8338898818162599	1.0	1	2	0.41694494090812995	0.5
26696028711	2	0.9348444848805666	0.0	0	2	0.4674222424402833	0.0
26696028712	2	0.4692313294366915	0.0	0	2	0.23461566471834575	0.0
26696028713	2	0.681359616199219	0.0	0	2	0.3406798080996095	0.0
26696028714	1	0.2346126008089327	0.0	0	1	0.2346126008089327	0.0
26696028715	1	0.23462347600388234	0.0	0	1	0.23462347600388234	0.0
26696028716	3	0.5627518108462192	1.0	1	2	0.2813759054231096	0.5
26696028717	2	0.46936684850688454	0.0	0	2	0.23468342425344227	0.0
26696028718	2	0.4693367817914355	0.0	0	2	0.23466839089571775	0.0
26696028719	7	2.1798147156336856	2.0	2	5	0.4359629431267371	0.4
26696028720	2	0.4694556345411949	0.0	0	2	0.23472781727059744	0.0
26696028721	1	0.23478532449342718	0.0	0	1	0.23478532449342718	0.0
26696028722	1	0.2348081523020212	0.0	0	1	0.2348081523020212	0.0
26696028723	1	0.23481936419031296	0.0	0	1	0.23481936419031296	0.0
26696028724	1	0.234834481721373	0.0	0	1	0.234834481721373	0.0
26696028725	1	0.23484993594577513	0.0	0	1	0.23484993594577513	0.0
26696028726	2	0.8878574812099022	0.0	0	2	0.4439287406049511	0.0
26696028727	1	0.23487283109303755	0.0	0	1	0.23487283109303755	0.0
26696028728	3	1.667616669377609	0.0	0	3	0.5558722231258697	0.0
26696028729	1	0.2349160961874967	0.0	0	1	0.2349160961874967	0.0
26696028730	1	0.2349239411423675	0.0	0	1	0.2349239411423675	0.0
26696028731	2	0.4698987229793913	0.0	0	2	0.23494936148969564	0.0
26696028732	5	2.6118279293659117	0.0	0	5	0.5223655858731824	0.0
26696028733	2	0.4699682164851996	0.0	0	2	0.2349841082425998	0.0
26696028734	2	0.47024511308973815	0.0	0	2	0.23512255654486908	0.0
26696028735	1	0.23501686850478562	0.0	0	1	0.23501686850478562	0.0
26696028736	1	0.23502848442508786	0.0	0	1	0.23502848442508786	0.0
26696028737	2	0.47020312742997894	0.0	0	2	0.23510156371498947	0.0
26696028738	5	3.4396816402837693	0.0	0	5	0.6879363280567539	0.0
26696028739	1	0.23508764144529387	0.0	0	1	0.23508764144529387	0.0
26696028740	4	1.250489375355401	0.0	0	4	0.31262234383885024	0.0
26696028741	6	3.5055682849955607	0.0	0	6	0.5842613808325935	0.0
26696028742	2	0.4702597929194535	0.0	0	2	0.23512989645972676	0.0
26696028743	1	0.23516295974592044	0.0	0	1	0.23516295974592044	0.0
26696028744	2	0.4703688478929579	0.0	0	2	0.23518442394647895	0.0
26696028745	2	1.0924188881328627	0.0	0	2	0.5462094440664313	0.0
26696028746	2	0.4704321125719375	0.0	0	2	0.23521605628596876	0.0
26696028747	2	0.23658441169757516	1.0	1	1	0.23658441169757516	1.0
26696028748	2	0.2366468346431995	1.0	1	1	0.2366468346431995	1.0
26696028749	23	3.6800781950085417	8.0	8	15	0.24533854633390278	0.5333333333333333
26979356515	6	1.0926733609608177	2.0	2	4	0.2731683402402044	0.5
26979356516	6	0.6043321928295294	2.0	3	3	0.3021660964147647	1.0
26979356517	2	0.2730369540807856	1.0	1	1	0.2730369540807856	1.0
27452990939	15	5.929579375404895	3.0	3	12	0.5390526704913541	0.25
27452990940	2	1.0305858965825525	0.0	0	2	0.5152929482912763	0.0
27452990941	3	1.0900625734475482	0.0	0	3	0.5450312867237741	0.0
27452990942	36	11.056739797695114	3.5	5	31	0.5025790817134143	0.16129032258064516
27452990943	14	5.035723129926897	0.0	0	14	0.5595247922140997	0.0
27452990944	5	2.1997690148995894	0.5	1	4	0.7332563382998631	0.25
27452990945	4	1.5078317059877915	0.0	0	4	0.5026105686625971	0.0
27452990946	6	2.084524439340772	1.0	1	5	0.4169048878681544	0.2
27452990947	23	8.132019378587321	2.0	2	21	0.47835408109337185	0.09523809523809523
27452990948	18	6.883383062378805	0.0	0	18	0.4916702187413432	0.0
27452990949	2	0.6747705274944288	0.0	0	2	0.6747705274944288	0.0
27452990950	1	0.418205049410253	0.0	0	1	0.418205049410253	0.0
27452990951	2	0.8375869093897949	0.0	0	2	0.4187934546948974	0.0
27452990952	3	1.0942284128306157	0.0	0	3	0.5471142064153078	0.0
27452990953	16	6.726683220082599	0.0	0	16	0.4204177012551624	0.0
27452990954	22	7.568930234681655	4.0	4	18	0.42049612414898085	0.2222222222222222
27452990955	2	1.004089746687754	0.0	0	2	0.502044873343877	0.0
27452990956	22	7.159670554992175	5.0	5	17	0.4211570914701279	0.29411764705882354
27452990957	27	9.327937699072045	5.0	5	22	0.4239971681396384	0.22727272727272727
27452990958	6	4.1862127645361715	0.0	0	6	0.8372425529072343	0.0
27452990959	2	0.7611709884680173	0.0	0	2	0.7611709884680173	0.0
27452990960	3	1.256238885542344	0.0	0	3	0.628119442771172	0.0
27452990961	2	0.8715416248760085	0.0	0	2	0.43577081243800425	0.0
27452990962	1	0.424104017771752	0.0	0	1	0.424104017771752	0.0
27452990963	6	1.7146461974173801	2.0	2	4	0.42866154935434503	0.5
27452990964	7	3.0791513186409563	0.5	1	6	0.7697878296602391	0.16666666666666666
27452990965	2	0.7183282084678577	0.0	0	2	0.7183282084678577	0.0
27452990966	1	0.4255120356590572	0.0	0	1	0.4255120356590572	0.0
27452990967	2	0.42552324754734894	1.0	1	1	0.42552324754734894	1.0
27452990968	5	2.1281587517188614	0.0	0	5	0.42563175034377226	0.0
27452990969	1	0.42561674728844856	0.0	0	1	0.42561674728844856	0.0
27452990970	23	16.67619056533405	1.0	1	22	0.7580086620606387	0.045454545454545456
27452990971	3	1.5553627050912782	0.0	0	3	0.7776813525456391	0.0
27792926016	2	0.5673476412964754	1.0	1	1	0.5673476412964754	1.0
27792926017	22	17.11283119135202	0.0	0	22	0.7778559632432736	0.0
27792926018	17	12.016365686948523	1.0	1	16	0.7510228554342827	0.0625
27792926019	8	5.978515597840947	0.0	0	8	0.7473144497301184	0.0
27792926020	7	5.142114152039333	0.0	0	7	0.7345877360056191	0.0
27873028081	4	0.5450854775171843	2.0	2	2	0.27254273875859214	1.0
27873028082	42	8.231045065494767	13.0	13	29	0.2838291401894747	0.4482758620689655
27873028083	2	0.2726530226627952	1.0	1	1	0.2726530226627952	1.0
27873028084	9	1.516365266081846	4.0	4	5	0.3032730532163692	0.8
27873028085	6	1.0918939832125374	2.0	2	4	0.27297349580313435	0.5
27873028086	35	6.441994151165276	12.0	12	23	0.2800867022245772	0.5217391304347826
27873028087	5	0.5729257745722925	1.5	2	3	0.2864628872861463	0.6666666666666666
27873028088	2	0.27284066186234446	1.0	1	1	0.27284066186234446	1.0
27873028089	14	2.3602975992047575	6.0	6	8	0.2950371999005947	0.75
28181518555	1	0.20820766114050762	0.0	0	1	0.20820766114050762	0.0
28181518556	1	0.2082079304951813	0.0	0	1	0.2082079304951813	0.0
28181518557	11	2.0303170806182242	2.0	3	8	0.3383861801030374	0.375
28181518558	41	5.748453710574431	14.0	14	27	0.21290569298423817	0.5185185185185185
28181518559	3	0.4263877413725109	0.5	1	2	0.4263877413725109	0.5
28181518560	3	0.24713729011084182	0.5	1	2	0.24713729011084182	0.5
28181518561	3	0.6620368863044158	0.5	1	2	0.6620368863044158	0.5
28181518562	1	0.20840179852155932	0.0	0	1	0.20840179852155932	0.0
28181518563	2	0.20843503015442408	1.0	1	1	0.20843503015442408	1.0
28181518564	2	0.20844667974406053	1.0	1	1	0.20844667974406053	1.0
28181518565	9	1.042478915505358	4.0	4	5	0.20849578310107159	0.8
28181518566	2	0.4169768257676263	0.0	0	2	0.20848841288381315	0.0
28181518567	2	0.20851785671657933	1.0	1	1	0.20851785671657933	1.0
28181518568	3	0.22335818814807787	0.5	1	2	0.22335818814807787	0.5
28181518569	2	0.7912284448501524	0.0	0	2	0.3956142224250762	0.0
28181518570	7	2.738147897735592	2.0	2	5	0.5476295795471184	0.4
28181518571	7	3.9805224921758358	1.0	1	6	0.6634204153626393	0.16666666666666666
28181518572	9	2.851897891548852	4.0	4	5	0.5703795783097705	0.8
28181518573	5	2.666560496032793	0.0	0	5	0.8888534986775977	0.0
28181518574	1	0.20868004189946626	0.0	0	1	0.20868004189946626	0.0
28181518575	7	3.0698455523668073	0.5	1	6	0.6139691104733614	0.16666666666666666
28181518576	5	0.626511799401339	2.0	2	3	0.208837266467113	0.6666666666666666
28181518577	33	5.001018665706506	10.0	10	23	0.21743559416115243	0.43478260869565216
28181518578	4	1.1328709097188117	1.0	1	3	0.37762363657293724	0.3333333333333333
28181518579	6	0.8362816839798312	2.0	2	4	0.2090704209949578	0.5
28181518580	2	0.20892279779911643	1.0	1	1	0.20892279779911643	1.0
28181518581	4	1.1562745312664717	1.0	1	3	0.5781372656332359	0.3333333333333333
28181518582	9	1.044852839252464	4.0	4	5	0.2089705678504928	0.8
28181518583	2	0.20898973243552482	1.0	1	1	0.20898973243552482	1.0
28181518584	4	0.6278429165293098	1.0	1	3	0.2092809721764366	0.3333333333333333
28181518585	39	5.100739456018709	15.0	15	24	0.2125308106674462	0.625
28181518586	2	0.20914622750093037	1.0	1	1	0.20914622750093037	1.0
28181518587	2	0.20915410612513538	1.0	1	1	0.20915410612513538	1.0
28181518588	10	1.2083681291873498	5.0	5	5	0.24167362583746996	1.0
28181518589	1	0.2092392895406853	0.0	0	1	0.2092392895406853	0.0
28181518590	3	0.41866187493680684	1.0	1	2	0.20933093746840342	0.5
28181518591	2	0.20934204834869255	1.0	1	1	0.20934204834869255	1.0
28181518592	20	3.3237087296873327	8.0	9	11	0.33237087296873324	0.8181818181818182
28181518593	2	0.2093991515395118	1.0	1	1	0.2093991515395118	1.0
28181518594	40	5.857108625049776	13.0	13	27	0.21692994907591762	0.48148148148148145
28181518595	5	0.6289104364397547	2.0	2	3	0.20963681214658492	0.6666666666666666
28181518596	4	0.41906466118195457	2.0	2	2	0.20953233059097728	1.0
28181518597	9	1.0479304857538818	4.0	4	5	0.20958609715077636	0.8
28181518598	2	0.20960524153420787	1.0	1	1	0.20960524153420787	1.0
28181518599	6	0.8394123596826288	2.0	2	4	0.2098530899206572	0.5
28181518600	38	5.657198501970512	12.0	12	26	0.21758455776809663	0.46153846153846156
28181518601	3	0.4194478518745924	1.0	1	2	0.2097239259372962	0.5
28181518602	2	0.20973345435887747	1.0	1	1	0.20973345435887747	1.0
28181518603	9	1.0488772337625174	4.0	4	5	0.20977544675250348	0.8
28181518604	2	0.20979345311243872	1.0	1	1	0.20979345311243872	1.0
28181518605	4	0.4198055212118994	2.0	2	2	0.2099027606059497	1.0
28181518606	9	1.0497688987403864	4.0	4	5	0.20995377974807727	0.8
28181518607	2	0.209974661469154	1.0	1	1	0.209974661469154	1.0
28181518608	30	4.36442492086949	10.0	10	20	0.21822124604347448	0.5
28181518609	2	0.21007590515712182	1.0	1	1	0.21007590515712182	1.0
28181518610	2	0.2100871507147478	1.0	1	1	0.2100871507147478	1.0
28181518611	2	0.42023480522306994	0.0	0	2	0.21011740261153497	0.0
28181518612	1	0.210142806124196	0.0	0	1	0.210142806124196	0.0
28181518613	2	0.2101541190204904	1.0	1	1	0.2101541190204904	1.0
28181518614	4	0.42054190322039436	2.0	2	2	0.21027095161019718	1.0
28181518615	2	0.21028233184516	1.0	1	1	0.21028233184516	1.0
28181518616	10	1.4238204883083743	4.0	4	6	0.23730341471806238	0.6666666666666666
28181518617	2	0.210343576364087	1.0	1	1	0.210343576364087	1.0
28181518618	42	6.055532213354356	14.0	14	28	0.21626900761979842	0.5
28181518619	9	1.513925586125029	3.0	3	6	0.25232093102083814	0.5
28181518620	3	0.4208853977679992	1.0	1	2	0.2104426988839996	0.5
28181518621	2	0.21045559423900184	1.0	1	1	0.21045559423900184	1.0
28181518622	9	1.2141868298560934	4.0	4	5	0.2428373659712187	0.8
28181518623	3	0.4210188293394713	1.0	1	2	0.21050941466973566	0.5
28181518624	4	0.4212988908614256	2.0	2	2	0.2106494454307128	1.0
28181518625	5	1.4552812825403594	1.0	1	4	0.36382032063508984	0.25
28181518626	2	0.2106182171232335	1.0	1	1	0.2106182171232335	1.0
28181518627	9	1.2149486322119167	4.0	4	5	0.24298972644238334	0.8
28181518628	5	1.0113541748981176	2.0	2	3	0.3371180582993725	0.6666666666666666
28181518629	31	4.614557670636945	10.0	10	21	0.21974084145890213	0.47619047619047616
28181518630	13	1.5126344008274306	5.0	6	7	0.25210573347123844	0.8571428571428571
28181518631	3	0.6325615053720938	0.0	0	3	0.21085383512403125	0.0
28181518632	3	0.42174841014245595	1.0	1	2	0.21087420507122798	0.5
28181518633	22	3.2399484495557793	7.0	7	15	0.2159965633037186	0.4666666666666667
28181518634	1	0.21098194694069825	0.0	0	1	0.21098194694069825	0.0
28181518635	3	0.2833857289900745	0.5	1	2	0.2833857289900745	0.5
28181518636	1	0.2110074009573606	0.0	0	1	0.2110074009573606	0.0
28181518637	3	0.42204436359015707	1.0	1	2	0.21102218179507853	0.5
28181518638	3	0.42207671982033235	1.0	1	2	0.21103835991016617	0.5
28181518639	1	0.21103692896346227	0.0	0	1	0.21103692896346227	0.0
28181518640	13	2.3355677762519207	3.0	3	10	0.23355677762519206	0.3
28181518641	9	1.221592096891455	4.0	4	5	0.24431841937829102	0.8
28181518642	2	0.4222143263892464	0.0	0	2	0.2111071631946232	0.0
28181518643	4	0.42228826424717036	2.0	2	2	0.21114413212358518	1.0
28181518644	5	1.6686320018200296	0.5	1	4	0.8343160009100148	0.25
28181518645	3	0.45157849751067464	0.5	1	2	0.45157849751067464	0.5
28181518646	3	0.42253108748548895	1.0	1	2	0.21126554374274448	0.5
28181518647	2	0.575249126979416	0.0	0	2	0.287624563489708	0.0
28181518648	2	0.5031753717439608	0.0	0	2	0.2515876858719804	0.0
28181518649	1	0.21128123365248608	0.0	0	1	0.21128123365248608	0.0
28181518650	20	2.7473757195010458	7.0	7	13	0.21133659380777275	0.5384615384615384
28181518651	17	2.163721346260248	2.5	5	12	0.360620224376708	0.4166666666666667
28181518652	2	0.4226902760976312	0.0	0	2	0.2113451380488156	0.0
28181518653	3	0.42275047686719774	1.0	1	2	0.21137523843359887	0.5
28181518654	31	4.919811160825379	9.0	9	22	0.22362778003751724	0.4090909090909091
28181518655	2	0.21149203735397146	1.0	1	1	0.21149203735397146	1.0
28181518656	2	0.2115032492422632	1.0	1	1	0.2115032492422632	1.0
28181518657	2	0.2115174913706338	1.0	1	1	0.2115174913706338	1.0
28181518658	1	0.21152870325892556	0.0	0	1	0.21152870325892556	0.0
28181518659	1	0.21153829901917526	0.0	0	1	0.21153829901917526	0.0
28181518660	2	0.21154951090746701	1.0	1	1	0.21154951090746701	1.0
28181518661	2	0.2115695104919874	1.0	1	1	0.2115695104919874	1.0
28181518662	9	1.2519960107226056	1.0	2	7	0.2503992021445211	0.2857142857142857
28181518663	2	0.4232856172651228	0.0	0	2	0.2116428086325614	0.0
28181518664	31	4.925922481677738	9.0	9	22	0.22390556734898806	0.4090909090909091
28181518665	3	0.7827772736169083	1.0	1	2	0.39138863680845415	0.5
28181518666	5	0.28253864221069885	0.6666666666666666	2	3	0.28253864221069885	0.6666666666666666
28181518667	1	0.2118109196182692	0.0	0	1	0.2118109196182692	0.0
28181518668	3	0.278079037886654	0.5	1	2	0.278079037886654	0.5
28181518669	2	0.21182213150656096	1.0	1	1	0.21182213150656096	1.0
28181518670	1	0.2118244210212872	0.0	0	1	0.2118244210212872	0.0
28181518671	3	0.4240084978705998	1.0	1	2	0.2120042489352999	0.5
28181518672	13	2.2439169866403788	1.5	3	10	0.3739861644400631	0.3
28181518673	2	0.4238549320372705	0.0	0	2	0.21192746601863524	0.0
28181518674	4	0.4239228430843709	2.0	2	2	0.21196142154218545	1.0
28181518675	29	4.144066872415479	10.0	10	19	0.21810878275870943	0.5263157894736842
28181518676	6	1.8549200846568272	2.0	2	4	0.4637300211642068	0.5
28181518677	2	0.43466430343854473	0.0	0	2	0.21733215171927237	0.0
28181518678	2	0.21205609970998246	1.0	1	1	0.21205609970998246	1.0
28181518679	1	0.21206731159827422	0.0	0	1	0.21206731159827422	0.0
28181518680	5	0.6365686948523661	2.0	2	3	0.2121895649507887	0.6666666666666666
28181518681	7	1.487457146092285	1.0	1	6	0.297491429218457	0.16666666666666666
28181518682	3	0.42434805310610213	1.0	1	2	0.21217402655305106	0.5
28181518683	17	2.658348747435112	5.0	5	12	0.22152906228625935	0.4166666666666667
28526998345	7	2.628211461061567	2.0	2	5	0.5256422922123134	0.4
28526998346	3	1.5769309102231783	0.0	0	3	0.5256436367410594	0.0
28526998347	4	1.0513448929360627	2.0	2	2	0.5256724464680314	1.0
28526998348	30	11.252073147167282	9.0	9	21	0.5358130070079659	0.42857142857142855
28526998349	2	1.481935307943266	0.0	0	2	0.740967653971633	0.0
28526998350	3	1.0518712119684248	1.0	1	2	0.5259356059842124	0.5
28526998351	9	3.3310045377171797	3.0	3	6	0.5551674229528633	0.5
28526998352	2	1.051719329601806	0.0	0	2	0.525859664800903	0.0
28526998353	2	0.5258910951243875	1.0	1	1	0.5258910951243875	1.0
28526998354	27	10.16188044174301	8.0	8	19	0.5348358127233164	0.42105263157894735
28526998355	2	1.0523283741883207	0.0	0	2	0.5261641870941604	0.0
28526998356	7	2.8061371923687646	2.0	2	5	0.5612274384737529	0.4
28526998357	3	1.0522252786869715	1.0	1	2	0.5261126393434857	0.5
28526998358	17	6.439536323437322	5.0	5	12	0.5366280269531102	0.4166666666666667
28526998359	2	0.5262263743544452	1.0	1	1	0.5262263743544452	1.0
28526998360	1	0.5262408858374895	0.0	0	1	0.5262408858374895	0.0
28526998361	2	1.4218634245881154	0.0	0	2	0.7109317122940577	0.0
28526998362	2	0.5262560370378837	1.0	1	1	0.5262560370378837	1.0
28526998363	14	5.429334447833188	4.0	4	10	0.5429334447833188	0.4
28526998364	8	2.8071688207689425	3.0	3	5	0.5614337641537885	0.6
28526998365	2	0.5263422978721284	1.0	1	1	0.5263422978721284	1.0
28526998366	28	10.737784571950137	8.0	8	20	0.5368892285975069	0.4
28526998367	8	6.877224368773215	0.0	0	8	0.8596530460966518	0.0
28526998368	1	0.5264234409675732	0.0	0	1	0.5264234409675732	0.0
28526998369	1	0.5264438109147699	0.0	0	1	0.5264438109147699	0.0
28526998370	1	0.5264516558696407	0.0	0	1	0.5264516558696407	0.0
28526998371	3	1.0529746570584713	1.0	1	2	0.5264873285292356	0.5
28526998372	2	0.5264953249961104	1.0	1	1	0.5264953249961104	1.0
28526998373	5	2.8082016949344855	0.0	0	5	0.5616403389868971	0.0
28526998374	5	2.107390428959776	1.0	1	4	0.526847607239944	0.25
28526998375	2	0.5268918824144293	1.0	1	1	0.5268918824144293	1.0
28526998376	24	8.474200451795328	8.0	8	16	0.529637528237208	0.5
28526998377	2	0.527026054711254	1.0	1	1	0.527026054711254	1.0
28526998378	1	0.5270277718472987	0.0	0	1	0.5270277718472987	0.0
28526998379	11	4.991296073074846	2.0	2	9	0.5545884525638718	0.2222222222222222
28526998380	8	3.3377971912166005	2.0	2	6	0.5562995318694334	0.3333333333333333
28526998381	3	1.581323007532133	0.0	0	3	0.5271076691773776	0.0
28526998382	25	9.127671118751504	8.0	8	17	0.5369218305147944	0.47058823529411764
28526998383	7	2.8113514948191143	2.0	2	5	0.5622702989638229	0.4
28526998384	3	1.5818493939031637	0.0	0	3	0.5272831313010545	0.0
28526998385	3	1.055021281207727	1.0	1	2	0.5275106406038635	0.5
28526998386	4	2.1099330024019367	0.0	0	4	0.5274832506004842	0.0
28526998387	2	1.0549480840751557	0.0	0	2	0.5274740420375779	0.0
28526998388	3	1.081745439833792	1.0	1	2	0.540872719916896	0.5
28526998389	27	13.214442548449412	2.0	2	25	0.5285777019379765	0.08
28526998390	9	3.6931732428319584	2.0	2	7	0.5275961775474226	0.2857142857142857
28526998391	4	1.0553840346144998	2.0	2	2	0.5276920173072499	1.0
28526998392	21	9.503590144272088	3.0	3	18	0.5279772302373382	0.16666666666666666
28526998393	19	8.985237343722522	2.0	2	17	0.5285433731601483	0.11764705882352941
28526998394	4	1.0579491328412471	2.0	2	2	0.5289745664206236	1.0
28526998395	1	0.5289691119884816	0.0	0	1	0.5289691119884816	0.0
28526998396	7	3.7055698203172005	0.0	0	7	0.5293671171881715	0.0
28526998397	4	2.194801003628982	0.0	0	4	0.5487002509072455	0.0
28526998398	1	0.5305648700833386	0.0	0	1	0.5305648700833386	0.0
28526998399	3	0.5496282114273923	0.5	1	2	0.5496282114273923	0.5
28526998400	1	0.5306015359882927	0.0	0	1	0.5306015359882927	0.0
28526998401	2	1.383648763929719	0.0	0	2	0.6918243819648595	0.0
28526998402	5	2.6534505663636554	0.0	0	5	0.5306901132727311	0.0
28526998403	2	1.0613695668342513	0.0	0	2	0.5306847834171257	0.0
28526998404	4	2.122979196021416	0.0	0	4	0.530744799005354	0.0
28526998405	9	8.0450195024568	0.0	0	9	0.8938910558285333	0.0
28526998406	11	3.6713581404723006	1.5	3	8	0.6118930234120501	0.375
28526998407	3	1.0623153047628606	1.0	1	2	0.5311576523814303	0.5
28526998408	2	0.7859188918533241	0.0	0	2	0.7859188918533241	0.0
28526998409	2	1.062498162916952	0.0	0	2	0.531249081458476	0.0
29305824312	13	6.217805441550254	2.0	3	10	0.6908672712833616	0.3
29305824313	2	0.08734300031544799	1.0	1	1	0.08734300031544799	1.0
29305824314	1	0.2847401452973182	0.0	0	1	0.2847401452973182	0.0
29305824315	1	0.2847607172605202	0.0	0	1	0.2847607172605202	0.0
29305824316	1	0.14466783636178332	0.0	0	1	0.14466783636178332	0.0
29305824317	2	0.0	2.0	2	0	0.0	inf
29305824318	3	1.7649727276709437	1.0	1	2	0.5883242425569812	0.5
29305824319	9	0.36336329309253074	3.5	4	5	0.09084082327313268	0.8
29305824320	1	0.0	1.0	1	0	0.0	inf
29305824321	1	0.0	1.0	1	0	0.0	inf
29305824322	13	0.43262390811611756	6.0	6	7	0.054077988514514695	0.8571428571428571
29305824323	9	0.34372737105091117	5.0	5	4	0.06874547421018223	1.25
29305824324	11	4.966843550758558	0.5	1	10	0.709549078679794	0.1
29305824325	10	2.5740010384296057	5.0	5	5	0.3677144340613722	1.0
29305824326	16	3.3224616175482145	8.0	8	8	0.4153077021935268	1.0
29305824327	1	0.1836518413068658	0.0	0	1	0.1836518413068658	0.0
29305824328	2	0.05323768189731547	1.0	1	1	0.05323768189731547	1.0
29305824329	8	2.9545655566684017	3.0	3	5	0.49242759277806697	0.6
29305824330	1	0.0	1.0	1	0	0.0	inf
29305824331	1	0.0	1.0	1	0	0.0	inf
29305824334	4	1.3613220897060825	2.0	2	2	0.3403305224265206	1.0
29305824335	11	0.9274010704895457	4.5	5	6	0.18548021409790913	0.8333333333333334
29305824336	2	0.0	2.0	2	0	0.0	inf
29305824337	13	0.0	13.0	13	0	0.0	inf
29305824338	5	0.6294401224055379	4.0	4	1	0.15736003060138448	4.0
29305824339	5	0.0	5.0	5	0	0.0	inf
29305824340	3	0.0	3.0	3	0	0.0	inf
29305824341	5	0.2056125298676455	4.0	4	1	0.0411225059735291	4.0
29305824342	4	0.0	4.0	4	0	0.0	inf
29305824343	5	0.4310120897488426	2.0	2	3	0.14367069658294754	0.6666666666666666
29305824344	14	1.155858546642314	7.0	7	7	0.14448231833028924	1.0
29305824345	9	1.5806191837698187	5.0	5	4	0.3161238367539637	1.25
29305824346	17	3.3294081399049724	7.0	8	9	0.41617601748812155	0.8888888888888888
29305824347	14	3.995612717405837	6.0	6	8	0.4994515896757296	0.75
29305824348	17	3.515662890100902	9.0	9	8	0.43945786126261277	1.125
29305824349	2	0.02703425319413398	1.0	1	1	0.02703425319413398	1.0
29305824351	2	0.42596956824162946	1.0	1	1	0.42596956824162946	1.0
29305824352	1	0.0	1.0	1	0	0.0	inf
29305824353	4	0.1266828901231244	3.0	3	1	0.042227630041041464	3.0
29305824354	3	0.04221144631439812	2.0	2	1	0.02110572315719906	2.0
29305824356	1	0.0	1.0	1	0	0.0	inf
29305824357	15	1.498409544825281	5.5	6	9	0.18730119310316012	0.6666666666666666
29305824358	2	0.5833156597386512	1.0	1	1	0.5833156597386512	1.0
29305824359	3	1.6645957893736685	1.0	1	2	0.8322978946868342	0.5
29305824360	2	0.4117581799731635	1.0	1	1	0.4117581799731635	1.0
29305824361	15	1.5986403582120867	7.0	7	8	0.19983004477651084	0.875
29305824362	1	0.9020718660491127	0.0	0	1	0.9020718660491127	0.0
29305824363	2	1.8041632939814012	0.0	0	2	0.9020816469907006	0.0
29305824365	1	0.0	1.0	1	0	0.0	inf
29305824366	4	1.086919103397751	1.0	1	3	0.36230636779925035	0.3333333333333333
29305824367	1	0.33333664415119724	0.0	0	1	0.33333664415119724	0.0
29305824369	5	0.0	5.0	5	0	0.0	inf
29305824370	9	0.0	9.0	9	0	0.0	inf
29305824371	1	0.0	1.0	1	0	0.0	inf
29305824372	11	1.114646204151247	4.5	5	6	0.2229292408302494	0.8333333333333334
29305824373	6	3.3882576580816486	2.0	2	4	0.5647096096802747	0.5
29305824374	3	1.2910057053696897	1.0	1	2	0.6455028526848449	0.5
29305824375	2	0.9998084888270167	0.0	0	2	0.9998084888270167	0.0
29305824376	4	0.446002216048239	1.0	2	2	0.446002216048239	1.0
29305824377	6	0.39947456310419405	2.0	2	4	0.09986864077604851	0.5
29305824378	4	0.04004266982063033	2.0	2	2	0.010010667455157583	1.0
29305824379	1	0.0	1.0	1	0	0.0	inf
29305824380	11	0.6195005645842308	4.5	6	5	0.12390011291684615	1.2
29305824381	2	0.0	2.0	2	0	0.0	inf
29305824382	35	12.259731708603898	16.0	16	19	0.4540641373556999	0.8421052631578947
29305824383	8	0.6381284940982876	5.0	5	3	0.1595321235245719	1.6666666666666667
29305824384	8	0.8652939432201021	7.0	7	1	0.10816174290251276	7.0
29305824385	6	0.02322621782571049	5.0	5	1	0.0038710363042850815	5.0
29305824386	4	0.0	4.0	4	0	0.0	inf
29305824387	6	0.09484452797731441	4.0	4	2	0.01896890559546288	2.0
29305824388	5	0.8264442789185154	3.0	3	2	0.2754814263061718	1.5
29305824389	6	0.0	6.0	6	0	0.0	inf
29305824390	14	1.2615994139111655	7.0	7	7	0.15769992673889568	1.0
29305824391	11	1.114225539489634	5.0	5	6	0.15917507706994774	0.8333333333333334
29305824392	4	0.6323204666084883	2.0	2	2	0.2107734888694961	1.0
29305824393	5	3.2548702271067294	1.0	1	4	0.8137175567766823	0.25
29305824394	1	0.7713946481313839	0.0	0	1	0.7713946481313839	0.0
29305824395	62	20.97009577275785	9.333333333333332	12	50	0.48767664587808957	0.24
29305824396	3	1.211750112800687	1.0	1	2	0.6058750564003434	0.5
29305824397	2	0.5720628632058384	1.0	1	1	0.5720628632058384	1.0
29305824398	2	1.6748195500450378	0.0	0	2	0.8374097750225189	0.0
29305824399	3	1.5454087031255952	1.0	1	2	0.7727043515627976	0.5
29305824400	2	1.8155548755098252	0.0	0	2	0.9077774377549126	0.0
29305824401	3	1.2205011767937346	1.0	1	2	0.6102505883968673	0.5
29305824402	4	1.2860130818157751	2.0	2	2	0.3215032704539438	1.0
29305824403	5	0.8802666288043781	3.0	3	2	0.22006665720109453	1.5
29305824404	10	0.8744592073625946	4.5	5	5	0.17489184147251893	1.0
29305824405	2	0.08120309419834612	1.0	1	1	0.04060154709917306	1.0
29305824406	8	0.0	8.0	8	0	0.0	inf
29305824407	13	0.35416328219713417	7.0	7	6	0.04427041027464177	1.1666666666666667
29305824408	10	0.2674889548590859	8.0	8	2	0.03343611935738574	4.0
29305824409	10	0.9744164574089489	5.0	5	5	0.1948832914817898	1.0
29305824410	8	0.20333907541382054	5.0	5	3	0.03388984590230342	1.6666666666666667
29305824411	13	2.8295211510252463	7.0	7	6	0.40421730728932087	1.1666666666666667
29305824412	17	6.708776386699306	5.0	6	11	0.6708776386699306	0.5454545454545454
29305824413	6	3.1362351832623547	1.0	1	5	0.627247036652471	0.2
29305824414	3	0.5567408582791394	0.5	1	2	0.5567408582791394	0.5
29305824415	3	1.036282074544108	1.0	1	2	0.518141037272054	0.5
29305824416	2	1.7526412666780626	0.0	0	2	0.8763206333390313	0.0
29305824417	2	0.876316407837588	1.0	1	1	0.438158203918794	1.0
29305824419	2	0.0	2.0	2	0	0.0	inf
29305824420	9	0.22001058092496867	5.0	5	4	0.044002116184993736	1.25
29305824421	2	0.0	2.0	2	0	0.0	inf
29305824422	6	0.0	6.0	6	0	0.0	inf
29305824423	6	0.36275232935396595	5.0	5	1	0.09068808233849149	5.0
29305824424	6	2.2778227132453175	2.0	2	4	0.5694556783113294	0.5
29305824425	7	1.4612899119233784	4.0	4	3	0.3653224779808446	1.3333333333333333
29305824426	7	1.2131779619258414	3.0	3	4	0.20219632698764023	0.75
29305824427	2	0.579428265749496	1.0	1	1	0.579428265749496	1.0
29305824428	9	1.8459581496236257	3.0	4	5	0.4614895374059064	0.8
29305824429	2	0.3849225758508653	1.0	1	1	0.3849225758508653	1.0
29305824430	5	1.275060817760116	2.0	2	3	0.637530408880058	0.6666666666666666
29305824431	1	0.0	1.0	1	0	0.0	inf
29305824432	2	0.24337652648764838	1.0	1	1	0.24337652648764838	1.0
29305824433	4	0.558095880634399	2.0	2	2	0.13952397015859974	1.0
29305824434	3	0.0	3.0	3	0	0.0	inf
29305824435	6	0.12716355353829856	5.0	5	1	0.025432710707659713	5.0
29305824436	1	0.0	1.0	1	0	0.0	inf
29305824437	15	3.531903966843517	0.0	0	15	0.23546026445623447	0.0
29305824438	6	3.2862454675604886	1.0	1	5	0.6572490935120977	0.2
29305824439	10	1.215317143074839	5.0	5	5	0.20255285717913984	1.0
29305824440	2	0.004864713753253005	1.0	1	1	0.004864713753253005	1.0
29305824441	12	4.121609594844443	5.0	5	7	0.5888013706920633	0.7142857142857143
29305824442	2	1.335161252710676	0.0	0	2	0.667580626355338	0.0
29305824443	4	0.8237137295834629	2.0	2	2	0.41185686479173145	1.0
29305824444	2	1.2202102400768307	0.0	0	2	0.6101051200384153	0.0
29305824445	3	1.0288410506758159	0.0	0	3	0.3429470168919386	0.0
29305824446	2	0.0	2.0	2	0	0.0	inf
29305824447	7	0.0	7.0	7	0	0.0	inf
29305824448	1	0.0	1.0	1	0	0.0	inf
29305824449	5	0.12859160467945835	4.0	4	1	0.03214790116986459	4.0
29305824450	1	0.0	1.0	1	0	0.0	inf
29305824451	8	0.0	8.0	8	0	0.0	inf
29305824452	8	0.4461992489920328	4.0	4	4	0.1115498122480082	1.0
29305824453	6	0.4003224242782566	3.0	3	3	0.08006448485565132	1.0
29305824454	4	0.4119169982226295	2.0	2	2	0.10297924955565738	1.0
29305824455	14	1.065849406428156	8.0	8	6	0.1332311758035195	1.3333333333333333
29305824456	7	0.3802087680535391	5.0	5	2	0.07604175361070782	2.5
29305824457	10	1.0333462769477144	5.0	5	5	0.17222437949128575	1.0
29305824458	10	1.3355264303095118	5.0	5	5	0.26710528606190237	1.0
29305824459	6	3.7728437089370903	1.0	1	5	0.6288072848228484	0.2
29305824460	1	0.958859945569481	0.0	0	1	0.958859945569481	0.0
29305824462	2	0.6046408059468933	1.0	1	1	0.6046408059468933	1.0
29305824464	4	0.4650260632632649	2.0	2	2	0.23251303163163245	1.0
29305824465	1	0.9588972848611192	0.0	0	1	0.9588972848611192	0.0
29305824466	4	0.0	4.0	4	0	0.0	inf
29305824468	1	0.0	1.0	1	0	0.0	inf
29305824469	9	0.0	9.0	9	0	0.0	inf
29305824470	8	0.024961030270852624	7.0	7	1	0.003120128783856578	7.0
29305824471	6	0.0	6.0	6	0	0.0	inf
29305824472	4	2.2712149717293753	1.0	1	3	0.5678037429323438	0.3333333333333333
29305824473	11	2.234961684466016	2.5	4	7	0.558740421116504	0.5714285714285714
29305824474	12	0.9003672549967565	5.0	5	7	0.1286238935709652	0.7142857142857143
29305824475	11	2.7240722978919933	5.0	5	6	0.3891531854131419	0.8333333333333334
29305824476	6	0.518885314739421	4.0	4	2	0.12972132868485525	2.0
29305824477	14	1.0549654237822736	6.0	6	8	0.1318706779727842	0.75
29305824478	1	0.9033155102468073	0.0	0	1	0.9033155102468073	0.0
29305824479	14	1.6351310816202909	3.0	5	9	0.2335901545171844	0.5555555555555556
29305824480	4	1.631018372446606	1.0	1	3	0.5436727908155353	0.3333333333333333
29305824481	3	1.386549915781211	0.0	0	3	0.46218330526040363	0.0
29305824484	4	0.0	4.0	4	0	0.0	inf
29305824486	1	0.0	1.0	1	0	0.0	inf
29305824487	5	0.0	5.0	5	0	0.0	inf
29305824488	5	0.0	5.0	5	0	0.0	inf
29305824489	6	0.9172353557503536	4.0	4	2	0.18344707115007072	2.0
29305824491	2	0.0	2.0	2	0	0.0	inf
29305824492	9	0.0	9.0	9	0	0.0	inf
29305824493	12	4.198879841452452	5.0	5	7	0.3817163492229502	0.7142857142857143
29305824495	1	0.0	1.0	1	0	0.0	inf
29305824496	10	0.0	10.0	10	0	0.0	inf
29305824497	14	1.4472948491272084	7.0	7	7	0.18091185614090105	1.0
29305824498	11	1.6305645434907965	5.0	5	6	0.2717607572484661	0.8333333333333334
29305824499	10	1.464931385095468	5.0	5	5	0.24415523084924465	1.0
29305824500	6	1.3568946395962076	2.0	2	4	0.3392236598990519	0.5
29305824501	8	1.6488919405277	4.0	4	4	0.412222985131925	1.0
29305824502	5	3.4192609534003955	0.0	0	5	0.6838521906800791	0.0
29305824503	11	3.2576534689498207	5.0	5	6	0.46537906699283155	0.8333333333333334
29305824504	7	2.721161987981597	2.0	2	5	0.5442323975963194	0.4
29305824505	3	0.2202660301636158	2.0	2	1	0.2202660301636158	2.0
29305824506	4	2.0679597666270704	0.0	0	4	0.6893199222090235	0.0
29305824507	1	0.24560388762294064	0.0	0	1	0.24560388762294064	0.0
29305824508	5	0.1296430643174854	4.0	4	1	0.03241076607937135	4.0
29305824510	4	1.9492739830960413	2.0	2	2	0.4873184957740103	1.0
29305824511	7	0.0	7.0	7	0	0.0	inf
29305824512	3	0.0	3.0	3	0	0.0	inf
29305824513	5	0.1298418143973238	4.0	4	1	0.03246045359933095	4.0
29305824515	1	0.0	1.0	1	0	0.0	inf
29305824516	5	0.17142408186334984	3.0	3	2	0.04285602046583746	1.5
29305824517	4	0.0	4.0	4	0	0.0	inf
29305824518	3	0.0	3.0	3	0	0.0	inf
29305824519	16	3.351673939972358	8.0	8	8	0.41895924249654476	1.0
29305824520	8	0.37145080184697843	4.0	4	4	0.07429016036939569	1.0
29305824521	14	0.2312457010573215	8.0	8	6	0.02890571263216519	1.3333333333333333
29305824522	7	0.7353749250394361	4.0	4	3	0.18384373125985903	1.3333333333333333
29305824523	2	0.1588839720063728	1.0	1	1	0.1588839720063728	1.0
29305824524	4	3.424034759951283	0.0	0	4	0.8560086899878208	0.0
29305824525	3	1.3635605953909982	1.0	1	2	0.45452019846366604	0.5
29305824526	5	1.416481852885413	0.5	1	4	0.7082409264427065	0.25
29305824530	8	0.0	8.0	8	0	0.0	inf
29305824531	10	1.1184389199726052	7.0	7	3	0.15977698856751504	2.3333333333333335
29305824533	1	0.0	1.0	1	0	0.0	inf
29305824534	10	0.0	10.0	10	0	0.0	inf
29305824535	4	0.0	4.0	4	0	0.0	inf
29305824537	1	0.0	1.0	1	0	0.0	inf
29305824538	9	0.0	9.0	9	0	0.0	inf
29305824539	9	1.553305441432412	2.5	3	6	0.31066108828648237	0.5
29305824540	10	0.7781523191925609	5.0	5	5	0.12969205319876015	1.0
29305824541	6	1.3680486166331156	2.0	3	3	0.3420121541582789	1.0
29305824542	8	0.9584462167907152	1.6666666666666665	3	5	0.3194820722635717	0.6
29305824543	2	0.5413427943264613	1.0	1	1	0.5413427943264613	1.0
29305824544	4	0.09442504174239882	1.0	2	2	0.09442504174239882	1.0
29305824545	2	0.541354006214753	1.0	1	1	0.2706770031073765	1.0
29305824546	1	0.8797651914099966	0.0	0	1	0.8797651914099966	0.0
29305824547	1	0.0	1.0	1	0	0.0	inf
29305824549	6	0.1304807573526166	5.0	5	1	0.02609615147052332	5.0
29305824551	1	0.0	1.0	1	0	0.0	inf
29305824553	36	4.558251264611775	10.0	10	26	0.17531735633122214	0.38461538461538464
29305824554	5	0.05182929364733399	4.0	4	1	0.010365858729466798	4.0
29305824555	8	2.774789527099723	3.0	3	5	0.5549579054199446	0.6
29305824556	14	0.4508258868830906	7.0	7	7	0.056353235860386326	1.0
29305824557	9	2.8386125109791487	4.0	4	5	0.5677225021958298	0.8
29305824558	6	2.6207780464628057	2.0	2	4	0.6551945116157014	0.5
29305824559	1	0.3568300954825282	0.0	0	1	0.3568300954825282	0.0
29305824560	2	0.03434942109115107	1.0	1	1	0.03434942109115107	1.0
29305824562	3	0.06580856552575995	2.0	2	1	0.06580856552575995	2.0
29305824563	2	0.3568444722882356	1.0	1	1	0.3568444722882356	1.0
29305824564	1	0.30090879930204817	0.0	0	1	0.30090879930204817	0.0
29305824566	4	0.6785304157149328	2.0	2	2	0.3392652078574664	1.0
29305824567	12	0.4433391737282764	8.0	8	4	0.049259908192030716	2.0
29305824568	6	1.286210316775574	4.0	4	2	0.21436838612926234	2.0
29305824569	1	0.9827241299397922	0.0	0	1	0.9827241299397922	0.0
29305824572	1	0.0	1.0	1	0	0.0	inf
29305824573	3	1.0604038629904557	0.0	0	3	0.5302019314952279	0.0
29305824574	1	0.0	1.0	1	0	0.0	inf
29305824576	1	0.9840992865569089	0.0	0	1	0.9840992865569089	0.0
29305824577	7	1.2552330815215051	3.0	3	4	0.3138082703803763	0.75
29305824578	1	0.44643836860358826	0.0	0	1	0.44643836860358826	0.0
29305824579	5	2.5206366924969945	0.0	0	5	0.504127338499399	0.0
29305824580	14	0.12503935524302406	9.0	9	5	0.013893261693669341	1.8
29305824581	1	0.0	1.0	1	0	0.0	inf
29305824582	1	0.0	1.0	1	0	0.0	inf
29305824583	5	0.0	5.0	5	0	0.0	inf
29305824584	4	0.0	4.0	4	0	0.0	inf
29305824585	5	0.0	5.0	5	0	0.0	inf
29305824586	4	0.0	4.0	4	0	0.0	inf
29305824587	4	0.0	4.0	4	0	0.0	inf
29305824588	5	0.0	5.0	5	0	0.0	inf
29305824589	4	0.0	4.0	4	0	0.0	inf
29305824590	4	0.0	4.0	4	0	0.0	inf
29305824591	4	0.0	4.0	4	0	0.0	inf
29305824592	13	3.1873864438573785	4.0	4	9	0.26561553698811485	0.4444444444444444
29305824593	4	0.0	4.0	4	0	0.0	inf
29305824594	5	0.0	5.0	5	0	0.0	inf
29305824595	3	0.0	3.0	3	0	0.0	inf
29305824596	17	2.1916427527414664	10.0	10	7	0.1461095168494311	1.4285714285714286
29305824598	4	2.1875647229820174	0.0	0	4	0.5468911807455044	0.0
29305824599	5	2.413433397696755	1.0	1	4	0.6033583494241888	0.25
29305824600	8	3.92414531321016	0.0	0	8	0.6540242188683599	0.0
29305824601	1	0.24212210810300674	0.0	0	1	0.24212210810300674	0.0
29305824602	2	0.8922417335639863	0.0	0	2	0.44612086678199314	0.0
29305824604	2	1.0613170090035502	0.0	0	2	0.5306585045017751	0.0
29305824606	3	0.3653137239539502	0.5	1	2	0.3653137239539502	0.5
29305824608	1	0.703063946449328	0.0	0	1	0.703063946449328	0.0
29305824611	1	0.6982897021970957	0.0	0	1	0.6982897021970957	0.0
29305824613	2	0.9259970592530115	0.0	0	2	0.46299852962650573	0.0
29305824614	1	0.44763410133870285	0.0	0	1	0.44763410133870285	0.0
29305824617	3	1.3367013217267507	0.0	0	3	0.44556710724225024	0.0
29305824618	3	1.3847458455155999	1.0	1	2	0.6923729227577999	0.5
29305824619	4	1.929147599862993	0.0	0	4	0.48228689996574825	0.0
29305824621	4	2.2323630852517304	0.0	0	4	0.5580907713129326	0.0
29305824623	2	0.909079060546116	0.0	0	2	0.454539530273058	0.0
29305824624	2	1.3063573729798272	0.0	0	2	0.6531786864899136	0.0
29305824626	2	0.6111013114643375	1.0	1	1	0.6111013114643375	1.0
29305824628	1	0.7444974627968166	0.0	0	1	0.7444974627968166	0.0
29305824631	2	0.7843068041313754	0.0	0	2	0.3921534020656877	0.0
29305824632	1	0.4470089628104359	0.0	0	1	0.4470089628104359	0.0
29305824633	4	1.4817860854540497	0.0	0	4	0.3704465213635124	0.0
29305824634	2	0.32869195949700303	0.0	0	2	0.16434597974850151	0.0
29305824635	3	0.9242713711974401	0.0	0	3	0.30809045706581334	0.0
29305824636	2	0.5037723290394943	0.0	0	2	0.25188616451974716	0.0
29305824637	3	2.2229951653866316	0.0	0	3	0.7409983884622106	0.0
29305824638	3	0.3676350225316868	0.5	1	2	0.3676350225316868	0.5
29305824639	2	0.44997826139436764	1.0	1	1	0.44997826139436764	1.0
29305824640	2	1.4071064920974536	0.0	0	2	0.7035532460487268	0.0
29305824641	4	1.893962505896763	0.0	0	4	0.47349062647419077	0.0
29305824644	4	1.8091100262327884	0.0	0	4	0.4522775065581971	0.0
29305824645	1	0.05912523635451748	0.0	0	1	0.05912523635451748	0.0
29305824647	2	0.7415615641924207	0.0	0	2	0.37078078209621035	0.0
29305824649	1	0.6702923713672345	0.0	0	1	0.6702923713672345	0.0
29305824650	2	0.6231059442300475	0.0	0	2	0.6231059442300475	0.0
29305824651	2	1.4071673999230385	0.0	0	2	0.7035836999615193	0.0
29305824653	2	0.9244878313470728	0.0	0	2	0.4622439156735364	0.0
29305824654	9	3.3851706178359864	1.0	1	8	0.4231463272294983	0.125
29305824655	2	1.714318729472859	0.0	0	2	0.8571593647364295	0.0
29305824657	1	0.23470145418191143	0.0	0	1	0.23470145418191143	0.0
29305824658	1	0.6523971202349096	0.0	0	1	0.6523971202349096	0.0
29305824665	2	1.9025932020200118	0.0	0	2	0.9512966010100059	0.0
29305824666	2	1.6533604335559762	0.0	0	2	0.8266802167779881	0.0
29305824667	10	0.2746283351621954	5.0	5	5	0.054925667032439084	1.0
29305824668	7	2.922585480294904	0.0	0	7	0.41751221147070056	0.0
29305824669	4	2.7135155811746268	0.0	0	4	0.6783788952936567	0.0
29305824672	1	0.12041638730939495	0.0	0	1	0.12041638730939495	0.0
29305824674	1	0.44677024723089087	0.0	0	1	0.44677024723089087	0.0
29305824676	1	0.06379955002281602	0.0	0	1	0.06379955002281602	0.0
29305824677	3	0.6647970309842385	1.0	1	2	0.33239851549211924	0.5
29305824678	3	0.8749504429487105	0.0	0	3	0.43747522147435525	0.0
29305824679	8	2.2211719036005215	2.0	2	6	0.3701953172667536	0.3333333333333333
29305824680	12	3.3391668934015746	4.0	4	8	0.4173958616751968	0.5
29305824681	2	1.516416376131176	0.0	0	2	0.758208188065588	0.0
29305824682	1	0.435268600648936	0.0	0	1	0.435268600648936	0.0
29305824685	12	0.07557294180117538	8.0	8	4	0.009446617725146923	2.0
29305824686	4	0.4843539108968679	2.0	2	2	0.12108847772421698	1.0
29305824687	8	0.0	8.0	8	0	0.0	inf
29305824688	10	2.710836074550236	2.0	3	7	0.677709018637559	0.42857142857142855
29305824689	4	0.0	4.0	4	0	0.0	inf
29305824690	8	1.6278109980004793	2.5	3	5	0.40695274950011984	0.6
29305824691	10	0.28695716994700815	5.0	5	5	0.047826194991168025	1.0
29305824692	13	2.161983671921698	6.0	6	7	0.27024795899021226	0.8571428571428571
29305824693	6	0.3141406792996927	3.0	3	3	0.07853516982492317	1.0
29305824695	6	1.9544506095614107	1.0	2	4	0.6514835365204702	0.5
29305824696	5	1.3781529521760438	0.5	1	4	0.6890764760880219	0.25
29305824697	3	0.6543342853786506	0.5	1	2	0.6543342853786506	0.5
29305824699	3	1.794133232989739	0.0	0	3	0.8970666164948695	0.0
29305824701	2	0.0	2.0	2	0	0.0	inf
29305824702	3	1.9936491555040758	1.0	1	2	0.6645497185013586	0.5
29305824703	1	0.0	1.0	1	0	0.0	inf
29305824704	8	0.7181370676575507	5.0	5	3	0.11968951127625845	1.6666666666666667
29305824705	3	1.4356273137356035	1.0	1	2	0.7178136568678017	0.5
29305824706	2	0.0	2.0	2	0	0.0	inf
29305824707	10	0.0	10.0	10	0	0.0	inf
29305824708	12	2.4279258575672014	6.0	6	6	0.4046543095945336	1.0
29305824709	4	1.4560361490133356	1.0	1	3	0.4853453830044452	0.3333333333333333
29305824710	12	4.802649588054012	4.0	4	8	0.6003311985067515	0.5
29305824711	1	0.4879556879239243	0.0	0	1	0.4879556879239243	0.0
29305824712	6	3.7314884064529705	1.0	1	5	0.7462976812905942	0.2
29305824713	4	1.0612863362400855	0.5	1	3	0.5306431681200428	0.3333333333333333
29305824714	3	0.5735198699744184	0.5	1	2	0.5735198699744184	0.5
29305824715	1	0.7975503673879907	0.0	0	1	0.7975503673879907	0.0
29305824718	1	0.0	1.0	1	0	0.0	inf
29305824719	4	2.6344931150756903	0.0	0	4	0.6586232787689226	0.0
29305824720	3	1.423451203050765	1.0	1	2	0.474483734350255	0.5
29305824721	8	0.0	8.0	8	0	0.0	inf
29305824722	4	1.1815135692298917	2.0	2	2	0.3938378564099639	1.0
29305824723	4	0.0	4.0	4	0	0.0	inf
29305824724	2	0.0	2.0	2	0	0.0	inf
29305824725	4	0.0	4.0	4	0	0.0	inf
29305824726	5	0.38797796692237063	2.0	2	3	0.09699449173059266	0.6666666666666666
29305824727	9	7.05596385421892	0.0	0	9	0.7839959838021022	0.0
29305824728	6	2.859673824284526	2.0	2	4	0.7149184560711315	0.5
29305824729	2	0.13860200277994225	1.0	1	1	0.13860200277994225	1.0
29305824730	1	0.8084908135073423	0.0	0	1	0.8084908135073423	0.0
29305824731	1	0.8085058300303997	0.0	0	1	0.8085058300303997	0.0
29305824732	1	0.0	1.0	1	0	0.0	inf
29305824733	6	0.0	6.0	6	0	0.0	inf
29305824734	6	0.13491601874802803	5.0	5	1	0.026983203749605604	5.0
29305824735	3	0.36063520161887547	2.0	2	1	0.18031760080943773	2.0
29305824736	10	0.0	10.0	10	0	0.0	inf
29305824737	9	1.2249684913953134	3.0	3	6	0.20416141523255224	0.5
29305824738	10	4.499480835701157	1.0	2	8	0.6427829765287367	0.25
29305824739	6	3.787450779221186	1.0	1	5	0.7574901558442372	0.2
29305824740	13	2.4395031591431247	6.0	6	7	0.3049378948928906	0.8571428571428571
29305824741	3	0.976279886710771	0.0	0	3	0.976279886710771	0.0
29305824742	4	0.09412854958535037	1.0	2	2	0.09412854958535037	1.0
29305824743	2	0.9762925463804338	0.0	0	2	0.9762925463804338	0.0
29305824744	2	0.6119254357577824	0.0	0	2	0.6119254357577824	0.0
29305824745	5	0.451396110727262	0.6666666666666666	2	3	0.451396110727262	0.6666666666666666
29305824746	6	0.1350369589965084	5.0	5	1	0.02700739179930168	5.0
29305824748	2	0.0	2.0	2	0	0.0	inf
29305824749	10	0.0	10.0	10	0	0.0	inf
29305824750	13	2.966006766795451	5.5	6	7	0.32955630742171677	0.8571428571428571
29305824752	1	0.0	1.0	1	0	0.0	inf
29305824753	2	0.49836796319753224	1.0	1	1	0.24918398159876612	1.0
29305824754	4	0.0	4.0	4	0	0.0	inf
29305824755	10	9.379455585047275	0.0	0	10	0.9379455585047275	0.0
29305824756	4	0.0	4.0	4	0	0.0	inf
29305824758	4	0.0	4.0	4	0	0.0	inf
29305824759	5	0.0	5.0	5	0	0.0	inf
29305824761	7	6.573316439857124	0.0	0	7	0.9390452056938748	0.0
29305824762	4	0.0	4.0	4	0	0.0	inf
29305824764	5	0.0	5.0	5	0	0.0	inf
29305824766	5	0.0	5.0	5	0	0.0	inf
29305824768	3	0.0	3.0	3	0	0.0	inf
29305824769	4	0.0	4.0	4	0	0.0	inf
29305824770	1	0.0	1.0	1	0	0.0	inf
29305824771	5	0.0	5.0	5	0	0.0	inf
29305824772	5	0.7797768308988329	4.0	4	1	0.15595536617976657	4.0
29305824773	5	0.0	5.0	5	0	0.0	inf
29305824774	4	0.0	4.0	4	0	0.0	inf
29305824775	4	0.5621451231130989	2.0	2	2	0.28107256155654947	1.0
29305824776	2	0.42353588142630166	1.0	1	1	0.42353588142630166	1.0
29305824777	12	1.939766335493973	5.0	5	7	0.24247079193674662	0.7142857142857143
29305824778	6	1.1315502300844456	3.0	3	3	0.2828875575211114	1.0
29305824779	1	0.28447156501832943	0.0	0	1	0.28447156501832943	0.0
29305824780	12	2.1810497741511568	6.0	6	6	0.31157853916445094	1.0
29305824781	1	0.2844936521015708	0.0	0	1	0.2844936521015708	0.0
29305824782	5	0.7970437112468067	2.0	2	3	0.39852185562340336	0.6666666666666666
29305824783	1	0.0	1.0	1	0	0.0	inf
29305824784	1	0.0	1.0	1	0	0.0	inf
29305824785	8	0.4815991533105187	3.0	3	5	0.08026652555175312	0.6
29305824786	7	2.5658922843252716	2.0	2	5	0.42764871405421195	0.4
29305824787	12	2.695078085414858	6.0	6	6	0.33688476067685724	1.0
29305824788	17	1.3710244807372183	7.0	8	9	0.17137806009215228	0.8888888888888888
29305824789	1	0.0	1.0	1	0	0.0	inf
29305824790	2	0.5624054880745406	0.0	0	2	0.2812027440372703	0.0
29305824791	5	0.598723622475587	2.0	2	3	0.19957454082519566	0.6666666666666666
29305824792	2	0.28123237305137466	1.0	1	1	0.28123237305137466	1.0
29305824793	1	0.3891468988674545	0.0	0	1	0.3891468988674545	0.0
29305824794	4	0.23764550076518612	1.0	2	2	0.23764550076518612	1.0
29305824795	9	0.32970166916061033	5.0	5	4	0.06594033383212207	1.25
29305824796	5	0.6334973108471114	3.0	3	2	0.15837432771177784	1.5
29305824797	9	1.376574062417626	5.0	5	4	0.2753148124835252	1.25
29305824798	13	4.128085621924958	5.0	5	8	0.5160107027406198	0.625
29305824800	4	1.358028589103048	1.0	1	3	0.679014294551524	0.3333333333333333
29305824801	2	0.40995030507278685	1.0	1	1	0.20497515253639342	1.0
29305824803	1	0.0	1.0	1	0	0.0	inf
29305824804	2	0.3465451576309004	0.0	0	2	0.1732725788154502	0.0
29305824805	1	0.0	1.0	1	0	0.0	inf
29305824806	6	2.926415737423906	2.0	2	4	0.7316039343559765	0.5
29305824807	1	0.39771231015167124	0.0	0	1	0.39771231015167124	0.0
29305824808	3	0.614559219426317	0.5	1	2	0.614559219426317	0.5
29305824809	2	0.16592291668553552	1.0	1	1	0.16592291668553552	1.0
29305824810	2	0.41654437683904005	1.0	1	1	0.41654437683904005	1.0
29305824812	9	3.63727019543062	0.0	0	9	0.5196100279186601	0.0
29305824813	9	0.02007079516226885	8.0	8	1	0.0022300883513632058	8.0
29305824814	10	2.041022716800799	5.0	5	5	0.4082045433601598	1.0
29305824815	2	0.13154501133764326	1.0	1	1	0.13154501133764326	1.0
29305824817	3	0.4788184029981599	0.5	1	2	0.4788184029981599	0.5
29305824818	10	4.282989003225085	3.0	3	7	0.5353736254031356	0.42857142857142855
29305824819	3	0.7065359955316753	2.0	2	1	0.35326799776583767	2.0
29305824820	21	0.6190035378726307	10.0	12	9	0.06190035378726307	1.3333333333333333
29305824822	1	0.0	1.0	1	0	0.0	inf
29305824823	3	0.052006057651933627	2.0	2	1	0.052006057651933627	2.0
29305824824	18	0.08116952587213928	14.0	14	4	0.004509418104007738	3.5
30103782810	2	1.070111944139073	0.0	0	2	0.5350559720695365	0.0
30103782811	4	1.9842706297987007	0.0	0	4	0.4960676574496752	0.0
30103782812	9	1.8361116875114076	4.0	4	5	0.3672223375022815	0.8
30103782813	1	0.18393092641812794	0.0	0	1	0.18393092641812794	0.0
30103782814	1	0.18394254233843021	0.0	0	1	0.18394254233843021	0.0
30103782815	1	0.18395553870143505	0.0	0	1	0.18395553870143505	0.0
30103782816	1	0.18396715462173732	0.0	0	1	0.18396715462173732	0.0
30103782817	3	0.7382358420365476	0.0	0	3	0.24607861401218253	0.0
30103782818	1	0.18399745702252582	0.0	0	1	0.18399745702252582	0.0
30103782819	1	0.18401988079910933	0.0	0	1	0.18401988079910933	0.0
30103782820	1	0.18403425760481676	0.0	0	1	0.18403425760481676	0.0
30103782821	1	0.1840611257335159	0.0	0	1	0.1840611257335159	0.0
30103782822	1	0.1840740210885181	0.0	0	1	0.1840740210885181	0.0
30103782823	2	0.3682112395173474	0.0	0	2	0.1841056197586737	0.0
30103782824	2	0.8879675125940986	0.0	0	2	0.4439837562970493	0.0
30103782825	2	0.3682318788192178	0.0	0	2	0.1841159394096089	0.0
30103782826	1	0.18418294138468572	0.0	0	1	0.18418294138468572	0.0
30284260048	9	0.5171167656214011	4.0	4	5	0.10342335312428022	0.8
30284260049	4	0.13515032364479163	2.0	2	2	0.06757516182239581	1.0
30284260050	29	1.4162295685641817	10.0	10	19	0.07453839834548324	0.5263157894736842
30284260051	7	2.6323147428216727	2.0	2	5	0.5264629485643345	0.4
30284260052	2	0.06766334180869037	1.0	1	1	0.06766334180869037	1.0
30700161561	3	1.0851320361459158	0.0	0	3	0.5425660180729579	0.0
30700161562	133	17.824587617152872	39.666666666666664	53	80	0.2922063543795553	0.6625
30700161564	7	4.789485046724787	1.0	1	6	0.7982475077874644	0.16666666666666666
30700161567	91	21.479690640770187	20.5	29	62	0.46694979653848234	0.46774193548387094
30700161568	2	0.0269947927344405	1.0	1	1	0.0269947927344405	1.0
30700161569	2	0.4736723482882527	1.0	1	1	0.23683617414412636	1.0
31078880191	14	4.243963046289577	5.0	5	9	0.4715514495877308	0.5555555555555556
31078880192	4	1.7917036201638505	1.0	1	3	0.5972345400546168	0.3333333333333333
31078880193	6	1.0890318877887284	2.0	2	4	0.2722579719471821	0.5
31078880194	2	0.2721174445635254	1.0	1	1	0.2721174445635254	1.0
31078880195	3	1.0828589520547671	1.0	1	2	0.5414294760273836	0.5
31078880196	9	1.360868530104947	4.0	4	5	0.2721737060209894	0.8
31078880197	2	0.2721989916909807	1.0	1	1	0.2721989916909807	1.0
31078880198	44	7.788208305571563	16.0	16	28	0.2781502966275558	0.5714285714285714
31078880199	4	0.9916644492604312	1.0	1	3	0.3305548164201437	0.3333333333333333
31078880200	3	0.3528092699219009	0.5	1	2	0.3528092699219009	0.5
31078880201	9	1.3618147394042355	4.0	4	5	0.2723629478808471	0.8
31078880202	4	0.3529131061486029	1.0	2	2	0.3529131061486029	1.0
31078880203	2	0.2724685483806616	1.0	1	1	0.2724685483806616	1.0
31078880204	2	0.27247979393828753	1.0	1	1	0.27247979393828753	1.0
31078880205	2	0.2724840026050637	1.0	1	1	0.2724840026050637	1.0
31078880206	7	1.09011913792902	3.0	3	4	0.272529784482255	0.75
31078880207	2	0.5450236606195757	0.0	0	2	0.2725118303097879	0.0
31933350758	6	0.33261827523650433	5.0	5	1	0.06652365504730087	5.0
31933350759	9	0.7155431821500544	5.0	5	4	0.14310863643001087	1.25
31933350760	6	2.15399326552711	2.0	2	4	0.430798653105422	0.5
31933350761	8	1.1807584670715763	4.0	4	4	0.23615169341431524	1.0
31933350762	7	1.5669079197917	4.0	4	3	0.391726979947925	1.3333333333333333
31952706239	4	3.2437536230307944	0.0	0	4	0.8109384057576986	0.0
31952706240	2	1.617795414822527	0.0	0	2	0.8088977074112635	0.0
31952706241	5	4.044794220941606	0.0	0	5	0.8089588441883212	0.0
31952706242	1	0.8089688170451139	0.0	0	1	0.8089688170451139	0.0
31952706243	2	1.6181243978870876	0.0	0	2	0.8090621989435438	0.0
31952706244	4	3.2364402396084904	0.0	0	4	0.8091100599021226	0.0
31952706245	1	0.8091310022280008	0.0	0	1	0.8091310022280008	0.0
31952706246	35	28.590041277593663	0.0	0	35	0.8168583222169618	0.0
31952706247	1	0.8093026148244664	0.0	0	1	0.8093026148244664	0.0
31952706248	5	4.046732665520047	0.0	0	5	0.8093465331040093	0.0
31952706249	2	1.6186903120564802	0.0	0	2	0.8093451560282401	0.0
31952706250	2	1.6187521962927571	0.0	0	2	0.8093760981463786	0.0
31952706251	6	4.077381018717557	1.0	1	5	0.8154762037435115	0.2
31952706252	27	22.032357644287327	0.0	0	27	0.8160132460847158	0.0
31952706253	1	0.8095179302167359	0.0	0	1	0.8095179302167359	0.0
31952706254	2	1.619181850666604	0.0	0	2	0.809590925333302	0.0
31952706255	1	0.8096762434261887	0.0	0	1	0.8096762434261887	0.0
31952706256	1	0.8096874553144805	0.0	0	1	0.8096874553144805	0.0
31952706257	4	3.246780294160219	0.0	0	4	0.8116950735400548	0.0
31952706258	3	1.6194536968710112	1.0	1	2	0.8097268484355056	0.5
31952706259	5	4.048869119452973	0.0	0	5	0.8097738238905945	0.0
31952706260	1	0.8098005842774243	0.0	0	1	0.8098005842774243	0.0
31952706261	1	0.8099516922493563	0.0	0	1	0.8099516922493563	0.0
31952706262	4	3.2399403689155686	0.0	0	4	0.8099850922288921	0.0
31952706263	21	17.17162741097264	0.0	0	21	0.8176965433796495	0.0
31952706264	2	1.6203869434766287	0.0	0	2	0.8101934717383144	0.0
31952706265	1	0.8101896334342145	0.0	0	1	0.8101896334342145	0.0
31952706266	3	2.43087761442801	0.0	0	3	0.81029253814267	0.0
31952706267	2	1.6206379146938261	0.0	0	2	0.8103189573469131	0.0
31952706268	14	11.408023510083982	0.0	0	14	0.8148588221488559	0.0
31952706269	1	0.8104395945713855	0.0	0	1	0.8104395945713855	0.0
31952706270	2	1.6209117137196174	0.0	0	2	0.8104558568598087	0.0
31952706271	1	0.8104520185557088	0.0	0	1	0.8104520185557088	0.0
32130673036	1	0.8926115238616087	0.0	0	1	0.8926115238616087	0.0
32130673037	1	0.8926574825028045	0.0	0	1	0.8926574825028045	0.0
32130673038	1	0.8926653274576754	0.0	0	1	0.8926653274576754	0.0
32130673039	1	0.8927831027887401	0.0	0	1	0.8927831027887401	0.0
32130673040	1	0.8928197686936942	0.0	0	1	0.8928197686936942	0.0
32130673041	1	0.8928553571799536	0.0	0	1	0.8928553571799536	0.0
32130673042	2	1.78576616775335	0.0	0	2	0.892883083876675	0.0
32130673043	1	0.8928890601834972	0.0	0	1	0.8928890601834972	0.0
32130673044	1	0.8929438738595902	0.0	0	1	0.8929438738595902	0.0
32130673045	2	1.7863437988510475	0.0	0	2	0.8931718994255238	0.0
32130673046	1	0.8929883847194151	0.0	0	1	0.8929883847194151	0.0
32130673047	1	0.8930000006397173	0.0	0	1	0.8930000006397173	0.0
32130673048	1	0.8930112125280091	0.0	0	1	0.8930112125280091	0.0
32130673049	1	0.8930263300590692	0.0	0	1	0.8930263300590692	0.0
32130673050	1	0.8930417842834713	0.0	0	1	0.8930417842834713	0.0
32130673051	1	0.8930620868919996	0.0	0	1	0.8930620868919996	0.0
32130673052	1	0.8930748475696649	0.0	0	1	0.8930748475696649	0.0
32130673053	1	0.8931146447227005	0.0	0	1	0.8931146447227005	0.0
32130673054	1	0.893137876563305	0.0	0	1	0.893137876563305	0.0
32130673055	1	0.8931545428837387	0.0	0	1	0.8931545428837387	0.0
32130673056	2	1.7863676030703335	0.0	0	2	0.8931838015351667	0.0
32130673057	1	0.8932019156369715	0.0	0	1	0.8932019156369715	0.0
32130673058	1	0.8932135315572737	0.0	0	1	0.8932135315572737	0.0
32130673059	3	2.6964323670447654	0.0	0	3	0.8988107890149218	0.0
32130673060	2	1.7865600569846747	0.0	0	2	0.8932800284923373	0.0
32130673061	2	1.7866769232437156	0.0	0	2	0.8933384616218578	0.0
32130673062	1	0.8946929621024371	0.0	0	1	0.8946929621024371	0.0
32130673063	1	0.894756933837435	0.0	0	1	0.894756933837435	0.0
32130673064	10	8.949211358134411	0.0	0	10	0.8949211358134411	0.0
32130673065	1	0.8948619484908343	0.0	0	1	0.8948619484908343	0.0
32130673066	1	0.8948731603791261	0.0	0	1	0.8948731603791261	0.0
32130673067	7	6.374956284578196	0.0	0	7	0.910708040654028	0.0
32130673068	2	1.7898376993312968	0.0	0	2	0.8949188496656484	0.0
32130673069	1	0.8949306339326216	0.0	0	1	0.8949306339326216	0.0
32130673070	5	4.4748996291895216	0.0	0	5	0.8949799258379043	0.0
32130673071	2	1.78994786539283	0.0	0	2	0.894973932696415	0.0
32130673072	2	1.7900305572776485	0.0	0	2	0.8950152786388242	0.0
32130673073	16	14.433980984300767	0.0	0	16	0.902123811518798	0.0
32130673074	1	0.8951344680819258	0.0	0	1	0.8951344680819258	0.0
32130673075	12	10.928343407815401	0.0	0	12	0.9106952839846167	0.0
32130673076	5	4.476040649256546	0.0	0	5	0.8952081298513092	0.0
32130673077	1	0.8951852414379136	0.0	0	1	0.8951852414379136	0.0
32130673078	13	11.713849109599307	0.0	0	13	0.9010653161230237	0.0
32130673079	4	3.5817068042727866	0.0	0	4	0.8954267010681967	0.0
32130673080	2	1.7909343095464987	0.0	0	2	0.8954671547732493	0.0
32130673081	22	19.92562124214457	0.0	0	22	0.9057100564611168	0.0
32130673082	2	1.7911848767316854	0.0	0	2	0.8955924383658427	0.0
32130673083	1	0.8955909232458032	0.0	0	1	0.8955909232458032	0.0
32130673084	1	0.8956211583079233	0.0	0	1	0.8956211583079233	0.0
32130673085	1	0.895621427662597	0.0	0	1	0.895621427662597	0.0
32130673086	5	4.478598037205759	0.0	0	5	0.8957196074411519	0.0
32130673087	1	0.8957307519907751	0.0	0	1	0.8957307519907751	0.0
32130673088	20	18.063972105360637	0.0	0	20	0.9031986052680319	0.0
32130673089	4	3.583545486613965	0.0	0	4	0.8958863716534913	0.0
32130673090	3	2.6876535595203292	0.0	0	3	0.8958845198401097	0.0
32130673091	1	0.8959156639742535	0.0	0	1	0.8959156639742535	0.0
32130673092	16	14.55499382386568	0.0	0	16	0.909687113991605	0.0
32130673093	4	3.584143420320191	0.0	0	4	0.8960358550800478	0.0
32130673094	3	2.688150552562595	0.0	0	3	0.8960501841875317	0.0
32130673095	14	12.58487357350186	0.0	0	14	0.8989195409644185	0.0
32130673096	1	0.8961645476927298	0.0	0	1	0.8961645476927298	0.0
32130673097	2	1.79236037419694	0.0	0	2	0.89618018709847	0.0
32130673098	1	0.8961866347759712	0.0	0	1	0.8961866347759712	0.0
32130673099	1	0.896194479730842	0.0	0	1	0.896194479730842	0.0
32130673100	1	0.8962223579395674	0.0	0	1	0.8962223579395674	0.0
32130673101	10	9.225142090482498	0.0	0	10	0.9225142090482498	0.0
32130673102	5	4.481435924378271	0.0	0	5	0.8962871848756542	0.0
32130673103	2	1.7925675079409966	0.0	0	2	0.8962837539704983	0.0
32130673104	1	0.8963153189713197	0.0	0	1	0.8963153189713197	0.0
32130673105	2	1.7931628827778225	0.0	0	2	0.8965814413889113	0.0
32130673106	16	14.41831565317313	0.0	0	16	0.9011447283233206	0.0
32130673107	5	4.482747041921722	0.0	0	5	0.8965494083843444	0.0
32130673108	1	0.8965247085607683	0.0	0	1	0.8965247085607683	0.0
32130673109	1	0.8965620478524066	0.0	0	1	0.8965620478524066	0.0
32130673110	21	19.053213540984686	0.0	0	21	0.9072958829040326	0.0
32130673111	1	0.8966351103076411	0.0	0	1	0.8966351103076411	0.0
32130673112	4	3.586787439466325	0.0	0	4	0.8966968598665812	0.0
32130673113	17	15.284250357492576	0.0	0	17	0.8990735504407398	0.0
32130673114	1	0.8968477321531738	0.0	0	1	0.8968477321531738	0.0
32130673115	1	0.8968555771080446	0.0	0	1	0.8968555771080446	0.0
32130673116	4	3.5885213428394436	0.0	0	4	0.8971303357098609	0.0
32130673117	3	2.690848375304796	0.0	0	3	0.896949458434932	0.0
32130673118	2	1.7939561996304656	0.0	0	2	0.8969780998152328	0.0
32130673119	16	14.575072261966813	0.0	0	16	0.9109420163729258	0.0
32130673120	1	0.897072171935014	0.0	0	1	0.897072171935014	0.0
32130673121	1	0.8970833838233058	0.0	0	1	0.8970833838233058	0.0
32130673122	1	0.8970976259516763	0.0	0	1	0.8970976259516763	0.0
32130673123	1	0.8971088378399681	0.0	0	1	0.8971088378399681	0.0
32130673124	1	0.8971264132324255	0.0	0	1	0.8971264132324255	0.0
32130673125	1	0.8971331470992673	0.0	0	1	0.8971331470992673	0.0
32130673126	1	0.8971336858086146	0.0	0	1	0.8971336858086146	0.0
32130673127	1	0.8971339551632883	0.0	0	1	0.8971339551632883	0.0
32130673128	8	7.288193878261855	0.0	0	8	0.9110242347827319	0.0
32130673129	4	3.588872177301906	0.0	0	4	0.8972180443254765	0.0
32130673130	2	1.794501844860664	0.0	0	2	0.897250922430332	0.0
32130673131	1	0.8973757346522464	0.0	0	1	0.8973757346522464	0.0
32130673132	1	0.8973910541993118	0.0	0	1	0.8973910541993118	0.0
32130673133	2	1.7949377280613397	0.0	0	2	0.8974688640306698	0.0
32130673134	1	0.8975141156158473	0.0	0	1	0.8975141156158473	0.0
32130673135	1	0.8976431701738722	0.0	0	1	0.8976431701738722	0.0
32130673136	1	0.8976543820621639	0.0	0	1	0.8976543820621639	0.0
32130673137	1	0.8976756610813843	0.0	0	1	0.8976756610813843	0.0
32130673138	1	0.897675930436058	0.0	0	1	0.897675930436058	0.0
32130673139	2	1.7955522270799964	0.0	0	2	0.8977761135399982	0.0
32130673140	1	0.897807914226159	0.0	0	1	0.897807914226159	0.0
32130673141	12	10.814390152231518	0.0	0	12	0.9011991793526265	0.0
32130673142	1	0.8978957238497772	0.0	0	1	0.8978957238497772	0.0
32130673143	1	0.8978959932044509	0.0	0	1	0.8978959932044509	0.0
32130673144	1	0.897900673241906	0.0	0	1	0.897900673241906	0.0
32130673145	1	0.8979118851301978	0.0	0	1	0.8979118851301978	0.0
32130673146	2	1.7958793920005096	0.0	0	2	0.8979396960002548	0.0
32130673147	1	0.8979358576961549	0.0	0	1	0.8979358576961549	0.0
32130673148	1	0.8979872707694928	0.0	0	1	0.8979872707694928	0.0
32130673149	4	3.592061168291554	0.0	0	4	0.8980152920728885	0.0
32130673150	2	1.7960449777861518	0.0	0	2	0.8980224888930759	0.0
32130673151	19	17.066999315199407	0.0	0	19	0.8982631218526004	0.0
32130673152	2	1.7965947643444578	0.0	0	2	0.8982973821722289	0.0
32130673153	3	2.6948066432424618	0.0	0	3	0.8982688810808206	0.0
32130673154	1	0.8982610697952841	0.0	0	1	0.8982610697952841	0.0
32130673155	5	4.606495110859145	0.0	0	5	0.9212990221718289	0.0
32130673156	3	2.6952018875567467	0.0	0	3	0.8984006291855823	0.0
32130673157	1	0.8983558826404179	0.0	0	1	0.8983558826404179	0.0
32130673158	6	5.390469430315202	0.0	0	6	0.8984115717192003	0.0
32130673159	1	0.8988077924441772	0.0	0	1	0.8988077924441772	0.0
32130673160	1	0.9021055690526564	0.0	0	1	0.9021055690526564	0.0
32130673161	1	0.90210583840733	0.0	0	1	0.90210583840733	0.0
32130673162	1	0.9021283631919161	0.0	0	1	0.9021283631919161	0.0
32130673163	4	3.6206985531647375	0.0	0	4	0.9051746382911844	0.0
32130673164	26	23.6486445045906	0.0	0	26	0.9095632501765615	0.0
32130673165	1	0.9021803823132698	0.0	0	1	0.9021803823132698	0.0
32130673166	1	0.9022645893181276	0.0	0	1	0.9022645893181276	0.0
32130673167	1	0.9023502777736907	0.0	0	1	0.9023502777736907	0.0
32130673168	1	0.9023702773582111	0.0	0	1	0.9023702773582111	0.0
32130673169	1	0.9023814892465029	0.0	0	1	0.9023814892465029	0.0
32130673170	1	0.9024207140208569	0.0	0	1	0.9024207140208569	0.0
32130673171	2	1.8050101787447717	0.0	0	2	0.9025050893723858	0.0
32130673172	30	27.204966752037507	0.0	0	30	0.9068322250679169	0.0
32130673173	1	0.9026899676865299	0.0	0	1	0.9026899676865299	0.0
32130673174	5	4.513699025175134	0.0	0	5	0.9027398050350268	0.0
32130673175	2	1.805463233305894	0.0	0	2	0.902731616652947	0.0
32130673176	2	1.816834714241795	0.0	0	2	0.9084173571208976	0.0
32130673177	1	0.9029218147218961	0.0	0	1	0.9029218147218961	0.0
32130673178	4	3.6118815982846417	0.0	0	4	0.9029703995711604	0.0
32130673179	1	0.9029901298010071	0.0	0	1	0.9029901298010071	0.0
32130673180	36	32.75010933274552	0.0	0	36	0.909725259242931	0.0
32130673181	4	3.624067035375056	0.0	0	4	0.906016758843764	0.0
32130673182	2	1.8063564134038024	0.0	0	2	0.9031782067019012	0.0
32130673183	2	1.8064236173948844	0.0	0	2	0.9032118086974422	0.0
32130673184	1	0.9032324816686468	0.0	0	1	0.9032324816686468	0.0
32130673185	1	0.9033467553889537	0.0	0	1	0.9033467553889537	0.0
32130673186	2	1.8972355692139327	0.0	0	2	0.9486177846069663	0.0
32130673187	1	0.9033579672772455	0.0	0	1	0.9033579672772455	0.0
32130673188	3	2.710670118401917	0.0	0	3	0.9035567061339723	0.0
32130673189	33	30.092403332900457	0.0	0	33	0.9118910100878926	0.0
32130673190	2	1.806798121399296	0.0	0	2	0.903399060699648	0.0
32130673191	4	3.613799538238549	0.0	0	4	0.9034498845596373	0.0
32130673192	1	0.903471230917526	0.0	0	1	0.903471230917526	0.0
32130673193	1	0.9036103862758137	0.0	0	1	0.9036103862758137	0.0
32130673194	5	4.518333844714404	0.0	0	5	0.9036667689428809	0.0
32130673195	2	1.8073649446407123	0.0	0	2	0.9036824723203561	0.0
32130673196	2	1.8075807987423291	0.0	0	2	0.9037903993711646	0.0
32130673197	1	0.9037938168085868	0.0	0	1	0.9037938168085868	0.0
32130673198	1	0.9037974867660157	0.0	0	1	0.9037974867660157	0.0
32130673199	2	1.8076262523435118	0.0	0	2	0.9038131261717559	0.0
32130673200	26	23.627126130073325	0.0	0	26	0.9087356203874356	0.0
32130673201	1	0.9038496742340403	0.0	0	1	0.9038496742340403	0.0
32130673202	4	3.6155315897982856	0.0	0	4	0.9038828974495714	0.0
32130673203	2	1.8077798855155096	0.0	0	2	0.9038899427577548	0.0
32130673204	2	1.8078503217626758	0.0	0	2	0.9039251608813379	0.0
32130673205	1	0.9040060682914433	0.0	0	1	0.9040060682914433	0.0
32130673206	1	0.904017280179735	0.0	0	1	0.904017280179735	0.0
32130673207	3	2.722825791800891	0.0	0	3	0.9076085972669636	0.0
32130673208	2	1.8081256022391723	0.0	0	2	0.9040628011195861	0.0
32130673209	5	4.520535246793021	0.0	0	5	0.9041070493586043	0.0
32130673210	2	1.8082632088080863	0.0	0	2	0.9041316044040432	0.0
32130673211	31	28.17443620784039	0.0	0	31	0.9088527808980771	0.0
32130673212	4	3.6280799149728105	0.0	0	4	0.9070199787432026	0.0
32130673213	2	1.8085952894513941	0.0	0	2	0.9042976447256971	0.0
32130673214	2	1.8087281486441849	0.0	0	2	0.9043640743220924	0.0
32130673215	1	0.9045825546317775	0.0	0	1	0.9045825546317775	0.0
32130673216	5	4.523167448002847	0.0	0	5	0.9046334896005694	0.0
32130673217	4	3.61948120471706	0.0	0	4	0.904870301179265	0.0
32130673218	2	1.8097546593055625	0.0	0	2	0.9048773296527812	0.0
32130673219	16	14.580631069044795	0.0	0	16	0.9112894418152997	0.0
32130673220	8	7.3376934559979015	0.0	0	8	0.9172116819997377	0.0
32130673221	3	2.7155004894342767	0.0	0	3	0.9051668298114256	0.0
32130673222	2	1.8104096625332733	0.0	0	2	0.9052048312666366	0.0
32130673223	4	3.6221837411660505	0.0	0	4	0.9055459352915126	0.0
32130673224	19	17.367164291570102	0.0	0	19	0.9140612785036896	0.0
32130673225	3	2.7163470711736393	0.0	0	3	0.9054490237245464	0.0
32130673226	2	1.8445837674011958	0.0	0	2	0.9222918837005979	0.0
32130673227	20	18.27504812442112	0.0	0	20	0.9137524062210559	0.0
32130673228	1	0.9056001765889241	0.0	0	1	0.9056001765889241	0.0
32130673229	1	0.9056113884772158	0.0	0	1	0.9056113884772158	0.0
32130673230	5	4.528430773003807	0.0	0	5	0.9056861546007614	0.0
32130673231	2	1.844649220586899	0.0	0	2	0.9223246102934495	0.0
32130673232	18	16.3724547203851	0.0	0	18	0.9095808177991722	0.0
32130673233	5	4.529791283460542	0.0	0	5	0.9059582566921083	0.0
32130673234	14	12.813584276717215	0.0	0	14	0.9152560197655154	0.0
32130673235	2	1.8123391510688145	0.0	0	2	0.9061695755344072	0.0
32130673236	1	0.9061657540649745	0.0	0	1	0.9061657540649745	0.0
32130673237	1	0.9061660234196481	0.0	0	1	0.9061660234196481	0.0
32130673238	11	10.131443329948329	0.0	0	11	0.9210403027225754	0.0
32130673239	4	3.625108057519479	0.0	0	4	0.9062770143798697	0.0
32130673240	2	1.8125248037776454	0.0	0	2	0.9062624018888227	0.0
32130673241	20	18.2900645128012	0.0	0	20	0.91450322564006	0.0
32130673242	1	0.9064165569355007	0.0	0	1	0.9064165569355007	0.0
32130673243	3	2.7197212098321053	0.0	0	3	0.9065737366107017	0.0
32130673244	5	4.532556613217833	0.0	0	5	0.9065113226435667	0.0
32130673245	2	1.8129950296992146	0.0	0	2	0.9064975148496073	0.0
32130673246	2	1.8448529873975346	0.0	0	2	0.9224264936987673	0.0
32130673247	22	20.171684379486123	0.0	0	22	0.9168947445220965	0.0
32130673248	1	0.9066759454862503	0.0	0	1	0.9066759454862503	0.0
32130673249	2	1.8133831697839813	0.0	0	2	0.9066915848919906	0.0
32130673250	3	2.72044695233099	0.0	0	3	0.9068156507769967	0.0
32130673251	8	7.622598143331501	0.0	0	8	0.9528247679164377	0.0
32130673252	2	1.8449259151754323	0.0	0	2	0.9224629575877161	0.0
32130673253	13	11.82175309691378	0.0	0	13	0.9093656228395215	0.0
32130673254	2	1.8138629241271316	0.0	0	2	0.9069314620635658	0.0
32130673255	7	6.476986353515821	0.0	0	7	0.9252837647879745	0.0
32130673256	20	18.270937132383477	0.0	0	20	0.9135468566191738	0.0
32130673257	2	1.8142660133962873	0.0	0	2	0.9071330066981437	0.0
32130673258	4	3.6285908807887726	0.0	0	4	0.9071477201971931	0.0
32130673259	22	20.18690591511954	0.0	0	22	0.9175866325054336	0.0
32130673260	1	0.9072560681146792	0.0	0	1	0.9072560681146792	0.0
32130673261	1	0.9072565731546923	0.0	0	1	0.9072565731546923	0.0
32130673262	1	0.907270983629734	0.0	0	1	0.907270983629734	0.0
32130673263	2	1.8146041208504187	0.0	0	2	0.9073020604252093	0.0
32130673264	1	0.9073054610279645	0.0	0	1	0.9073054610279645	0.0
32130673265	1	0.9073060334066461	0.0	0	1	0.9073060334066461	0.0
32130673266	4	3.6294723439583763	0.0	0	4	0.9073680859895941	0.0
32130673267	2	1.8148209513627276	0.0	0	2	0.9074104756813638	0.0
32130673268	20	18.312490376883414	0.0	0	20	0.9156245188441707	0.0
32130673269	4	3.6301487945519786	0.0	0	4	0.9075371986379946	0.0
32130673270	3	2.7226501725536543	0.0	0	3	0.9075500575178848	0.0
32130673271	2	1.8448978012813673	0.0	0	2	0.9224489006406836	0.0
32130673272	17	15.621567962712692	0.0	0	17	0.9189157625125113	0.0
32130673273	1	0.9076785172510052	0.0	0	1	0.9076785172510052	0.0
32130673274	1	0.907689729139297	0.0	0	1	0.907689729139297	0.0
32130673275	2	1.8154544062165443	0.0	0	2	0.9077272031082722	0.0
32130673276	7	6.4527341637380795	0.0	0	7	0.9218191662482971	0.0
32130673277	3	2.7234193821630037	0.0	0	3	0.9078064607210012	0.0
32130673278	2	1.84495645326156	0.0	0	2	0.92247822663078	0.0
32130673279	1	0.9080626843543351	0.0	0	1	0.9080626843543351	0.0
32130673280	2	1.816157994293519	0.0	0	2	0.9080789971467595	0.0
32130673281	8	7.441868665556678	0.0	0	8	0.9302335831945847	0.0
32130673282	2	1.8191070912769254	0.0	0	2	0.9095535456384627	0.0
32130673283	1	0.9095654814174399	0.0	0	1	0.9095654814174399	0.0
32130673284	1	0.9095930902714917	0.0	0	1	0.9095930902714917	0.0
32130673285	2	1.8193118008289186	0.0	0	2	0.9096559004144593	0.0
32130673286	1	0.9096292848057669	0.0	0	1	0.9096292848057669	0.0
32130673287	1	0.9096444023368269	0.0	0	1	0.9096444023368269	0.0
32130673288	2	1.8193111611115689	0.0	0	2	0.9096555805557844	0.0
32130673289	2	1.819370823171788	0.0	0	2	0.909685411585894	0.0
32130673290	2	1.8194693059743505	0.0	0	2	0.9097346529871753	0.0
32130673291	2	1.8672104690619729	0.0	0	2	0.9336052345309864	0.0
32130673292	1	0.9097435921954079	0.0	0	1	0.9097435921954079	0.0
32130673293	1	0.9097661843186625	0.0	0	1	0.9097661843186625	0.0
32130673294	2	1.8200470044107164	0.0	0	2	0.9100235022053582	0.0
32130673295	2	1.81989034099864	0.0	0	2	0.90994517049932	0.0
32130673296	2	1.8199861639238	0.0	0	2	0.9099930819619	0.0
32130673297	2	1.8199676457899847	0.0	0	2	0.9099838228949924	0.0
32130673298	2	1.8201554870055394	0.0	0	2	0.9100777435027697	0.0
32130673299	2	1.8201446118105897	0.0	0	2	0.9100723059052949	0.0
32130673300	1	0.9100657067157898	0.0	0	1	0.9100657067157898	0.0
32130673301	1	0.9101247963973274	0.0	0	1	0.9101247963973274	0.0
32130673302	2	1.8203886471449398	0.0	0	2	0.9101943235724699	0.0
32130673303	1	0.910166378025076	0.0	0	1	0.910166378025076	0.0
32130673304	1	0.9101814955561361	0.0	0	1	0.9101814955561361	0.0
32130673305	1	0.9102198449278006	0.0	0	1	0.9102198449278006	0.0
32130673306	2	1.8205708655816812	0.0	0	2	0.9102854327908406	0.0
32130673307	1	0.910352502104586	0.0	0	1	0.910352502104586	0.0
32130673308	1	0.9104207161756943	0.0	0	1	0.9104207161756943	0.0
32130673309	1	0.910431928063986	0.0	0	1	0.910431928063986	0.0
32130673310	1	0.9104469445870434	0.0	0	1	0.9104469445870434	0.0
32130673311	2	1.8212860022402901	0.0	0	2	0.9106430011201451	0.0
32130673312	2	1.8210290378816036	0.0	0	2	0.9105145189408018	0.0
32130673313	1	0.9105491983550376	0.0	0	1	0.9105491983550376	0.0
32130673314	1	0.9105604102433293	0.0	0	1	0.9105604102433293	0.0
32130673315	1	0.9105762684997419	0.0	0	1	0.9105762684997419	0.0
32130673316	1	0.9106288936691114	0.0	0	1	0.9106288936691114	0.0
32130673317	1	0.9106552567577973	0.0	0	1	0.9106552567577973	0.0
32130673318	2	1.821479701919997	0.0	0	2	0.9107398509599985	0.0
32130673319	1	0.9106951212495014	0.0	0	1	0.9106951212495014	0.0
32130673320	1	0.9107102387805613	0.0	0	1	0.9107102387805613	0.0
32130673321	1	0.9107316861464528	0.0	0	1	0.9107316861464528	0.0
32130673322	1	0.9107571401631152	0.0	0	1	0.9107571401631152	0.0
32130673323	1	0.9107856580891905	0.0	0	1	0.9107856580891905	0.0
32130673324	6	5.465977154616013	0.0	0	6	0.9109961924360022	0.0
32130673325	3	2.734104345374374	0.0	0	3	0.9113681151247913	0.0
32130673326	22	20.05691188166226	0.0	0	22	0.91167781280283	0.0
32130673327	1	0.9116677946454782	0.0	0	1	0.9116677946454782	0.0
32130673328	1	0.9116711952482334	0.0	0	1	0.9116711952482334	0.0
32130673329	1	0.9118823019737267	0.0	0	1	0.9118823019737267	0.0
32130673330	4	3.651097618611762	0.0	0	4	0.9127744046529405	0.0
32130673331	18	16.426830089085357	0.0	0	18	0.9126016716158531	0.0
32130673332	6	5.47746890241371	0.0	0	6	0.9129114837356184	0.0
32130673333	1	0.9128759513649161	0.0	0	1	0.9128759513649161	0.0
32130673334	1	0.9129026174776099	0.0	0	1	0.9129026174776099	0.0
32130673335	1	0.9148140929193491	0.0	0	1	0.9148140929193491	0.0
32130673336	1	0.914871297118171	0.0	0	1	0.914871297118171	0.0
32130673337	3	2.7492914372788952	0.0	0	3	0.916430479092965	0.0
32130673338	2	1.8328565026107033	0.0	0	2	0.9164282513053517	0.0
32130673339	1	0.9164607590475309	0.0	0	1	0.9164607590475309	0.0
32130673340	1	0.9164630485622571	0.0	0	1	0.9164630485622571	0.0
32130673341	4	3.6660454898967254	0.0	0	4	0.9165113724741814	0.0
32130673342	2	1.8330688214322282	0.0	0	2	0.9165344107161141	0.0
32130673343	2	1.8339236184891377	0.0	0	2	0.9169618092445688	0.0
32130673344	2	1.8339406215029135	0.0	0	2	0.9169703107514567	0.0
32130673345	19	17.439212256095555	0.0	0	19	0.9178532766366082	0.0
32130673346	1	0.9173852179569199	0.0	0	1	0.9173852179569199	0.0
32130673347	2	1.8357644556677055	0.0	0	2	0.9178822278338528	0.0
32130673348	2	1.8357776877160499	0.0	0	2	0.9178888438580249	0.0
32130673349	1	0.9180532848863039	0.0	0	1	0.9180532848863039	0.0
32130673350	2	1.8688381793549946	0.0	0	2	0.9344190896774973	0.0
32130673351	9	8.269506926404931	0.0	0	9	0.9188341029338812	0.0
32130673352	1	0.920396367523274	0.0	0	1	0.920396367523274	0.0
32130673353	2	1.8408242158740338	0.0	0	2	0.9204121079370169	0.0
32130673354	2	1.840874080157998	0.0	0	2	0.920437040078999	0.0
32130673355	3	2.7663690286299443	0.0	0	3	0.9221230095433147	0.0
32130673356	1	0.9212503228468284	0.0	0	1	0.9212503228468284	0.0
32130673357	1	0.9212615347351202	0.0	0	1	0.9212615347351202	0.0
32130673358	1	0.921272443599404	0.0	0	1	0.921272443599404	0.0
32130673359	24	22.12554065796007	0.0	0	24	0.9218975274150029	0.0
32130673360	2	1.842816733403215	0.0	0	2	0.9214083667016075	0.0
32130673361	1	0.9215762083326418	0.0	0	1	0.9215762083326418	0.0
32130673362	2	1.8904530501841088	0.0	0	2	0.9452265250920544	0.0
32130673363	2	1.8432356809287835	0.0	0	2	0.9216178404643918	0.0
32130673364	1	0.9216190020564219	0.0	0	1	0.9216190020564219	0.0
32130673365	1	0.922142257179371	0.0	0	1	0.922142257179371	0.0
32130673366	2	1.870409257827876	0.0	0	2	0.935204628913938	0.0
32130673367	1	0.92229349982864	0.0	0	1	0.92229349982864	0.0
32130673368	1	0.9223047117169316	0.0	0	1	0.9223047117169316	0.0
32130673369	2	1.8449031547055066	0.0	0	2	0.9224515773527533	0.0
32130673370	18	16.61714384586691	0.0	0	18	0.9231746581037172	0.0
32130673371	6	5.54002982496963	0.0	0	6	0.923338304161605	0.0
32130673372	1	0.923013013500696	0.0	0	1	0.923013013500696	0.0
32130673373	1	0.9230132828553697	0.0	0	1	0.9230132828553697	0.0
32130673374	1	0.9230135522100433	0.0	0	1	0.9230135522100433	0.0
32130673375	1	0.9235036767081304	0.0	0	1	0.9235036767081304	0.0
32130673376	1	0.9235097035189538	0.0	0	1	0.9235097035189538	0.0
32130673377	1	0.9235148885964221	0.0	0	1	0.9235148885964221	0.0
32130673378	1	0.9235209154072456	0.0	0	1	0.9235209154072456	0.0
32130673379	1	0.9235521268800577	0.0	0	1	0.9235521268800577	0.0
32130673380	1	0.9253556584363214	0.0	0	1	0.9253556584363214	0.0
32130673381	4	3.7909291244690304	0.0	0	4	0.9477322811172576	0.0
32130673382	1	0.9256573020015039	0.0	0	1	0.9256573020015039	0.0
32130673383	5	4.6285834398659125	0.0	0	5	0.9257166879731825	0.0
32130673384	2	1.8514065549547338	0.0	0	2	0.9257032774773669	0.0
32130673385	2	1.8514830180127235	0.0	0	2	0.9257415090063618	0.0
32130673386	1	0.9257529565799929	0.0	0	1	0.9257529565799929	0.0
32130673387	21	19.71091893478173	0.0	0	21	0.9386151873705586	0.0
32130673388	2	1.8736091240124741	0.0	0	2	0.9368045620062371	0.0
32130673389	4	3.704066888576759	0.0	0	4	0.9260167221441897	0.0
32130673390	3	2.778058684774124	0.0	0	3	0.9260195615913748	0.0
32130673391	2	1.8521038468662114	0.0	0	2	0.9260519234331057	0.0
32130673392	16	14.862689687557669	0.0	0	16	0.9289181054723543	0.0
32130673393	2	1.8523583533635009	0.0	0	2	0.9261791766817504	0.0
32130673394	2	1.8523968374125022	0.0	0	2	0.9261984187062511	0.0
32130673395	3	2.7785767884889396	0.0	0	3	0.9261922628296465	0.0
32130673396	11	10.41019595653518	0.0	0	11	0.9463814505941073	0.0
32130673397	1	0.9263573884677211	0.0	0	1	0.9263573884677211	0.0
32130673398	1	0.9263652334225919	0.0	0	1	0.9263652334225919	0.0
32130673399	2	1.8528024855510576	0.0	0	2	0.9264012427755288	0.0
32130673400	9	8.338154355513893	0.0	0	9	0.9264615950570992	0.0
32130673401	3	2.7794564335144956	0.0	0	3	0.9264854778381652	0.0
32130673402	2	1.8530367904478213	0.0	0	2	0.9265183952239107	0.0
32130673403	18	16.898911696009552	0.0	0	18	0.9388284275560862	0.0
32130673404	3	2.779969621506516	0.0	0	3	0.9266565405021719	0.0
32130673405	17	15.800425997884151	0.0	0	17	0.92943682340495	0.0
32130673406	1	0.9268071097647568	0.0	0	1	0.9268071097647568	0.0
32130673407	4	3.7076176565624888	0.0	0	4	0.9269044141406222	0.0
32130673408	3	2.7807157339525976	0.0	0	3	0.9269052446508659	0.0
32130673409	2	1.853868759696137	0.0	0	2	0.9269343798480685	0.0
32130673410	4	3.7082749493049256	0.0	0	4	0.9270687373262314	0.0
32130673411	13	12.066102397805404	0.0	0	13	0.928161722908108	0.0
32130673412	2	1.8558296617204957	0.0	0	2	0.9279148308602478	0.0
32130673413	18	16.72226469234629	0.0	0	18	0.9290147051303494	0.0
32130673414	5	4.6478350937962	0.0	0	5	0.92956701875924	0.0
32130673415	2	1.8614282322821778	0.0	0	2	0.9307141161410889	0.0
32130673416	3	2.7921652940745307	0.0	0	3	0.9307217646915102	0.0
32130673417	1	0.9307429875951735	0.0	0	1	0.9307429875951735	0.0
32130673418	1	0.9307541994834653	0.0	0	1	0.9307541994834653	0.0
32130673419	4	3.7265838618773475	0.0	0	4	0.9316459654693369	0.0
32130673420	16	14.923340548783887	0.0	0	16	0.932708784298993	0.0
32130673421	7	6.522445779493403	0.0	0	7	0.9317779684990576	0.0
32130673422	1	0.9318539072774145	0.0	0	1	0.9318539072774145	0.0
32130673423	2	1.8638765652578866	0.0	0	2	0.9319382826289433	0.0
32130673424	22	20.509456318702064	0.0	0	22	0.9322480144864574	0.0
32130673425	5	4.661141820723792	0.0	0	5	0.9322283641447584	0.0
32130673426	17	15.865564476320476	0.0	0	17	0.9332684986070868	0.0
32130673427	3	2.800559732479632	0.0	0	3	0.933519910826544	0.0
32130673428	15	14.10156172849877	0.0	0	15	0.9401041152332514	0.0
32130673429	2	1.870161384189426	0.0	0	2	0.935080692094713	0.0
32130673430	1	0.9350242117865767	0.0	0	1	0.9350242117865767	0.0
32130673431	1	0.9350358613762132	0.0	0	1	0.9350358613762132	0.0
32130673432	5	4.6754106825457535	0.0	0	5	0.9350821365091507	0.0
32130673433	1	0.9350778133666381	0.0	0	1	0.9350778133666381	0.0
32130673434	1	0.9351172064876632	0.0	0	1	0.9351172064876632	0.0
32130673435	2	1.8718774428154137	0.0	0	2	0.9359387214077068	0.0
32130673436	19	17.772549674641443	0.0	0	19	0.935397351296918	0.0
32130673437	1	0.93530026665776	0.0	0	1	0.93530026665776	0.0
32130673438	1	0.9353114785460518	0.0	0	1	0.9353114785460518	0.0
32130673439	1	0.935331444461238	0.0	0	1	0.935331444461238	0.0
32130673440	1	0.9353348450639931	0.0	0	1	0.9353348450639931	0.0
32130673441	4	3.7417292038074494	0.0	0	4	0.9354323009518624	0.0
32130673442	2	1.8708199226972289	0.0	0	2	0.9354099613486144	0.0
32130673443	3	2.8816334017572767	0.0	0	3	0.9605444672524256	0.0
32130673444	1	0.9354879731959778	0.0	0	1	0.9354879731959778	0.0
32130673445	1	0.9354968282308748	0.0	0	1	0.9354968282308748	0.0
32130673446	8	7.490328096550991	0.0	0	8	0.9362910120688739	0.0
32130673447	2	1.8713492383003356	0.0	0	2	0.9356746191501678	0.0
32130673448	5	4.67863957169644	0.0	0	5	0.935727914339288	0.0
32130673449	17	15.911648434778307	0.0	0	17	0.9359793196928416	0.0
32130673450	1	0.9359134525723826	0.0	0	1	0.9359134525723826	0.0
32130673451	1	0.9359246644606743	0.0	0	1	0.9359246644606743	0.0
32130673452	3	2.8080077932387737	0.0	0	3	0.9360025977462579	0.0
32130673453	3	2.8080152004922994	0.0	0	3	0.9360050668307665	0.0
32130673454	18	17.417506680080077	0.0	0	18	0.9676392600044488	0.0
32130673455	1	0.936045975071831	0.0	0	1	0.936045975071831	0.0
32130673456	1	0.936063011754941	0.0	0	1	0.936063011754941	0.0
32130673457	1	0.9360752337232591	0.0	0	1	0.9360752337232591	0.0
32130673458	7	6.555040691578898	0.0	0	7	0.9364343845112711	0.0
32130673459	3	2.809087939149547	0.0	0	3	0.9363626463831823	0.0
32130673460	1	0.9364718584802464	0.0	0	1	0.9364718584802464	0.0
32130673461	2	1.8730157019970326	0.0	0	2	0.9365078509985163	0.0
32130673462	3	2.8095922721066704	0.0	0	3	0.9365307573688901	0.0
32130673463	1	0.9366116198865498	0.0	0	1	0.9366116198865498	0.0
32130673464	4	3.7470799007306814	0.0	0	4	0.9367699751826704	0.0
32130673465	1	0.9368461941379871	0.0	0	1	0.9368461941379871	0.0
32130673466	22	20.6316061380139	0.0	0	22	0.9378002790006318	0.0
32130673467	18	16.895749270124586	0.0	0	18	0.9386527372291437	0.0
32130673468	1	0.9405634569813819	0.0	0	1	0.9405634569813819	0.0
32130673469	1	0.9405746688696737	0.0	0	1	0.9405746688696737	0.0
32130673470	2	1.8812042860927771	0.0	0	2	0.9406021430463886	0.0
32130673471	1	0.9405983047422887	0.0	0	1	0.9405983047422887	0.0
32130673472	1	0.9407669544373438	0.0	0	1	0.9407669544373438	0.0
32130673473	1	0.9407686715733885	0.0	0	1	0.9407686715733885	0.0
32130673474	33	31.11132964005428	0.0	0	33	0.9427675648501297	0.0
32130673475	4	3.7763457573962183	0.0	0	4	0.9440864393490546	0.0
32130673476	1	0.941291185970985	0.0	0	1	0.941291185970985	0.0
32130673477	1	0.9415085551926413	0.0	0	1	0.9415085551926413	0.0
32130673478	1	0.9415231003450197	0.0	0	1	0.9415231003450197	0.0
32130673479	2	1.883120879273316	0.0	0	2	0.941560439636658	0.0
32130673480	4	3.766384482854346	0.0	0	4	0.9415961207135864	0.0
32130673481	1	0.9416342764865794	0.0	0	1	0.9416342764865794	0.0
32130673482	32	30.339619476592016	0.0	0	32	0.9481131086435005	0.0
32130673483	1	0.9418183130673683	0.0	0	1	0.9418183130673683	0.0
32130673484	5	4.709345802479457	0.0	0	5	0.9418691604958914	0.0
32130673485	2	1.8837182069315261	0.0	0	2	0.9418591034657631	0.0
32130673486	1	0.9418916112079423	0.0	0	1	0.9418916112079423	0.0
32130673487	1	0.9420507324814161	0.0	0	1	0.9420507324814161	0.0
32130673488	4	3.768348751812126	0.0	0	4	0.9420871879530315	0.0
32130673489	2	1.8842652999430953	0.0	0	2	0.9421326499715477	0.0
32130673490	1	0.942217564032424	0.0	0	1	0.942217564032424	0.0
32130673491	1	0.9422178333870976	0.0	0	1	0.9422178333870976	0.0
32130673492	4	3.7797716458213646	0.0	0	4	0.9449429114553412	0.0
32130673493	28	26.620132740003335	0.0	0	28	0.9507190264286906	0.0
32130673494	1	0.9423416018596517	0.0	0	1	0.9423416018596517	0.0
32130673495	1	0.9425189382429328	0.0	0	1	0.9425189382429328	0.0
32130673496	1	0.9425456380249609	0.0	0	1	0.9425456380249609	0.0
32130673497	4	3.7807477198200963	0.0	0	4	0.9451869299550241	0.0
32130673498	1	0.9425824386072519	0.0	0	1	0.9425824386072519	0.0
32130673499	4	3.770451873104185	0.0	0	4	0.9426129682760462	0.0
32130673500	35	33.28007337355987	0.0	0	35	0.9508592392445678	0.0
32130673501	1	0.9427792358657061	0.0	0	1	0.9427792358657061	0.0
32130673502	2	1.9196235889644986	0.0	0	2	0.9598117944822493	0.0
32130673503	2	1.8856811627852714	0.0	0	2	0.9428405813926357	0.0
32130673504	4	3.77160521614753	0.0	0	4	0.9429013040368825	0.0
32130673505	1	0.942921791826749	0.0	0	1	0.942921791826749	0.0
32130673506	37	35.18733567050138	0.0	0	37	0.9510090721757131	0.0
32130673507	1	0.9431039765941562	0.0	0	1	0.9431039765941562	0.0
32130673508	4	3.772549135932092	0.0	0	4	0.943137283983023	0.0
32130673509	2	1.8862909144278046	0.0	0	2	0.9431454572139023	0.0
32130673510	1	0.9431783858227591	0.0	0	1	0.9431783858227591	0.0
32130673511	1	0.9432963968391633	0.0	0	1	0.9432963968391633	0.0
32130673512	3	2.8487793704757043	0.0	0	3	0.9495931234919014	0.0
32130673513	1	0.9433461601151248	0.0	0	1	0.9433461601151248	0.0
32130673514	1	0.9434108389061412	0.0	0	1	0.9434108389061412	0.0
32130673515	4	3.784049166386005	0.0	0	4	0.9460122915965012	0.0
32130673516	5	4.718088718493625	0.0	0	5	0.9436177436987251	0.0
32130673517	3	2.9374469897376203	0.0	0	3	0.9791489965792067	0.0
32130673518	1	0.943737431447973	0.0	0	1	0.943737431447973	0.0
32130673519	1	0.9437452764028438	0.0	0	1	0.9437452764028438	0.0
32130673520	4	3.784894940061346	0.0	0	4	0.9462237350153365	0.0
32130673521	1	0.9437961507668342	0.0	0	1	0.9437961507668342	0.0
32130673522	5	4.7192265399739	0.0	0	5	0.9438453079947801	0.0
32130673523	1	0.9438652739099662	0.0	0	1	0.9438652739099662	0.0
32130673524	2	1.8879974109628765	0.0	0	2	0.9439987054814383	0.0
32130673525	4	3.7763171384621406	0.0	0	4	0.9440792846155351	0.0
32130673526	4	3.786793755833423	0.0	0	4	0.9466984389583557	0.0
32130673527	1	0.9443129077082809	0.0	0	1	0.9443129077082809	0.0
32130673528	5	4.721819449070704	0.0	0	5	0.9443638898141409	0.0
32130673529	2	1.88878433064202	0.0	0	2	0.94439216532101	0.0
32130673530	20	19.05427968045243	0.0	0	20	0.9527139840226215	0.0
32130673531	5	4.723395645282387	0.0	0	5	0.9446791290564773	0.0
32130673532	1	0.9447140441560524	0.0	0	1	0.9447140441560524	0.0
32130673533	1	0.9447253233830125	0.0	0	1	0.9447253233830125	0.0
32130673534	15	14.21383720748966	0.0	0	15	0.9475891471659774	0.0
32130673535	1	0.9448676773280501	0.0	0	1	0.9448676773280501	0.0
32130673536	2	1.889766633467581	0.0	0	2	0.9448833167337904	0.0
32130673537	8	7.802781100473434	0.0	0	8	0.9753476375591793	0.0
32130673538	5	4.72487420042486	0.0	0	5	0.9449748400849719	0.0
32130673539	2	1.8899300644158337	0.0	0	2	0.9449650322079168	0.0
32130673540	2	1.8900173689994386	0.0	0	2	0.9450086844997193	0.0
32130673541	19	18.07822517626486	0.0	0	19	0.9514855355928873	0.0
32130673542	3	2.8359933398016612	0.0	0	3	0.9453311132672204	0.0
32130673543	4	3.7810875444102727	0.0	0	4	0.9452718861025682	0.0
32130673544	2	1.8905347656582352	0.0	0	2	0.9452673828291176	0.0
32130673545	2	1.890597558966536	0.0	0	2	0.945298779483268	0.0
32130673546	22	21.04194380877677	0.0	0	22	0.956451991308035	0.0
32130673547	3	2.836634134570336	0.0	0	3	0.9455447115234453	0.0
32130673548	18	17.143176857234984	0.0	0	18	0.9523987142908324	0.0
33555544138	2	1.6227000267368183	0.0	0	2	0.8113500133684092	0.0
33555544139	12	9.889669531107723	0.0	0	12	0.8241391275923102	0.0
33555544140	12	9.830493588735884	0.0	0	12	0.8192077990613237	0.0
33555544141	5	4.057763884164427	0.0	0	5	0.8115527768328853	0.0
33555544142	3	2.434661576222474	0.0	0	3	0.8115538587408246	0.0
33555544143	2	1.6231604885514668	0.0	0	2	0.8115802442757334	0.0
33555544144	20	16.38762093730241	0.0	0	20	0.8193810468651206	0.0
33555544145	2	1.6234924681867722	0.0	0	2	0.8117462340933861	0.0
33555544146	1	0.8117479848987649	0.0	0	1	0.8117479848987649	0.0
33555544147	4	3.247242708796252	0.0	0	4	0.811810677199063	0.0
33555544148	3	2.4354467450962383	0.0	0	3	0.8118155816987461	0.0
33555544149	23	18.077474047087975	1.0	1	22	0.8217033657767261	0.045454545454545456
33555544150	2	0.8119244122100224	1.0	1	1	0.8119244122100224	1.0
33555544151	1	0.8119389236930667	0.0	0	1	0.8119389236930667	0.0
33555544152	3	2.436048281421224	0.0	0	3	0.8120160938070747	0.0
33555544153	14	11.400224177161036	0.0	0	14	0.814301726940074	0.0
33555544154	9	7.491817526888415	0.0	0	9	0.8324241696542684	0.0
33555544155	4	3.2487179306746388	0.0	0	4	0.8121794826686597	0.0
33555544156	3	2.436547631316885	0.0	0	3	0.812182543772295	0.0
33555544157	2	1.6533183805575487	0.0	0	2	0.8266591902787743	0.0
33555544158	11	9.124217049093627	0.0	0	11	0.8294742771903297	0.0
33555544159	4	3.249754474797611	0.0	0	4	0.8124386186994027	0.0
33555544160	3	2.437302834483203	0.0	0	3	0.8124342781610676	0.0
33555544161	2	1.6533829920098966	0.0	0	2	0.8266914960049483	0.0
33555544162	18	14.717118031588369	0.0	0	18	0.817617668421576	0.0
33555544163	1	0.8125548368237603	0.0	0	1	0.8125548368237603	0.0
33555544164	1	0.8125582037571812	0.0	0	1	0.8125582037571812	0.0
33555544165	1	0.8125553755331076	0.0	0	1	0.8125553755331076	0.0
33555544166	2	1.806263284025379	0.0	0	2	0.9031316420126895	0.0
33555544167	3	1.6251574504327637	1.0	1	2	0.8125787252163819	0.5
33555544168	2	1.6252810505586466	0.0	0	2	0.8126405252793233	0.0
33555544169	2	1.625373371873049	0.0	0	2	0.8126866859365245	0.0
33555544170	20	16.377693298425413	0.0	0	20	0.8188846649212707	0.0
33555544171	4	3.251347943377742	0.0	0	4	0.8128369858444355	0.0
33555544172	2	1.6256579450857873	0.0	0	2	0.8128289725428937	0.0
33555544173	2	1.6257250143995325	0.0	0	2	0.8128625071997663	0.0
33555544174	1	0.8129564783115448	0.0	0	1	0.8129564783115448	0.0
33555544175	1	0.8129555692395212	0.0	0	1	0.8129555692395212	0.0
33555544176	1	0.8129782623707783	0.0	0	1	0.8129782623707783	0.0
33555544177	1	0.8130529409540549	0.0	0	1	0.8130529409540549	0.0
33555544178	1	0.8130993372965956	0.0	0	1	0.8130993372965956	0.0
33555544179	3	2.511584254293438	0.0	0	3	0.837194751431146	0.0
33555544180	2	1.626337695274142	0.0	0	2	0.813168847637071	0.0
33555544181	3	2.4398535222349085	0.0	0	3	0.8132845074116362	0.0
33555544182	2	1.6291222838906005	0.0	0	2	0.8145611419453003	0.0
33555544183	2	1.6293220103811312	0.0	0	2	0.8146610051905656	0.0
33555544184	2	1.6292694525504303	0.0	0	2	0.8146347262752152	0.0
33555544185	1	0.8146256692243128	0.0	0	1	0.8146256692243128	0.0
33555544186	2	1.62928776866824	0.0	0	2	0.81464388433412	0.0
33555544187	1	0.8146788331030295	0.0	0	1	0.8146788331030295	0.0
33555544188	1	0.8147031760316629	0.0	0	1	0.8147031760316629	0.0
33555544189	1	0.8147438822567221	0.0	0	1	0.8147438822567221	0.0
33555544190	3	2.7494592789099297	0.0	0	3	0.9164864263033099	0.0
33555544191	2	1.6295571906805841	0.0	0	2	0.8147785953402921	0.0
33555544192	2	1.6297530451976807	0.0	0	2	0.8148765225988404	0.0
33555544193	2	1.6297610584992224	0.0	0	2	0.8148805292496112	0.0
33555544194	2	1.6298189360847286	0.0	0	2	0.8149094680423643	0.0
33555544195	1	0.8148943841806384	0.0	0	1	0.8148943841806384	0.0
33555544196	1	0.8149117238877562	0.0	0	1	0.8149117238877562	0.0
33555544197	1	0.8149233398080585	0.0	0	1	0.8149233398080585	0.0
33555544198	3	2.4460725512874024	0.0	0	3	0.8153575170958008	0.0
33555544199	1	0.8150147520504372	0.0	0	1	0.8150147520504372	0.0
33555544200	2	1.6302174126550972	0.0	0	2	0.8151087063275486	0.0
33555544201	2	1.6301562018055047	0.0	0	2	0.8150781009027523	0.0
33555544202	2	1.6302608460962276	0.0	0	2	0.8151304230481138	0.0
33555544203	2	1.6302772430619874	0.0	0	2	0.8151386215309937	0.0
33555544204	2	1.6306229934549845	0.0	0	2	0.8153114967274923	0.0
33555544205	1	0.8152009771379497	0.0	0	1	0.8152009771379497	0.0
33555544206	2	1.6306786488644327	0.0	0	2	0.8153393244322164	0.0
33555544207	3	2.498025411391285	0.0	0	3	0.8326751371304284	0.0
33555544208	1	0.8152749823345421	0.0	0	1	0.8152749823345421	0.0
33555544209	1	0.815331715162685	0.0	0	1	0.815331715162685	0.0
33555544210	2	1.63074733430622	0.0	0	2	0.81537366715311	0.0
33555544211	1	0.8154270330478319	0.0	0	1	0.8154270330478319	0.0
33555544212	1	0.8154711735449806	0.0	0	1	0.8154711735449806	0.0
33555544213	1	0.8155190513382264	0.0	0	1	0.8155190513382264	0.0
33555544214	1	0.8155302632265181	0.0	0	1	0.8155302632265181	0.0
33555544215	2	1.631149548172686	0.0	0	2	0.815574774086343	0.0
33555544216	1	0.8156242006689626	0.0	0	1	0.8156242006689626	0.0
33555544217	2	1.7827254228422258	0.0	0	2	0.8913627114211129	0.0
33555544218	1	0.8156610012512535	0.0	0	1	0.8156610012512535	0.0
33555544219	2	1.6315079245660113	0.0	0	2	0.8157539622830057	0.0
33555544220	1	0.8157591136911398	0.0	0	1	0.8157591136911398	0.0
33555544221	4	3.5807862846755003	0.0	0	4	0.8951965711688751	0.0
33555544222	1	0.8158662158432601	0.0	0	1	0.8158662158432601	0.0
33555544223	2	1.6317882554426395	0.0	0	2	0.8158941277213198	0.0
33555544224	1	0.8173233236198426	0.0	0	1	0.8173233236198426	0.0
33555544225	14	11.444840152647336	0.0	0	14	0.8174885823319525	0.0
33555544226	2	1.6350315887377018	0.0	0	2	0.8175157943688509	0.0
33555544227	2	1.6349471123781705	0.0	0	2	0.8174735561890852	0.0
33555544228	1	0.8174792799759009	0.0	0	1	0.8174792799759009	0.0
33555544229	6	4.087681713817595	1.0	1	5	0.817536342763519	0.2
33555544230	2	1.635040107079257	0.0	0	2	0.8175200535396285	0.0
33555544231	3	2.545699976535841	0.0	0	3	0.8485666588452804	0.0
33555544232	1	0.8175543289218538	0.0	0	1	0.8175543289218538	0.0
33555544233	9	7.452155926592366	0.0	0	9	0.8280173251769295	0.0
33555544234	11	9.056624446556112	0.0	0	11	0.8233294951414648	0.0
33555544235	4	3.2710074676226424	0.0	0	4	0.8177518669056606	0.0
33555544236	2	1.635524575129197	0.0	0	2	0.8177622875645985	0.0
33555544237	1	0.8177957717174698	0.0	0	1	0.8177957717174698	0.0
33555544238	20	16.48292013596889	0.0	0	20	0.8241460067984445	0.0
33555544239	2	1.6362795426101755	0.0	0	2	0.8181397713050877	0.0
33555544240	4	3.2721742783996715	0.0	0	4	0.8180435695999179	0.0
33555544241	1	0.8180322314516227	0.0	0	1	0.8180322314516227	0.0
33555544242	4	1.6361564475243056	2.0	2	2	0.8180782237621528	1.0
33555544243	21	17.336495669433397	0.0	0	21	0.8255474128301618	0.0
33555544244	1	0.8182322946354953	0.0	0	1	0.8182322946354953	0.0
33555544245	4	3.2739898299082473	0.0	0	4	0.8184974574770618	0.0
33555544246	4	3.273258498299884	0.0	0	4	0.818314624574971	0.0
33555544247	2	1.6366991298530937	0.0	0	2	0.8183495649265469	0.0
33555544248	12	9.85276938859553	0.0	0	12	0.8210641157162941	0.0
33555544249	6	5.032885040738379	0.0	0	6	0.8388141734563965	0.0
33555544250	4	3.2743123484606396	0.0	0	4	0.8185780871151599	0.0
33555544251	2	1.637220667839998	0.0	0	2	0.818610333919999	0.0
33555544252	22	18.224482373547996	0.0	0	22	0.8283855624339999	0.0
33555544253	3	2.456256481136402	0.0	0	3	0.8187521603788007	0.0
33555544254	20	15.589845928116578	1.0	1	19	0.8205182067429778	0.05263157894736842
33555544255	4	3.2767148238031556	0.0	0	4	0.8191787059507889	0.0
33555544256	19	15.584621053495285	0.0	0	19	0.8202432133418571	0.0
33555544257	12	9.839302193621098	0.0	0	12	0.8199418494684249	0.0
33555544258	1	0.8201857557369936	0.0	0	1	0.8201857557369936	0.0
33555544259	2	1.6409890070633886	0.0	0	2	0.8204945035316943	0.0
33555544260	5	4.101549338183783	0.0	0	5	0.8203098676367565	0.0
33555544261	14	11.515775514023835	0.0	0	14	0.8225553938588454	0.0
33555544262	8	6.584265437987367	0.0	0	8	0.8230331797484208	0.0
33555544263	1	0.8215264349558798	0.0	0	1	0.8215264349558798	0.0
33555544264	4	3.289126485150123	0.0	0	4	0.8222816212875308	0.0
33555544265	2	1.645872609313133	0.0	0	2	0.8229363046565665	0.0
33555544266	4	2.6175141748738757	1.0	1	3	0.8725047249579586	0.3333333333333333
33555544267	1	0.8229524996063213	0.0	0	1	0.8229524996063213	0.0
33555544268	1	0.8253306320202035	0.0	0	1	0.8253306320202035	0.0
33555544269	1	0.8253384769750743	0.0	0	1	0.8253384769750743	0.0
33555544270	15	12.428540861625873	0.0	0	15	0.8285693907750582	0.0
33555544271	1	0.8255214698065027	0.0	0	1	0.8255214698065027	0.0
33555544272	1	0.8255217391611763	0.0	0	1	0.8255217391611763	0.0
33555544273	1	0.8255362843135549	0.0	0	1	0.8255362843135549	0.0
33555544274	1	0.825568135503717	0.0	0	1	0.825568135503717	0.0
33555544275	2	1.6513448862021955	0.0	0	2	0.8256724431010978	0.0
33555544276	4	3.3027037115087543	0.0	0	4	0.8256759278771886	0.0
33555544277	1	0.8257085366273704	0.0	0	1	0.8257085366273704	0.0
33555544278	1	0.8257303543559381	0.0	0	1	0.8257303543559381	0.0
33555544279	16	13.30293491882677	0.0	0	16	0.8314334324266731	0.0
33555544280	2	1.651949486436595	0.0	0	2	0.8259747432182974	0.0
33555544281	4	3.650179321190533	0.0	0	4	0.9125448302976332	0.0
33555544282	5	4.12989777283078	0.0	0	5	0.8259795545661561	0.0
33555544283	2	1.6519302949160954	0.0	0	2	0.8259651474580477	0.0
33555544284	2	1.6520367236815316	0.0	0	2	0.8260183618407658	0.0
33555544285	21	17.61676913984649	0.0	0	21	0.8388937685641186	0.0
33555544286	1	0.8261481907934775	0.0	0	1	0.8261481907934775	0.0
33555544287	4	3.3048372698789388	0.0	0	4	0.8262093174697347	0.0
33555544288	1	0.8262057316856414	0.0	0	1	0.8262057316856414	0.0
33555544289	1	0.8262407814625534	0.0	0	1	0.8262407814625534	0.0
33555544290	20	16.749585774598554	0.0	0	20	0.8374792887299277	0.0
33555544291	1	0.8263205441152957	0.0	0	1	0.8263205441152957	0.0
33555544292	1	0.8263283890701665	0.0	0	1	0.8263283890701665	0.0
33555544293	1	0.826342631198537	0.0	0	1	0.826342631198537	0.0
33555544294	1	0.8263509475240868	0.0	0	1	0.8263509475240868	0.0
33555544295	1	0.8263719235192993	0.0	0	1	0.8263719235192993	0.0
33555544296	4	2.479262535185717	1.0	1	3	0.8264208450619056	0.3333333333333333
33555544297	2	1.6529317892621558	0.0	0	2	0.8264658946310779	0.0
33555544298	2	1.6529675797644203	0.0	0	2	0.8264837898822102	0.0
33555544299	19	15.84018143461464	0.0	0	19	0.83369375971656	0.0
33555544300	2	1.6531978106717446	0.0	0	2	0.8265989053358723	0.0
33555544301	1	0.8266135009922521	0.0	0	1	0.8266135009922521	0.0
33555544302	1	0.8266247128805438	0.0	0	1	0.8266247128805438	0.0
33555544303	1	0.826648045729151	0.0	0	1	0.826648045729151	0.0
33555544304	1	0.8266531297986166	0.0	0	1	0.8266531297986166	0.0
33555544305	1	0.8266805703059974	0.0	0	1	0.8266805703059974	0.0
33555544306	1	0.8267775379885206	0.0	0	1	0.8267775379885206	0.0
33555544307	13	10.925118794670157	0.0	0	13	0.8403937534361658	0.0
33555544308	11	9.480586245060163	0.0	0	11	0.8618714768236512	0.0
33555544309	3	2.48110101551089	0.0	0	3	0.8270336718369634	0.0
33555544310	2	1.810162361273505	0.0	0	2	0.9050811806367525	0.0
33555544311	25	21.96627669384781	0.0	0	25	0.8786510677539124	0.0
33555544312	1	0.8272068556690253	0.0	0	1	0.8272068556690253	0.0
33555544313	2	0.8272180675573171	1.0	1	1	0.8272180675573171	1.0
33555544314	2	1.7507868270884743	0.0	0	2	0.8753934135442372	0.0
33555544315	3	2.482008909107848	0.0	0	3	0.8273363030359494	0.0
33555544316	4	3.44892255942023	0.0	0	4	0.8622306398550575	0.0
33555544317	18	14.982351242063425	0.0	0	18	0.8323528467813014	0.0
33555544318	2	1.6551164240123362	0.0	0	2	0.8275582120061681	0.0
33555544319	2	1.6551925503769838	0.0	0	2	0.8275962751884919	0.0
33555544320	14	11.719807201311674	0.0	0	14	0.8371290858079767	0.0
33555544321	1	0.8277049261299858	0.0	0	1	0.8277049261299858	0.0
33555544322	1	0.8277161380182775	0.0	0	1	0.8277161380182775	0.0
33555544323	9	7.667620945383053	0.0	0	9	0.8519578828203392	0.0
33555544324	5	4.139103709528998	0.0	0	5	0.8278207419057996	0.0
33555544325	2	1.655638669055259	0.0	0	2	0.8278193345276295	0.0
33555544326	22	18.521500681282145	0.0	0	22	0.8418863946037338	0.0
33555544327	1	0.8279741461263246	0.0	0	1	0.8279741461263246	0.0
33555544328	1	0.8279819910811954	0.0	0	1	0.8279819910811954	0.0
33555544329	1	0.8280019906657158	0.0	0	1	0.8280019906657158	0.0
33555544330	1	0.8280132025540076	0.0	0	1	0.8280132025540076	0.0
33555544331	5	4.14047667763939	0.0	0	5	0.8280953355278781	0.0
33555544332	2	1.656176671346592	0.0	0	2	0.828088335673296	0.0
33555544333	17	14.254568011162867	0.0	0	17	0.8385040006566392	0.0
33555544334	1	0.8282424907199739	0.0	0	1	0.8282424907199739	0.0
33555544335	1	0.8282503356748447	0.0	0	1	0.8282503356748447	0.0
33555544336	1	0.8282716146940651	0.0	0	1	0.8282716146940651	0.0
33555544337	1	0.8282718840487387	0.0	0	1	0.8282718840487387	0.0
33555544338	2	1.65656730296209	0.0	0	2	0.828283651481045	0.0
33555544339	3	2.4850790136784027	0.0	0	3	0.8283596712261342	0.0
33555544340	2	1.6566591865751477	0.0	0	2	0.8283295932875738	0.0
33555544341	3	2.4851475644428533	0.0	0	3	0.8283825214809512	0.0
33555544342	1	0.8283951811506138	0.0	0	1	0.8283951811506138	0.0
33555544343	15	12.513575425049252	0.0	0	15	0.8342383616699501	0.0
33555544344	1	0.8284752468273638	0.0	0	1	0.8284752468273638	0.0
33555544345	2	1.6570684710017978	0.0	0	2	0.8285342355008989	0.0
33555544346	2	1.6571504221612634	0.0	0	2	0.8285752110806317	0.0
33555544347	13	10.773931666133402	0.0	0	13	0.828763974317954	0.0
33555544348	2	1.6573923699968927	0.0	0	2	0.8286961849984463	0.0
33555544349	1	0.8286896868169439	0.0	0	1	0.8286896868169439	0.0
33555544350	1	0.8287022791479383	0.0	0	1	0.8287022791479383	0.0
33555544351	1	0.828703996283983	0.0	0	1	0.828703996283983	0.0
33555544352	1	0.828725881351219	0.0	0	1	0.828725881351219	0.0
33555544353	2	1.6574972163036208	0.0	0	2	0.8287486081518104	0.0
33555544354	1	0.8287597190320996	0.0	0	1	0.8287597190320996	0.0
33555544355	8	5.9889476033444025	1.0	1	7	0.8555639433349146	0.14285714285714285
33555544356	2	1.6576863706232097	0.0	0	2	0.8288431853116048	0.0
33555544357	22	18.548488437125737	0.0	0	22	0.8431131107784426	0.0
33555544358	5	4.145095605252915	0.0	0	5	0.829019121050583	0.0
33555544359	3	2.4870233503903303	0.0	0	3	0.8290077834634434	0.0
33555544360	19	15.888081651637068	0.0	0	19	0.8362148237703719	0.0
33555544361	3	2.487754749337362	0.0	0	3	0.8292515831124541	0.0
33555544362	11	9.388166043823265	0.0	0	11	0.8534696403475696	0.0
33555544363	11	9.16768318314734	0.0	0	11	0.8334257439224854	0.0
33555544364	3	2.488315242743947	0.0	0	3	0.8294384142479824	0.0
33555544365	21	17.641780404763978	0.0	0	21	0.840084781179237	0.0
33555544366	8	5.913641928718182	1.0	1	7	0.844805989816883	0.14285714285714285
33555544367	3	2.4888148956636154	0.0	0	3	0.8296049652212051	0.0
33555544368	16	13.31998069265699	0.0	0	16	0.8324987932910619	0.0
33555544369	4	3.31908741155108	0.0	0	4	0.82977185288777	0.0
33555544370	2	1.6595370729167007	0.0	0	2	0.8297685364583504	0.0
33555544371	4	3.319953824528292	0.0	0	4	0.829988456132073	0.0
33555544372	17	14.163090618622501	0.0	0	17	0.8331229775660295	0.0
33555544373	2	1.6604372562361247	0.0	0	2	0.8302186281180624	0.0
33555544374	4	3.321207131824904	0.0	0	4	0.830301782956226	0.0
33555544375	2	1.6605841218719464	0.0	0	2	0.8302920609359732	0.0
33555544376	23	19.110637600558935	0.0	0	23	0.8308972869808232	0.0
33555544377	2	0.8305028814721257	1.0	1	1	0.8305028814721257	1.0
33555544378	1	0.8305107264269964	0.0	0	1	0.8305107264269964	0.0
33555544379	5	4.152910594416271	0.0	0	5	0.8305821188832543	0.0
33555544380	2	1.6611515511613781	0.0	0	2	0.8305757755806891	0.0
33555544381	12	9.983904980829188	0.0	0	12	0.8319920817357657	0.0
33555544382	4	3.3233945274604904	0.0	0	4	0.8308486318651226	0.0
33555544383	1	0.8308407195715833	0.0	0	1	0.8308407195715833	0.0
33555544384	4	3.3245739642378473	0.0	0	4	0.8311434910594618	0.0
33555544385	2	1.662721215522223	0.0	0	2	0.8313606077611115	0.0
33555544386	3	2.553656006540201	0.0	0	3	0.8512186688467337	0.0
33555544387	4	3.326523688043248	0.0	0	4	0.831630922010812	0.0
33555544388	2	1.6632515748746903	0.0	0	2	0.8316257874373452	0.0
33555544389	23	19.145135772768626	0.0	0	23	0.8323972075116793	0.0
33555544390	1	0.831858375198064	0.0	0	1	0.831858375198064	0.0
33555544391	1	0.8318586445527377	0.0	0	1	0.8318586445527377	0.0
33555544392	1	0.8318589139074114	0.0	0	1	0.8318589139074114	0.0
33555544393	1	0.8318934923136445	0.0	0	1	0.8318934923136445	0.0
33555544394	4	3.327838946914807	0.0	0	4	0.8319597367287017	0.0
33619190108	3	1.1385887370622636	0.0	0	3	0.3795295790207545	0.0
33619190109	2	0.18945229319646795	1.0	1	1	0.18945229319646795	1.0
34094639290	3	1.5236836662349473	0.0	0	3	0.5078945554116491	0.0
34094639291	8	4.16613715465911	0.0	0	8	0.5951624506655872	0.0
34094639292	3	1.312105334377397	0.0	0	3	0.6560526671886985	0.0
34094639294	2	0.5376648235960889	0.0	0	2	0.26883241179804446	0.0
34094639296	3	0.9518023817485004	0.0	0	3	0.9518023817485004	0.0
34094639298	3	1.6743196951093642	0.0	0	3	0.8371598475546821	0.0
34094639299	4	0.0	4.0	4	0	0.0	inf
34094639301	1	0.30496854661302153	0.0	0	1	0.30496854661302153	0.0
34094639303	5	2.5909298113234485	1.0	1	4	0.6477324528308621	0.25
34094639306	6	2.5904728511195576	0.0	0	6	0.5180945702239115	0.0
34094639308	1	0.5072637043196779	0.0	0	1	0.5072637043196779	0.0
34094639309	3	0.0	3.0	3	0	0.0	inf
34094639311	3	1.3042933754541193	0.0	0	3	0.6521466877270596	0.0
34094639312	1	0.0	1.0	1	0	0.0	inf
34094639314	116	18.56831994432978	40.66666666666667	51	65	0.309471999072163	0.7846153846153846
34094639315	33	3.6658821936258086	14.5	16	17	0.21564012903681226	0.9411764705882353
34094639316	5	0.0	5.0	5	0	0.0	inf
34094639320	3	0.86802405485381	0.0	0	3	0.86802405485381	0.0
34094639321	30	1.8811425702031714	19.0	27	3	0.08550648046378052	9.0
34094639322	6	0.0	6.0	6	0	0.0	inf
34094639323	11	5.731379991196816	0.0	0	11	0.5731379991196816	0.0
34094639324	4	0.0	4.0	4	0	0.0	inf
34094639325	8	0.6521910975788819	7.0	7	1	0.09317015679698314	7.0
34094639326	8	1.5744684361271013	6.0	6	2	0.26241140602118357	3.0
34094639327	6	0.0	6.0	6	0	0.0	inf
34094639328	11	0.7018413455855143	9.0	9	2	0.08773016819818928	4.5
34094639329	6	0.0	6.0	6	0	0.0	inf
34094639330	4	0.0	4.0	4	0	0.0	inf
34094639331	7	0.0	7.0	7	0	0.0	inf
34094639332	8	0.0	8.0	8	0	0.0	inf
34094639333	8	0.01170635613394833	7.0	7	1	0.001672336590564047	7.0
34094639334	8	0.0	8.0	8	0	0.0	inf
34094639335	8	0.0	8.0	8	0	0.0	inf
34094639336	8	0.833302520280976	6.0	6	2	0.13888375338016265	3.0
34094639337	39	0.5267481480266892	24.5	27	12	0.019509190667655156	2.25
34094639338	5	0.0	5.0	5	0	0.0	inf
34094639339	10	1.706907469296008	5.0	5	5	0.3413814938592016	1.0
34094639340	7	0.0	7.0	7	0	0.0	inf
34094639341	1	0.6983510140546911	0.0	0	1	0.6983510140546911	0.0
34094639342	6	0.0	6.0	6	0	0.0	inf
34094639343	9	1.155961406458324	7.0	7	2	0.16513734377976055	3.5
34094639344	6	0.0	6.0	6	0	0.0	inf
34094639345	8	4.711407274805099	0.0	0	8	0.5889259093506374	0.0
34094639347	7	3.52101530416018	0.0	0	7	0.5868358840266966	0.0
34094639348	72	3.747242658292249	32.0	35	37	0.09608314508441665	0.9459459459459459
34094639349	116	8.28875083638835	38.83333333333333	53	63	0.16915818033445615	0.8412698412698413
34094639350	5	0.0	5.0	5	0	0.0	inf
34094639352	5	2.7043641214591605	0.0	0	5	0.5408728242918321	0.0
34094639353	8	0.0	8.0	8	0	0.0	inf
36324665353	3	0.1344586208427926	1.0	1	2	0.0672293104213963	0.5
36324665354	3	0.13460413970524585	1.0	1	2	0.06730206985262292	0.5
36324665355	4	2.3031077771886017	0.0	0	4	0.5757769442971504	0.0
36324665356	1	0.06741833006364817	0.0	0	1	0.06741833006364817	0.0
36324665357	3	0.2227247332942612	0.5	1	2	0.2227247332942612	0.5
36324665358	1	0.06745337984056021	0.0	0	1	0.06745337984056021	0.0
36324665359	4	0.14208637483861025	2.0	2	2	0.07104318741930513	1.0
36324665360	16	1.1980649088872461	2.0	2	14	0.08557606492051759	0.14285714285714285
36324665361	2	0.06749994452977189	1.0	1	1	0.06749994452977189	1.0
36459804217	2	0.13977770226120217	0.0	0	2	0.06988885113060109	0.0
36459804218	3	0.17992380427652394	1.0	1	2	0.08996190213826197	0.5
36459804219	29	1.4601746152276904	10.0	10	19	0.0768512955382995	0.5263157894736842
36459804220	2	0.06997171136209056	1.0	1	1	0.06997171136209056	1.0
36459804221	4	0.37073883010578534	0.5	1	3	0.18536941505289267	0.3333333333333333
36459804222	3	0.4327349832496746	0.5	1	2	0.4327349832496746	0.5
36459804223	3	1.5035132435127525	0.0	0	3	0.7517566217563763	0.0
36459804224	1	0.07006702924723753	0.0	0	1	0.07006702924723753	0.0
36459804225	9	0.35074564275886927	4.0	4	5	0.07014912855177385	0.8
36459804226	3	1.011084517200434	0.0	0	3	0.33702817240014465	0.0
36459804227	5	1.6244273645897658	1.0	1	4	0.40610684114744144	0.25
36459804228	28	2.613005379652551	6.0	6	22	0.11877297180238867	0.2727272727272727
36459804229	7	0.8771294885894121	2.5	3	4	0.2923764961964707	0.75
36459804230	15	3.469709770675808	7.0	7	8	0.433713721334476	0.875
36459804231	7	3.314822348640097	2.0	2	5	0.6629644697280195	0.4
36459804232	1	0.07027998778611232	0.0	0	1	0.07027998778611232	0.0
36459804233	7	3.400858945118884	1.0	1	6	0.5668098241864806	0.16666666666666666
36942361859	6	4.075607082506064	1.0	1	5	0.8151214165012128	0.2
36942361860	2	1.0379087074184352	0.0	0	2	0.5189543537092176	0.0
36942361861	2	1.0379845644284091	0.0	0	2	0.5189922822142046	0.0
36942361862	1	0.5190169955055143	0.0	0	1	0.5190169955055143	0.0
36942361863	10	2.650161240758062	5.0	5	5	0.5300322481516124	1.0
36942361864	10	3.9787120584060593	1.5	2	8	0.5683874369151514	0.25
36942361865	2	0.5192308294470784	1.0	1	1	0.5192308294470784	1.0
36942361866	8	2.7657206582610723	3.0	3	5	0.5531441316522144	0.6
36942361867	2	0.5193991761181258	1.0	1	1	0.5193991761181258	1.0
36942361868	12	5.349327524071302	2.0	2	10	0.5349327524071301	0.2
36942361869	8	2.597958823549019	3.0	3	5	0.5195917647098038	0.6
36942361870	3	1.5587785937241638	0.0	0	3	0.5195928645747213	0.0
36942361871	3	1.0392578713095422	1.0	1	2	0.5196289356547711	0.5
36942361872	32	11.615556168412258	10.0	10	22	0.5279798258369208	0.45454545454545453
36942361873	7	2.5989875227171204	2.0	2	5	0.5197975045434241	0.4
36942361874	3	1.5593895237933948	0.0	0	3	0.5197965079311316	0.0
36942361875	28	9.971636043789934	9.0	9	19	0.5248229496731543	0.47368421052631576
36942361876	1	0.5199535080365503	0.0	0	1	0.5199535080365503	0.0
36942361877	2	0.519961352991421	1.0	1	1	0.519961352991421	1.0
36942361878	7	2.778615979593959	2.0	2	5	0.5557231959187918	0.4
36942361879	3	1.5601172527829976	0.0	0	3	0.5200390842609992	0.0
36942361880	3	1.040138122383114	1.0	1	2	0.520069061191557	0.5
36942361881	23	8.44489075765665	7.0	7	16	0.5278056723535406	0.4375
36942361882	3	1.0404050528647266	1.0	1	2	0.5202025264323633	0.5
36942361883	3	1.2182188673050125	1.0	1	2	0.6091094336525062	0.5
36942361884	1	0.5202038395363975	0.0	0	1	0.5202038395363975	0.0
36942361885	2	0.5202072401391526	1.0	1	1	0.5202072401391526	1.0
36942361886	9	3.1808408222630526	3.0	3	6	0.5301401370438421	0.5
36942361887	5	2.7797165627905978	0.0	0	5	0.5559433125581196	0.0
36942361888	3	1.5608717825626317	0.0	0	3	0.5202905941875439	0.0
36942361889	3	1.0406440377989454	1.0	1	2	0.5203220188994727	0.5
36942361890	31	11.083918930034349	10.0	10	21	0.527805663334969	0.47619047619047616
36942361891	3	0.6536324817763887	0.5	1	2	0.6536324817763887	0.5
36942361892	2	0.9938576023521666	0.0	0	2	0.9938576023521666	0.0
36942361893	3	0.7086642341470549	0.5	1	2	0.7086642341470549	0.5
36942361894	1	0.5204958200026619	0.0	0	1	0.5204958200026619	0.0
36942361895	9	2.78093899530774	4.0	4	5	0.556187799061548	0.8
36942361896	3	1.5617168491819546	0.0	0	3	0.5205722830606515	0.0
36942361897	29	11.116662256545041	8.0	8	21	0.5293648693592876	0.38095238095238093
36942361898	2	0.5207476666225486	1.0	1	1	0.5207476666225486	1.0
36942361899	1	0.5207588785108404	0.0	0	1	0.5207588785108404	0.0
36942361900	8	2.6041571459609743	3.0	3	5	0.5208314291921948	0.6
36942361901	3	1.5624869678633275	0.0	0	3	0.5208289892877759	0.0
36942361902	3	1.0417256314910899	1.0	1	2	0.5208628157455449	0.5
36942361903	20	7.324213769700474	6.0	6	14	0.5231581264071767	0.42857142857142855
36942361904	1	0.5209801533752649	0.0	0	1	0.5209801533752649	0.0
36942361905	2	0.5209804227299386	1.0	1	1	0.5209804227299386	1.0
36942361906	10	3.7679704768422826	3.0	3	7	0.5382814966917546	0.42857142857142855
36942361907	3	1.563199478313868	0.0	0	3	0.5210664927712894	0.0
36942361908	6	3.0787798448766233	1.0	1	5	0.6157559689753247	0.2
36942361909	8	6.123591472864015	0.0	0	8	0.7654489341080019	0.0
36942361910	1	0.5212001151356552	0.0	0	1	0.5212001151356552	0.0
36942361911	1	0.5212018659410341	0.0	0	1	0.5212018659410341	0.0
36942361912	2	1.516460583966993	0.0	0	2	0.7582302919834965	0.0
36942361913	1	0.5212222022188967	0.0	0	1	0.5212222022188967	0.0
36942361914	1	0.5212334141071884	0.0	0	1	0.5212334141071884	0.0
36942361915	2	0.9050687734870962	0.0	0	2	0.9050687734870962	0.0
36942361916	2	0.905079985375388	0.0	0	2	0.905079985375388	0.0
36942361917	28	11.159277027813934	7.0	7	21	0.5313941441816159	0.3333333333333333
36942361918	3	1.5640467334399148	0.0	0	3	0.5213489111466383	0.0
36942361919	31	11.685602895050968	9.0	9	22	0.5311637679568622	0.4090909090909091
36942361920	2	0.5214922639485907	1.0	1	1	0.5214922639485907	1.0
36942361921	1	0.5215034758368824	0.0	0	1	0.5215034758368824	0.0
36942361922	2	1.0431682277846281	0.0	0	2	0.5215841138923141	0.0
36942361923	4	2.30118556122925	1.0	1	3	0.7670618537430833	0.3333333333333333
36942361924	28	10.585474571117494	8.0	8	20	0.5292737285558747	0.4
36942361925	6	2.7862177745331014	1.0	1	5	0.5572435549066203	0.2
36942361926	2	1.0435504757359082	0.0	0	2	0.5217752378679541	0.0
36942361927	2	0.5218062641594281	1.0	1	1	0.5218062641594281	1.0
36942361928	20	7.889935687194647	5.0	5	15	0.5259957124796432	0.3333333333333333
36942361929	1	0.5219201338477244	0.0	0	1	0.5219201338477244	0.0
36942361930	3	2.11999090793299	0.0	0	3	0.7066636359776634	0.0
36942361931	1	0.5219479783871157	0.0	0	1	0.5219479783871157	0.0
36942361932	5	1.5664290745205731	2.0	2	3	0.522143024840191	0.6666666666666666
36942361933	7	2.7008847324619554	2.0	2	5	0.5401769464923911	0.4
36942361934	5	2.7874999027797975	0.0	0	5	0.5574999805559595	0.0
36942361935	2	1.0441327868710606	0.0	0	2	0.5220663934355303	0.0
36942361936	3	1.0442074654543372	1.0	1	2	0.5221037327271686	0.5
36942361937	31	11.117951219666582	10.0	10	21	0.5294262485555515	0.47619047619047616
36942361938	3	1.0444790423040708	1.0	1	2	0.5222395211520354	0.5
36942361939	2	0.5222285786184172	1.0	1	1	0.5222285786184172	1.0
36942361940	1	0.5222391844586932	0.0	0	1	0.5222391844586932	0.0
36942361941	3	2.2194033544825014	0.0	0	3	0.7398011181608338	0.0
36942361942	1	0.5222436288108089	0.0	0	1	0.5222436288108089	0.0
36942361943	4	1.0446274903986001	2.0	2	2	0.5223137451993001	1.0
36942361944	8	2.788566412610216	3.0	3	5	0.5577132825220432	0.6
36942361945	2	0.5223576668457763	1.0	1	1	0.5223576668457763	1.0
36942361946	1	0.5224418065119657	0.0	0	1	0.5224418065119657	0.0
36942361947	3	0.5920198896878136	0.5	1	2	0.5920198896878136	0.5
36942361948	1	0.5224842298730696	0.0	0	1	0.5224842298730696	0.0
36942361949	4	2.0901913586508996	0.0	0	4	0.5225478396627249	0.0
36942361950	3	1.5677482727042338	0.0	0	3	0.5225827575680779	0.0
36942361951	5	2.0904201081075184	1.0	1	4	0.5226050270268796	0.25
36942361952	9	7.960253822336418	0.0	0	9	0.8844726469262687	0.0
36942361953	4	2.091141843955632	0.0	0	4	0.522785460988908	0.0
36942361954	2	1.0455601982948703	0.0	0	2	0.5227800991474352	0.0
36942361955	3	1.1245515202596632	1.0	1	2	0.5622757601298316	0.5
36942361956	12	3.474494486090979	6.0	6	6	0.5790824143484965	1.0
36942361957	1	0.5230944528862818	0.0	0	1	0.5230944528862818	0.0
36942361958	1	0.5231045873558788	0.0	0	1	0.5231045873558788	0.0
36942361959	2	0.5231147218254759	1.0	1	1	0.5231147218254759	1.0
36942361960	20	6.856392781335148	7.0	7	13	0.527414829333473	0.5384615384615384
36942361961	2	0.5242939565868278	1.0	1	1	0.5242939565868278	1.0
36942361962	3	1.0486428615270855	1.0	1	2	0.5243214307635428	0.5
36942361963	2	0.5243325416438318	1.0	1	1	0.5243325416438318	1.0
36942361964	3	1.0487902658722545	1.0	1	2	0.5243951329361273	0.5
36942361965	20	7.994969599453102	5.0	5	15	0.5329979732968735	0.3333333333333333
36942361966	8	3.8435785020897044	2.0	2	6	0.6405964170149507	0.3333333333333333
36942361967	1	0.5245548265882827	0.0	0	1	0.5245548265882827	0.0
36942361968	3	1.9449520863489131	0.0	0	3	0.6483173621163044	0.0
36942361969	2	1.0491280703023778	0.0	0	2	0.5245640351511889	0.0
36942361970	2	0.524561796140464	1.0	1	1	0.524561796140464	1.0
36942361971	2	1.1548976911826445	0.0	0	2	0.5774488455913223	0.0
36942361972	3	1.57381942604088	0.0	0	3	0.52460647534696	0.0
36942361973	2	1.0492141291206172	0.0	0	2	0.5246070645603086	0.0
36942361974	9	3.2309239232302818	3.0	3	6	0.5384873205383803	0.5
36942361975	5	2.7983098802290876	0.0	0	5	0.5596619760458175	0.0
36942361976	3	1.574118746422002	0.0	0	3	0.524706248807334	0.0
36942361977	31	11.230495615629803	10.0	10	21	0.5347855055061811	0.47619047619047616
36942361978	5	2.624767660550621	0.0	0	5	0.5249535321101242	0.0
36942361979	3	1.5748592024199364	0.0	0	3	0.5249530674733122	0.0
36942361980	31	11.235127303920994	10.0	10	21	0.5350060620914758	0.47619047619047616
36942361981	2	0.5251137375361596	1.0	1	1	0.5251137375361596	1.0
36942361982	3	2.024533497065061	0.0	0	3	0.674844499021687	0.0
36942361983	3	1.0503631624891834	1.0	1	2	0.5251815812445917	0.5
36942361984	6	2.8022180481974504	1.0	1	5	0.56044360963949	0.2
36942361985	2	0.5252367316140267	1.0	1	1	0.5252367316140267	1.0
36942361986	21	7.397019361584307	7.0	7	14	0.5283585258274505	0.5
36942361987	2	0.5253559210571283	1.0	1	1	0.5253559210571283	1.0
36960293002	3	0.4738189109000665	1.0	1	2	0.23690945545003325	0.5
36960293003	4	0.47385210886359697	2.0	2	2	0.23692605443179848	1.0
37961544257	10	1.0517133027909824	5.0	5	5	0.17528555046516373	1.0
37961544258	8	0.7101207022062874	3.0	3	5	0.11835345036771457	0.6
38049440797	2	1.7730946801542877	0.0	0	2	0.8865473400771439	0.0
38049440798	4	3.5463245426854266	0.0	0	4	0.8865811356713567	0.0
38049440799	2	1.7735078702237062	0.0	0	2	0.8867539351118531	0.0
38174624283	1	0.8924589681083056	0.0	0	1	0.8924589681083056	0.0
38174624284	1	0.8924719308019763	0.0	0	1	0.8924719308019763	0.0
38174624285	1	0.8924832773676049	0.0	0	1	0.8924832773676049	0.0
38174624286	2	1.7851376622916622	0.0	0	2	0.8925688311458311	0.0
38174624287	2	1.7850767544660773	0.0	0	2	0.8925383772330386	0.0
38916915423	1	0.1831483837524318	0.0	0	1	0.1831483837524318	0.0
38916915424	1	0.18315999967273408	0.0	0	1	0.18315999967273408	0.0
38916915425	4	2.972560031328642	0.0	0	4	0.7431400078321605	0.0
38916915426	1	0.18319552082032506	0.0	0	1	0.18319552082032506	0.0
38916915427	1	0.18322397140773203	0.0	0	1	0.18322397140773203	0.0
38916915428	1	0.1832355873280343	0.0	0	1	0.1832355873280343	0.0
38916915429	6	3.4184607006649053	0.0	0	6	0.5697434501108175	0.0
38916915430	8	0.9495705762610924	1.0	2	6	0.2373926440652731	0.3333333333333333
38916915431	1	0.1833199626795632	0.0	0	1	0.1833199626795632	0.0
38916915432	1	0.18333117456785494	0.0	0	1	0.18333117456785494	0.0
38916915433	1	0.18334056831209938	0.0	0	1	0.18334056831209938	0.0
38916915434	2	0.3667564212554911	0.0	0	2	0.18337821062774556	0.0
38916915435	7	4.502094586115836	1.0	1	6	0.7503490976859727	0.16666666666666666
38916915436	1	0.18345258618701424	0.0	0	1	0.18345258618701424	0.0
38916915437	3	0.8648077580341176	0.0	0	3	0.2882692526780392	0.0
38916915438	13	5.82367851145988	2.0	2	11	0.5294253192236255	0.18181818181818182
38916915439	1	0.18350416760702312	0.0	0	1	0.18350416760702312	0.0
38916915440	1	0.18352965529301968	0.0	0	1	0.18352965529301968	0.0
38916915441	3	1.1076228483738233	0.0	0	3	0.3692076161246078	0.0
38916915442	8	5.465822073662645	0.0	0	8	0.6832277592078306	0.0
38916915443	2	0.3964877227971392	0.0	0	2	0.1982438613985696	0.0
38916915444	4	0.9635623731318443	0.0	0	4	0.24089059328296109	0.0
38916915445	1	0.18360968730043553	0.0	0	1	0.18360968730043553	0.0
38916915446	1	0.18364022538656352	0.0	0	1	0.18364022538656352	0.0
38916915447	3	1.068102625612121	0.0	0	3	0.3560342085373737	0.0
38916915448	3	1.2350938029334544	0.0	0	3	0.4116979343111515	0.0
38916915449	3	1.4889623336781186	0.0	0	3	0.4963207778927062	0.0
38916915450	2	0.3676503084094179	0.0	0	2	0.18382515420470896	0.0
38916915451	13	3.8311828673458197	1.5	3	10	0.5473118381922599	0.3
38916915452	2	0.36751977240068784	0.0	0	2	0.18375988620034392	0.0
38916915453	2	0.36752569820350867	0.0	0	2	0.18376284910175433	0.0
38916915454	1	0.1837833873956221	0.0	0	1	0.1837833873956221	0.0
38916915455	3	0.8567821335159468	1.0	1	2	0.4283910667579734	0.5
39041037798	17	2.5495148804484433	4.0	4	13	0.19611652926526488	0.3076923076923077
39041037799	2	0.18957882255442707	1.0	1	1	0.18957882255442707	1.0
39041037800	2	0.18957936126377442	1.0	1	1	0.18957936126377442	1.0
39041037801	1	0.1895796306184481	0.0	0	1	0.1895796306184481	0.0
39041037802	4	0.37927208717583205	2.0	2	2	0.18963604358791603	1.0
39041037803	13	1.7821676903210462	4.0	4	9	0.198018632257894	0.4444444444444444
39041037804	9	0.9482404355438138	4.0	4	5	0.18964808710876274	0.8
39041037805	30	3.8968628833535677	10.0	10	20	0.1948431441676784	0.5
39041037806	1	0.18980848108306975	0.0	0	1	0.18980848108306975	0.0
39041037807	1	0.18981632603794055	0.0	0	1	0.18981632603794055	0.0
39041037808	4	0.37975746429779556	2.0	2	2	0.18987873214889778	1.0
39041037809	12	2.0757647559981667	5.0	5	7	0.2965378222854524	0.7142857142857143
39041037810	2	0.18991716569389788	1.0	1	1	0.18991716569389788	1.0
39041037811	27	3.255844314614744	10.0	10	17	0.19152025380086732	0.5882352941176471
39041037812	9	1.101538328311496	4.0	4	5	0.22030766566229917	0.8
39041037813	3	0.5703584205001532	0.0	0	3	0.19011947350005107	0.0
39041037814	3	0.380283816999492	1.0	1	2	0.190141908499746	0.5
40135768851	3	0.520248922774904	0.5	1	2	0.520248922774904	0.5
40135768852	1	0.4709633809964285	0.0	0	1	0.4709633809964285	0.0
40135768853	1	0.47096365035110216	0.0	0	1	0.47096365035110216	0.0
40135768854	2	1.2828889042944798	0.0	0	2	0.6414444521472399	0.0
40135768855	7	4.1451201501975525	0.0	0	7	0.5921600214567933	0.0
40135768856	2	1.4506661258922668	0.0	0	2	0.7253330629461334	0.0
40135768857	4	1.8881943092293336	0.0	0	4	0.4720485773073334	0.0
40135768858	1	0.47158952960472167	0.0	0	1	0.47158952960472167	0.0
40135768859	2	0.47160074149301345	1.0	1	1	0.47160074149301345	1.0
40135768860	3	0.6128740019104654	0.5	1	2	0.6128740019104654	0.5
40135768861	1	0.471884068940386	0.0	0	1	0.471884068940386	0.0
40135768862	1	0.4719044388875827	0.0	0	1	0.4719044388875827	0.0
40135768863	3	0.9438403586026513	1.0	1	2	0.4719201793013256	0.5
40135768864	3	1.7654508658860522	0.0	0	3	0.5884836219620174	0.0
40135768865	1	0.4719392529791553	0.0	0	1	0.4719392529791553	0.0
40135768866	27	10.869288304684044	4.0	4	23	0.47257775237756716	0.17391304347826086
40135768867	2	0.4722640610462739	1.0	1	1	0.4722640610462739	1.0
40135768868	5	1.656751709905555	0.5	1	4	0.8283758549527775	0.25
40135768869	2	0.4725704519875799	1.0	1	1	0.4725704519875799	1.0
40135768870	1	0.4725816638758717	0.0	0	1	0.4725816638758717	0.0
40135768871	7	3.758493064302334	2.0	2	5	0.7516986128604668	0.4
40135768872	2	1.3963096793578396	0.0	0	2	0.6981548396789198	0.0
40135768873	1	0.4728563383043524	0.0	0	1	0.4728563383043524	0.0
40135768874	4	1.3789734401813942	1.0	1	3	0.6894867200906971	0.3333333333333333
40135768875	2	0.4728596715684391	1.0	1	1	0.4728596715684391	1.0
40135768876	1	0.4728635772112074	0.0	0	1	0.4728635772112074	0.0
40135768877	1	0.47287142216607825	0.0	0	1	0.47287142216607825	0.0
40135768878	2	0.47313932905838285	1.0	1	1	0.47313932905838285	1.0
40135768879	2	0.473142729661138	1.0	1	1	0.473142729661138	1.0
40135768880	3	0.9463121254349699	1.0	1	2	0.47315606271748495	0.5
40135768881	1	0.4731538405414271	0.0	0	1	0.4731538405414271	0.0
40135768882	2	0.9718293731069627	0.0	0	2	0.48591468655348136	0.0
40135768883	2	0.9468307341897981	0.0	0	2	0.47341536709489906	0.0
40135768884	3	0.4988760671200871	0.5	1	2	0.4988760671200871	0.5
40135768885	1	0.47537073051378026	0.0	0	1	0.47537073051378026	0.0
40135768886	2	0.47538739683421394	1.0	1	1	0.47538739683421394	1.0
40135768887	3	0.6783338204724838	0.5	1	2	0.6783338204724838	0.5
40135768888	3	0.6021378949804309	0.5	1	2	0.6021378949804309	0.5
40135768889	2	0.9061388185976069	0.0	0	2	0.9061388185976069	0.0
40135768890	2	1.104312344757013	0.0	0	2	0.5521561723785064	0.0
40135768891	4	1.4528549693092234	1.0	1	3	0.7264274846546117	0.3333333333333333
40135768892	2	1.24721062192075	0.0	0	2	0.623605310960375	0.0
40135768893	33	15.198129890702267	7.0	7	26	0.5845434573347026	0.2692307692307692
40135768894	2	0.4757523724170444	1.0	1	1	0.4757523724170444	1.0
40135768895	10	3.037352894049305	4.0	4	6	0.5062254823415508	0.6666666666666666
40135768896	2	0.9515819149480969	0.0	0	2	0.4757909574740484	0.0
40135768897	4	0.9516631253822101	2.0	2	2	0.47583156269110505	1.0
40135768898	44	21.5493338404384	10.0	10	34	0.6530101163769212	0.29411764705882354
40135768899	11	2.6745710366892377	1.5	3	8	0.5349142073378476	0.375
40135768900	3	1.4280463937836712	0.0	0	3	0.47601546459455707	0.0
40135768901	14	10.92287507023844	0.0	0	14	0.7802053621598886	0.0
40135768902	33	26.942609980122636	0.0	0	33	0.8419565618788324	0.0
40135768903	11	9.143899838848466	0.0	0	11	0.8312636217134969	0.0
40135768904	20	7.935051012576608	1.5	3	17	0.7935051012576608	0.17647058823529413
40135768905	4	1.9051199508750947	0.0	0	4	0.47627998771877367	0.0
40135768906	2	0.9525405819010426	0.0	0	2	0.4762702909505213	0.0
40135768907	2	0.4763019232900111	1.0	1	1	0.4763019232900111	1.0
40135768908	28	11.49535479347113	4.0	4	24	0.4789731163946304	0.16666666666666666
40135768909	24	12.478263330354382	3.0	3	21	0.5942030157311611	0.14285714285714285
40135768910	6	2.863320078502073	0.0	0	6	0.47722001308367884	0.0
40135768911	2	1.1762955294834447	0.0	0	2	0.5881477647417224	0.0
40135768912	1	0.47650316490058103	0.0	0	1	0.47650316490058103	0.0
40135768913	1	0.47652319815443567	0.0	0	1	0.47652319815443567	0.0
40135768914	1	0.47653104310930644	0.0	0	1	0.47653104310930644	0.0
40135768915	4	1.9064287452344846	0.0	0	4	0.47660718630862114	0.0
40135768916	2	0.9531967972247849	0.0	0	2	0.47659839861239245	0.0
40135768917	1	0.4766825887825832	0.0	0	1	0.4766825887825832	0.0
40135768918	4	2.823842615794817	0.0	0	4	0.7059606539487042	0.0
40135768919	8	4.42016898167469	2.0	2	6	0.7366948302791151	0.3333333333333333
40135768920	1	0.47683470683454154	0.0	0	1	0.47683470683454154	0.0
40135768921	2	0.4768459187228333	1.0	1	1	0.4768459187228333	1.0
40135768922	2	1.4359605391362744	0.0	0	2	0.7179802695681372	0.0
40135768923	2	0.47686888120876414	1.0	1	1	0.47686888120876414	1.0
40135768924	7	2.977193268409205	1.0	1	6	0.4961988780682008	0.16666666666666666
40135768925	2	0.953854595007235	0.0	0	2	0.4769272975036175	0.0
40135768926	4	2.092376666787764	0.0	0	4	0.6974588889292547	0.0
40135768927	3	1.543290194947802	0.0	0	3	0.771645097473901	0.0
40135768928	4	1.9088717921247225	0.0	0	4	0.4772179480311806	0.0
40135768929	2	0.9544229333686907	0.0	0	2	0.47721146668434533	0.0
40135768930	25	9.5569378575536	5.0	5	20	0.47784689287767995	0.25
40135768931	4	1.9100653700224477	0.0	0	4	0.4775163425056119	0.0
40135768932	4	1.9110926214091781	0.0	0	4	0.47777315535229453	0.0
40135768933	7	5.903066188826985	0.0	0	7	0.8432951698324265	0.0
40135768934	1	0.47796131642652406	0.0	0	1	0.47796131642652406	0.0
40135768935	2	0.4780043458356438	1.0	1	1	0.4780043458356438	1.0
40135768936	2	1.0502160948373565	0.0	0	2	0.5251080474186782	0.0
40135768937	1	0.47800828514774624	0.0	0	1	0.47800828514774624	0.0
40135768938	6	3.5417271971151303	0.0	0	6	0.590287866185855	0.0
40135768939	2	0.9561645806886773	0.0	0	2	0.47808229034433863	0.0
40135768940	15	10.620308291911915	0.0	0	15	0.7080205527941277	0.0
40135768941	4	1.9135534457078787	0.0	0	4	0.47838836142696967	0.0
40135768942	2	0.9567693492697475	0.0	0	2	0.4783846746348738	0.0
40135768943	2	0.47860951844872446	1.0	1	1	0.47860951844872446	1.0
40135768944	1	0.47862073033701624	0.0	0	1	0.47862073033701624	0.0
40135768945	1	0.4786407635908709	0.0	0	1	0.4786407635908709	0.0
40135768946	9	3.5536351315529906	2.0	2	7	0.5076621616504272	0.2857142857142857
40135768947	2	0.9574138139958507	0.0	0	2	0.47870690699792534	0.0
40135768948	5	2.394760384944192	0.0	0	5	0.47895207698883835	0.0
40135768949	2	0.9578856223761277	0.0	0	2	0.47894281118806387	0.0
40135768950	4	1.916750584676406	0.0	0	4	0.4791876461691015	0.0
40135768951	3	1.7237568162304506	0.0	0	3	0.5745856054101502	0.0
40135768952	1	0.4794188282351171	0.0	0	1	0.4794188282351171	0.0
40135768953	4	1.3379125760249357	0.5	1	3	0.6689562880124679	0.3333333333333333
40135768954	5	2.2968552808179035	0.0	0	5	0.5742138202044759	0.0
40135768955	6	1.4646372161224799	3.0	3	3	0.48821240537415994	1.0
40135768956	1	0.48093704585328984	0.0	0	1	0.48093704585328984	0.0
40135768957	2	0.4809482577415816	1.0	1	1	0.4809482577415816	1.0
40135768958	22	6.762815802782816	8.0	8	14	0.483058271627344	0.5714285714285714
40135768959	4	0.9625752219221574	2.0	2	2	0.4812876109610787	1.0
40135768960	2	0.4812572412216218	1.0	1	1	0.4812572412216218	1.0
40135768961	8	2.5837931919057437	3.0	3	5	0.5167586383811488	0.6
40135768962	2	0.9625885886478385	0.0	0	2	0.48129429432391924	0.0
40135768963	4	2.052695134245864	1.0	1	3	0.684231711415288	0.3333333333333333
40135768964	11	7.764635461950168	0.0	0	11	0.8627372735500187	0.0
40135768965	41	19.837988954909587	8.0	8	33	0.6199371548409246	0.24242424242424243
40135768966	7	3.2663762170327977	0.5	1	6	0.6532752434065595	0.16666666666666666
40135768967	3	1.4444361879754888	0.0	0	3	0.48147872932516295	0.0
40135768968	27	19.446508737512087	0.0	0	27	0.7479426437504648	0.0
40135768969	18	15.485081572547802	0.0	0	18	0.9108871513263413	0.0
40135768970	5	2.414888350635948	0.0	0	5	0.4829776701271896	0.0
40135768971	1	0.4817203292443386	0.0	0	1	0.4817203292443386	0.0
40135768972	13	6.275940395447004	0.0	0	13	0.4827646458036157	0.0
40135768973	26	10.145902120484568	5.0	5	21	0.48313819621355086	0.23809523809523808
40135768974	2	0.9678120828264275	0.0	0	2	0.48390604141321375	0.0
40135768975	2	1.038895050564101	0.0	0	2	0.5194475252820505	0.0
40135768976	9	4.139999818858982	0.5	1	8	0.5914285455512831	0.125
40135768977	2	0.7571976029992912	0.0	0	2	0.7571976029992912	0.0
40135768978	1	0.4849465921869569	0.0	0	1	0.4849465921869569	0.0
40135768979	3	1.9993698447409356	0.0	0	3	0.6664566149136452	0.0
40135768980	3	1.4548773178685144	0.0	0	3	0.4849591059561715	0.0
40135768981	2	0.9699250018947418	0.0	0	2	0.4849625009473709	0.0
40135768982	3	0.9703491344977783	1.0	1	2	0.48517456724888913	0.5
40135768983	1	0.4851722777341629	0.0	0	1	0.4851722777341629	0.0
40135768984	2	0.4851706279367866	1.0	1	1	0.4851706279367866	1.0
40135768985	1	0.48517254708883656	0.0	0	1	0.48517254708883656	0.0
40135768986	8	6.590580491981025	0.0	0	8	0.8238225614976281	0.0
40135768987	8	2.123111651182196	4.0	4	4	0.530777912795549	1.0
40135768988	13	5.015740615758925	5.0	5	8	0.6269675769698656	0.625
40135768989	1	0.48534389033062847	0.0	0	1	0.48534389033062847	0.0
40135768990	7	3.71763923288193	0.5	1	6	0.7435278465763859	0.16666666666666666
40135768991	1	0.485353452421544	0.0	0	1	0.485353452421544	0.0
40135768992	2	0.4853741253927486	1.0	1	1	0.4853741253927486	1.0
40135768993	2	0.4855548623787849	1.0	1	1	0.4855548623787849	1.0
40135768994	1	0.4855693738618292	0.0	0	1	0.4855693738618292	0.0
40135768995	3	0.6028131671473357	0.5	1	2	0.6028131671473357	0.5
40135768996	1	0.4858293684605946	0.0	0	1	0.4858293684605946	0.0
40135768997	2	0.48584000797020477	1.0	1	1	0.48584000797020477	1.0
40135768998	1	0.48585121985849655	0.0	0	1	0.48585121985849655	0.0
40135768999	5	2.429602859765506	0.0	0	5	0.4859205719531012	0.0
40135769000	2	0.9718237166588155	0.0	0	2	0.48591185832940775	0.0
40135769001	2	0.4859424637542042	1.0	1	1	0.4859424637542042	1.0
40135769002	5	1.9438758797502422	1.0	1	4	0.48596896993756056	0.25
40135769003	4	2.4248505005805097	0.0	0	4	0.6062126251451274	0.0
40135769004	7	2.9183765104947144	1.0	1	6	0.4863960850824524	0.16666666666666666
40135769005	2	0.9720188641198935	0.0	0	2	0.48600943205994673	0.0
40135769006	7	2.4310448836803626	2.0	2	5	0.48620897673607255	0.4
40135769007	2	0.48613037230842715	1.0	1	1	0.48613037230842715	1.0
40135769008	19	7.296031257532461	4.0	4	15	0.48640208383549743	0.26666666666666666
40135769009	1	0.4862505718315549	0.0	0	1	0.4862505718315549	0.0
40135769010	1	0.4863872356591111	0.0	0	1	0.4863872356591111	0.0
40135769011	4	1.946385457244878	0.0	0	4	0.4865963643112195	0.0
40135769012	52	18.208767211805736	15.0	15	37	0.4921288435623172	0.40540540540540543
40135769013	2	1.1876441826107518	0.0	0	2	0.5938220913053759	0.0
40135769014	2	0.4874786271275105	1.0	1	1	0.4874786271275105	1.0
40135769015	2	0.48749236421586795	1.0	1	1	0.48749236421586795	1.0
40135769016	2	0.48749940110671774	1.0	1	1	0.48749940110671774	1.0
40135769017	1	0.48750357610415973	0.0	0	1	0.48750357610415973	0.0
40135769018	1	0.4875106129950095	0.0	0	1	0.4875106129950095	0.0
40135769019	2	0.4875501744627056	1.0	1	1	0.4875501744627056	1.0
40135769020	11	3.096795160854739	5.0	5	6	0.5161325268091231	0.8333333333333334
40135769021	44	15.981591459867653	9.5	10	34	0.5155352083828275	0.29411764705882354
40135769022	2	0.48778858701824274	1.0	1	1	0.48778858701824274	1.0
40135769023	5	2.439214175247605	0.0	0	5	0.48784283504952103	0.0
40135769024	2	0.9756675761988378	0.0	0	2	0.4878337880994189	0.0
40135769025	2	0.48787313071644267	1.0	1	1	0.48787313071644267	1.0
40135769026	1	0.48800295966915436	0.0	0	1	0.48800295966915436	0.0
40135769027	3	1.9123054918354052	0.0	0	3	0.9561527459177026	0.0
40135769028	1	0.488020265706938	0.0	0	1	0.488020265706938	0.0
40135769029	2	0.4880558878625316	1.0	1	1	0.4880558878625316	1.0
40135769030	9	3.099614832917444	3.0	3	6	0.5166024721529073	0.5
40135769031	2	0.9761993833326763	0.0	0	2	0.48809969166633815	0.0
40135769032	26	9.521289978588662	8.0	8	18	0.5289605543660367	0.4444444444444444
40135769033	2	0.9765607562967462	0.0	0	2	0.4882803781483731	0.0
40135769034	5	1.9696222809108646	1.0	1	4	0.6565407603036215	0.25
40135769035	1	0.4883010679542449	0.0	0	1	0.4883010679542449	0.0
40135769036	3	1.464947984077233	0.0	0	3	0.488315994692411	0.0
40135769037	3	0.9766275899251521	1.0	1	2	0.48831379496257604	0.5
40135769038	2	0.4883153774212839	1.0	1	1	0.4883153774212839	1.0
40135769039	6	1.9649554081654264	2.0	2	4	0.4912388520413566	0.5
40135769040	2	0.48835840683040355	1.0	1	1	0.48835840683040355	1.0
40135769041	5	2.612896425687049	0.0	0	5	0.5225792851374098	0.0
40135769042	5	2.5463255190961185	1.0	1	4	0.6365813797740296	0.25
40135769043	3	0.9768650260699971	1.0	1	2	0.48843251303499857	0.5
40135769044	49	17.262595049793074	14.0	14	35	0.49321700142265923	0.4
40135769045	7	5.020056654041901	1.0	1	6	0.8366761090069835	0.16666666666666666
40135769046	1	0.48853288132027695	0.0	0	1	0.48853288132027695	0.0
40135769047	4	1.4719638652624623	1.0	1	3	0.7359819326312311	0.3333333333333333
40135769048	2	0.4885418710325109	1.0	1	1	0.4885418710325109	1.0
40135769049	1	0.4885706919825942	0.0	0	1	0.4885706919825942	0.0
40135769050	2	0.48862116231457414	1.0	1	1	0.48862116231457414	1.0
40135769051	11	3.102787527949335	5.0	5	6	0.5171312546582225	0.8333333333333334
40135769052	3	0.9773871701049174	1.0	1	2	0.4886935850524587	0.5
40135769053	2	0.48876435799296697	1.0	1	1	0.48876435799296697	1.0
40135769054	5	1.5229143892869295	2.0	2	3	0.5076381297623098	0.6666666666666666
40135769055	10	5.529167424366975	3.0	3	7	0.7898810606238535	0.42857142857142855
40135769056	2	0.9777429876288428	0.0	0	2	0.4888714938144214	0.0
40135769057	2	0.48890145952186786	1.0	1	1	0.48890145952186786	1.0
40135769058	2	0.4889899425321703	1.0	1	1	0.4889899425321703	1.0
40135769059	2	0.4890042183298751	1.0	1	1	0.4890042183298751	1.0
40135769060	1	0.48901543021816685	0.0	0	1	0.48901543021816685	0.0
40135769061	6	1.9673029351545122	2.0	2	4	0.49182573378862804	0.5
40135769062	3	0.9781267507001622	1.0	1	2	0.4890633753500811	0.5
40135769063	2	0.4891310843811763	1.0	1	1	0.4891310843811763	1.0
40135769064	1	0.48921535872470256	0.0	0	1	0.48921535872470256	0.0
40135769065	1	0.4892192643674709	0.0	0	1	0.4892192643674709	0.0
40135769066	2	0.48923131798911784	1.0	1	1	0.48923131798911784	1.0
40135769067	1	0.4892318903677994	0.0	0	1	0.4892318903677994	0.0
40135769068	2	1.0623469876063516	0.0	0	2	0.5311734938031758	0.0
40135769069	2	1.23336249209907	0.0	0	2	0.616681246049535	0.0
40135769070	43	14.30398873531819	14.0	14	29	0.4932409908730411	0.4827586206896552
40135769071	2	0.48929946472155783	1.0	1	1	0.48929946472155783	1.0
40135769072	10	2.8041929229955054	3.5	4	6	0.5608385845991011	0.6666666666666666
40135769073	3	0.9787422261295111	1.0	1	2	0.48937111306475556	0.5
40135769074	1	0.4895055210469197	0.0	0	1	0.4895055210469197	0.0
40135769075	2	0.9791694563112947	0.0	0	2	0.48958472815564735	0.0
40135769076	2	0.4896157881164556	1.0	1	1	0.4896157881164556	1.0
40135769077	48	16.293997899100884	15.0	15	33	0.4937575120939662	0.45454545454545453
40135769078	4	3.3901828369424107	0.0	0	4	0.8475457092356027	0.0
40135769079	1	0.489768882579106	0.0	0	1	0.489768882579106	0.0
40135769080	3	2.284493988794913	0.0	0	3	0.7614979962649709	0.0
40135769081	5	1.4797547471825248	2.0	2	3	0.49325158239417494	0.6666666666666666
40135769082	2	0.48982638980193577	1.0	1	1	0.48982638980193577	1.0
40135769083	7	2.627748406708184	2.0	2	5	0.5255496813416368	0.4
40135769084	2	0.4899060851160095	1.0	1	1	0.4899060851160095	1.0
40135769085	4	1.0205549938575351	0.5	1	3	0.5102774969287676	0.3333333333333333
40135769086	2	0.904789520029163	0.0	0	2	0.904789520029163	0.0
40135769087	3	0.9800604815718138	1.0	1	2	0.4900302407859069	0.5
40135769088	10	2.6286923264927458	3.5	4	6	0.5257384652985492	0.6666666666666666
40135769089	2	0.4901014009237586	1.0	1	1	0.4901014009237586	1.0
40135769090	1	0.4901922407874557	0.0	0	1	0.4901922407874557	0.0
40135769091	2	0.4902043617477711	1.0	1	1	0.4902043617477711	1.0
40135769092	2	0.49022769459637827	1.0	1	1	0.49022769459637827	1.0
40135769093	1	0.49024223974875675	0.0	0	1	0.49024223974875675	0.0
40135769094	16	5.974430800545322	4.0	4	12	0.49786923337877687	0.3333333333333333
40135769095	2	0.980577002827921	0.0	0	2	0.4902885014139605	0.0
40135769096	2	0.4903037536223574	1.0	1	1	0.4903037536223574	1.0
40135769097	8	3.050106097122494	3.0	3	5	0.6100212194244988	0.6
40135769098	2	0.9806625902754815	0.0	0	2	0.49033129513774076	0.0
40135769099	2	0.4903568501624057	1.0	1	1	0.4903568501624057	1.0
40135769100	28	9.396342607966698	9.0	9	19	0.49454434778772094	0.47368421052631576
40135769101	3	1.471691514018042	0.0	0	3	0.490563838006014	0.0
40135769102	2	0.4906024342861295	1.0	1	1	0.4906024342861295	1.0
40135769103	30	10.424717271025044	9.0	9	21	0.4964151081440497	0.42857142857142855
40135769104	2	0.49070664087550775	1.0	1	1	0.49070664087550775	1.0
40135769105	1	0.4907126676863312	0.0	0	1	0.4907126676863312	0.0
40135769106	1	0.4907144858303785	0.0	0	1	0.4907144858303785	0.0
40135769107	2	0.490723879574623	1.0	1	1	0.490723879574623	1.0
40135769108	10	4.102607666365988	3.0	3	7	0.5860868094808555	0.42857142857142855
40135769109	2	0.9816010219585674	0.0	0	2	0.4908005109792837	0.0
40135769110	4	2.1298977054921115	1.0	1	3	0.7099659018307038	0.3333333333333333
40135769111	22	7.402083431465413	7.0	7	15	0.49347222876436087	0.4666666666666667
40135769112	9	3.514764895288202	2.0	2	7	0.5021092707554574	0.2857142857142857
40135769113	9	2.4548598434840594	4.0	4	5	0.49097196869681187	0.8
40135769114	2	0.9819323282071885	0.0	0	2	0.4909661641035942	0.0
40135769115	2	0.4909980826324248	1.0	1	1	0.4909980826324248	1.0
40135769116	31	10.411616263729469	10.0	10	21	0.4957912506537842	0.47619047619047616
40135769117	2	0.4911122216753948	1.0	1	1	0.4911122216753948	1.0
40135769118	2	0.49111276038474216	1.0	1	1	0.49111276038474216	1.0
40135769119	1	0.4911267331584391	0.0	0	1	0.4911267331584391	0.0
40135769120	1	0.49112730553712064	0.0	0	1	0.49112730553712064	0.0
40135769121	5	1.4738040627236801	2.0	2	3	0.4912680209078934	0.6666666666666666
40135769122	9	2.6336479811176985	4.0	4	5	0.5267295962235397	0.8
40135769123	2	1.2849738778154003	0.0	0	2	0.6424869389077001	0.0
40135769124	2	0.4912438687721538	1.0	1	1	0.4912438687721538	1.0
40135769125	35	13.484702388505937	6.5	8	27	0.5618625995210808	0.2962962962962963
40135769126	4	0.9828322758412729	2.0	2	2	0.49141613792063643	1.0
40135769127	12	5.011423601065257	2.0	2	10	0.5011423601065257	0.2
40135769128	4	1.6518507342793587	1.0	1	3	0.5506169114264529	0.3333333333333333
40135769129	4	0.9829360783986407	2.0	2	2	0.49146803919932036	1.0
40135769130	5	1.5967460541307945	2.0	2	3	0.5322486847102649	0.6666666666666666
40135769131	22	7.4334279991557075	7.0	7	15	0.4955618666103805	0.4666666666666667
40135769132	6	2.458421991704751	1.0	1	5	0.49168439834095023	0.2
40135769133	2	0.4917161148537756	1.0	1	1	0.4917161148537756	1.0
40135769134	29	10.4440010791695	8.0	8	21	0.4973333847223571	0.38095238095238093
40135769135	7	2.4594962791513724	2.0	2	5	0.4918992558302745	0.4
40135769136	6	2.4980474311358583	2.0	2	4	0.6245118577839646	0.5
40135769137	25	8.915790705627428	7.0	7	18	0.49532170586819046	0.3888888888888889
40135769138	2	0.4920290713152525	1.0	1	1	0.4920290713152525	1.0
40135769139	2	1.3074527374296636	0.0	0	2	0.6537263687148318	0.0
40135769140	9	2.6485544391215847	2.5	3	6	0.529710887824317	0.5
40135769141	3	1.4763431008857493	0.0	0	3	0.4921143669619164	0.0
40135769142	11	4.200572163197823	2.5	3	8	0.600081737599689	0.375
40135769143	23	7.972565149067442	7.0	7	16	0.49828532181671514	0.4375
40135769144	10	3.4837523072332135	3.0	3	7	0.4976789010333162	0.42857142857142855
40135769145	8	3.618703072734146	2.0	2	6	0.6031171787890243	0.3333333333333333
40135769146	3	1.477097462318712	0.0	0	3	0.49236582077290403	0.0
40135769147	32	10.952200050254852	10.0	10	22	0.4978272750115842	0.45454545454545453
40135769148	9	2.643741071103001	4.0	4	5	0.5287482142206003	0.8
40135769149	2	0.49257781412419815	1.0	1	1	0.49257781412419815	1.0
40135769150	2	0.4925870731911058	1.0	1	1	0.4925870731911058	1.0
40135769151	32	10.955552068160738	10.0	10	22	0.49797963946185175	0.45454545454545453
40135769152	2	0.9856077400681609	0.0	0	2	0.49280387003408044	0.0
40135769153	6	2.8936081024848743	2.0	2	4	0.7234020256212186	0.5
40135769154	26	8.422952762227128	9.0	9	17	0.49546780954277225	0.5294117647058824
40135769155	3	0.6808727239572161	0.5	1	2	0.6808727239572161	0.5
40135769156	2	0.8534723032858206	0.0	0	2	0.8534723032858206	0.0
40135769157	7	3.139169566746711	1.0	1	6	0.5231949277911185	0.16666666666666666
40135769158	3	1.4792157011418314	0.0	0	3	0.4930719003806105	0.0
40135769159	3	0.9862127780039047	1.0	1	2	0.49310638900195236	0.5
40135769160	14	6.042776788105108	2.0	2	12	0.5035647323420923	0.16666666666666666
40135769161	19	6.494975171727915	6.0	6	13	0.49961347474830115	0.46153846153846156
40135769162	8	2.4663150263848053	3.0	3	5	0.49326300527696104	0.6
40135769163	3	1.4797924905061737	0.0	0	3	0.4932641635020579	0.0
40135769164	4	0.9865886624510192	2.0	2	2	0.4932943312255096	1.0
40135769165	30	10.48558826235832	9.0	9	21	0.4993137267789676	0.42857142857142855
40135769166	7	2.647811053891574	2.0	2	5	0.5295622107783148	0.4
40135769167	3	1.4803763167613655	0.0	0	3	0.4934587722537885	0.0
40135769168	4	0.986968654556907	2.0	2	2	0.4934843272784535	1.0
40135769169	26	8.947137461824447	8.0	8	18	0.49706319232358037	0.4444444444444444
40135769170	2	0.905844986317961	0.0	0	2	0.905844986317961	0.0
40135769171	1	0.4935828100810162	0.0	0	1	0.4935828100810162	0.0
40135769172	9	3.143107397398512	3.0	3	6	0.523851232899752	0.5
40135769173	3	1.4809571127764787	0.0	0	3	0.4936523709254929	0.0
40135769174	5	2.930289731018046	1.0	1	4	0.7325724327545114	0.25
40135769175	16	6.027925446801325	4.0	4	12	0.5023271205667771	0.3333333333333333
40135769176	5	1.5406728755836958	0.5	1	4	0.7703364377918479	0.25
40135769177	3	1.7953011885241308	0.0	0	3	0.8976505942620654	0.0
40135769178	1	0.49381469078571666	0.0	0	1	0.49381469078571666	0.0
40135769179	2	0.4938180577191376	1.0	1	1	0.4938180577191376	1.0
40135769180	3	0.5985646695487841	0.5	1	2	0.5985646695487841	0.5
40135769181	2	0.49382593634334265	1.0	1	1	0.49382593634334265	1.0
40135769182	19	6.5022350545781595	6.0	6	13	0.5001719272752431	0.46153846153846156
40135769183	3	1.4817259856924858	0.0	0	3	0.49390866189749527	0.0
40135769184	3	0.9878734505751177	1.0	1	2	0.49393672528755883	0.5
40135769185	30	9.96657281564218	10.0	10	20	0.49832864078210903	0.5
40135769186	6	2.470809478469757	1.0	1	5	0.4941618956939514	0.2
40135769187	3	1.4824765761600172	0.0	0	3	0.4941588587200057	0.0
40135769188	28	9.99152317273409	8.0	8	20	0.49957615863670446	0.4
40135769189	1	0.4942717183282758	0.0	0	1	0.4942717183282758	0.0
40135769190	2	0.49428293021656755	1.0	1	1	0.49428293021656755	1.0
40135769191	7	2.4719392866484897	2.0	2	5	0.4943878573296979	0.4
40135769192	3	1.4831562590097034	0.0	0	3	0.4943854196699011	0.0
40135769193	4	0.9888354844614844	2.0	2	2	0.4944177422307422	1.0
40135769194	22	7.4606059867375825	7.0	7	15	0.49737373244917216	0.4666666666666667
40135769195	2	0.49450309399296316	1.0	1	1	0.49450309399296316	1.0
40135769196	1	0.49451430588125495	0.0	0	1	0.49451430588125495	0.0
40135769197	2	0.4945309722016886	1.0	1	1	0.4945309722016886	1.0
40135769198	1	0.49453215062838596	0.0	0	1	0.49453215062838596	0.0
40135769199	2	0.4945349115137911	1.0	1	1	0.4945349115137911	1.0
40135769200	9	3.566574492375024	2.0	2	7	0.5095106417678605	0.2857142857142857
40135769201	7	2.6538064848955836	2.0	2	5	0.5307612969791167	0.4
40135769202	3	1.4839849286632665	0.0	0	3	0.4946616428877555	0.0
40135769203	4	1.8663663451840073	1.0	1	3	0.6221221150613357	0.3333333333333333
40135769204	31	10.49551606958199	10.0	10	21	0.4997864795039043	0.47619047619047616
40135769205	3	0.545401632565411	0.5	1	2	0.545401632565411	0.5
40135769206	2	0.4948269256493897	1.0	1	1	0.4948269256493897	1.0
40135769207	1	0.49484120144709454	0.0	0	1	0.49484120144709454	0.0
40135769208	1	0.4948414708017682	0.0	0	1	0.4948414708017682	0.0
40135769209	15	7.399764624418408	4.0	4	11	0.672705874947128	0.36363636363636365
40135769210	3	1.4847749795904912	0.0	0	3	0.4949249931968304	0.0
40135769211	30	10.66130026861058	9.0	9	21	0.5076809651719324	0.42857142857142855
40135769212	3	0.7611977219193796	0.5	1	2	0.7611977219193796	0.5
40135769213	1	0.495074361586495	0.0	0	1	0.495074361586495	0.0
40135769214	9	3.157000206426688	3.0	3	6	0.5261667010711147	0.5
40135769215	3	1.48544540337327	0.0	0	3	0.49514846779109	0.0
40135769216	3	1.0050664604038362	1.0	1	2	0.5025332302019181	0.5
40135769217	28	8.957329606990994	10.0	10	18	0.49762942261061077	0.5555555555555556
40135769218	8	2.4768993856255577	3.0	3	5	0.49537987712511156	0.6
40135769219	3	1.486134513636535	0.0	0	3	0.4953781712121783	0.0
40135769220	3	1.0051123853756978	1.0	1	2	0.5025561926878489	0.5
40135769221	15	5.53082755822884	4.0	4	11	0.502802505293531	0.36363636363636365
40135769222	3	0.5410754598128382	0.5	1	2	0.5410754598128382	0.5
40135769223	2	0.8466031530590762	0.0	0	2	0.8466031530590762	0.0
40135769224	19	6.6639199448280815	6.0	6	13	0.512609226525237	0.46153846153846156
40135769225	7	2.481836757802035	0.5	1	6	0.49636735156040696	0.16666666666666666
40135769226	3	1.4867344001641447	0.0	0	3	0.49557813338804824	0.0
40135769227	1	0.4957258632034479	0.0	0	1	0.4957258632034479	0.0
40135769228	1	0.49572949949154255	0.0	0	1	0.49572949949154255	0.0
40135769229	1	0.4957401390011527	0.0	0	1	0.4957401390011527	0.0
40135769230	1	0.4957485563347051	0.0	0	1	0.4957485563347051	0.0
40135769231	1	0.49575468415353124	0.0	0	1	0.49575468415353124	0.0
40135769232	3	1.790433781224141	0.0	0	3	0.596811260408047	0.0
40135769233	3	1.8491641099577156	0.0	0	3	0.6163880366525719	0.0
40135769234	1	0.49584633208124934	0.0	0	1	0.49584633208124934	0.0
40135769235	2	1.3012700039194471	0.0	0	2	0.6506350019597236	0.0
40135769236	1	0.495924074573939	0.0	0	1	0.495924074573939	0.0
40135769237	1	0.49593673424360174	0.0	0	1	0.49593673424360174	0.0
40135769238	1	0.4959479798012277	0.0	0	1	0.4959479798012277	0.0
40135769239	3	0.9919912101489339	1.0	1	2	0.49599560507446694	0.5
40135769240	12	6.746531528284413	0.0	0	12	0.5622109606903677	0.0
40135769241	22	8.651102298649217	5.0	5	17	0.5088883705087774	0.29411764705882354
40135769242	1	0.4974058619724971	0.0	0	1	0.4974058619724971	0.0
40135769243	1	0.49743044058646996	0.0	0	1	0.49743044058646996	0.0
40135769244	1	0.49745633230447706	0.0	0	1	0.49745633230447706	0.0
40135769245	2	0.9950179822863612	0.0	0	2	0.4975089911431806	0.0
40135769246	1	0.4975345124985114	0.0	0	1	0.4975345124985114	0.0
40135769247	1	0.4975702356621076	0.0	0	1	0.4975702356621076	0.0
40135769248	2	1.335987969542855	0.0	0	2	0.6679939847714275	0.0
40135769249	2	0.9951960257256609	0.0	0	2	0.49759801286283045	0.0
40135769250	2	1.448260249946996	0.0	0	2	0.724130124973498	0.0
40135769251	2	0.9954921811893672	0.0	0	2	0.4977460905946836	0.0
40135769252	1	0.4976437694880211	0.0	0	1	0.4976437694880211	0.0
40135769253	1	0.49768868437985647	0.0	0	1	0.49768868437985647	0.0
40135769254	1	0.49774228595991793	0.0	0	1	0.49774228595991793	0.0
40135769255	1	0.4977662585258751	0.0	0	1	0.4977662585258751	0.0
40135769256	4	1.5562381414500581	1.0	1	3	0.5187460471500194	0.3333333333333333
40135769257	2	1.2424415290766517	0.0	0	2	0.6212207645383259	0.0
40135769258	2	0.996154423323933	0.0	0	2	0.4980772116619665	0.0
40135769259	3	2.26185348270711	0.0	0	3	0.75395116090237	0.0
40135769260	4	2.8988950970277823	0.0	0	4	0.7247237742569456	0.0
40135769261	2	0.9958870551409758	0.0	0	2	0.4979435275704879	0.0
40135769262	1	0.4979244707273253	0.0	0	1	0.4979244707273253	0.0
40135769263	2	0.9959152700430431	0.0	0	2	0.49795763502152157	0.0
40135769264	4	2.8145336846032523	0.0	0	4	0.7036334211508131	0.0
40135769265	3	1.9587060430428096	0.0	0	3	0.6529020143476032	0.0
40135769266	1	0.4980852417981754	0.0	0	1	0.4980852417981754	0.0
40135769267	2	0.9962634782974373	0.0	0	2	0.49813173914871867	0.0
40135769268	7	5.409363919948195	0.0	0	7	0.7727662742783136	0.0
40135769269	2	0.996364351622729	0.0	0	2	0.4981821758113645	0.0
40135769270	1	0.498184195971417	0.0	0	1	0.498184195971417	0.0
40135769271	2	0.996458558419847	0.0	0	2	0.4982292792099235	0.0
40135769272	2	0.9964957293648142	0.0	0	2	0.4982478646824071	0.0
40135769273	2	0.996602764178266	0.0	0	2	0.498301382089133	0.0
40135769274	1	0.49832429407106255	0.0	0	1	0.49832429407106255	0.0
40135769275	2	0.9966975433540657	0.0	0	2	0.49834877167703284	0.0
40135769276	2	0.9968077767542675	0.0	0	2	0.49840388837713373	0.0
40135769277	4	2.9296782959088024	0.0	0	4	0.7324195739772006	0.0
40135769278	1	0.49843008311914866	0.0	0	1	0.49843008311914866	0.0
40135769279	7	4.324364035939051	0.0	0	7	0.7207273393231751	0.0
40135769280	2	0.9972373637894458	0.0	0	2	0.4986186818947229	0.0
40135769281	4	2.7827478466188094	0.0	0	4	0.6956869616547023	0.0
40135769282	3	1.893954795619229	0.0	0	3	0.6313182652064097	0.0
40135769283	2	1.4651149503055778	0.0	0	2	0.7325574751527889	0.0
40135769284	2	0.9973821082572123	0.0	0	2	0.49869105412860615	0.0
40135769285	1	0.49870671036901354	0.0	0	1	0.49870671036901354	0.0
40135769286	1	0.49871792225730527	0.0	0	1	0.49871792225730527	0.0
40135769287	2	0.9974743622329463	0.0	0	2	0.49873718111647314	0.0
40135769288	6	4.5000678942124335	0.0	0	6	0.7500113157020722	0.0
40135769289	4	1.0004829865992346	2.0	2	2	0.5002414932996173	1.0
40135769290	17	6.432196442248994	5.0	5	12	0.5360163701874162	0.4166666666666667
40135769291	3	1.000389352180798	1.0	1	2	0.500194676090399	0.5
40135769292	2	0.5002046590479922	1.0	1	1	0.5002046590479922	1.0
40135769293	7	2.501261573118161	2.0	2	5	0.5002523146236322	0.4
40135769294	3	1.0005583722385296	1.0	1	2	0.5002791861192648	0.5
40135769295	42	25.26784739859108	7.0	7	35	0.7431719823115024	0.2
40135769296	20	11.967859421910326	3.0	3	17	0.7039917307006074	0.17647058823529413
40135769297	3	1.5013774966358442	0.0	0	3	0.5004591655452814	0.0
40135769298	46	32.074138156793175	1.0	2	44	0.8440562672840309	0.045454545454545456
40135769299	7	4.6691097696724615	0.0	0	7	0.778184961612077	0.0
40135769300	5	2.348470336491663	0.5	1	4	0.7828234454972209	0.25
40135769301	10	3.0632020203486006	1.0	2	8	0.6126404040697201	0.25
40135769302	19	6.031225613932532	7.0	7	12	0.5026021344943777	0.5833333333333334
40135769303	2	0.5007752195855055	1.0	1	1	0.5007752195855055	1.0
40135769304	2	0.5007835022417211	1.0	1	1	0.5007835022417211	1.0
40135769305	14	4.326783345948671	4.5	5	9	0.6181119065640959	0.5555555555555556
40135769306	2	1.0016292254130614	0.0	0	2	0.5008146127065307	0.0
40135769307	3	1.0016984495641958	1.0	1	2	0.5008492247820979	0.5
40135769308	45	25.95839773294946	9.0	9	36	0.7210666036930405	0.25
40135769309	4	1.0020937612171492	2.0	2	2	0.5010468806085746	1.0
40135769310	14	10.43663133328173	1.0	1	13	0.8028177948678253	0.07692307692307693
40135769311	3	2.2828494438347864	0.0	0	3	0.7609498146115955	0.0
40135769312	26	22.030721280975403	0.0	0	26	0.8473354338836694	0.0
40135769313	49	32.62906292485438	1.5	3	46	0.8366426390988303	0.06521739130434782
40135769314	2	1.3918265401691823	0.0	0	2	0.6959132700845911	0.0
40135769315	3	2.088299613439007	0.0	0	3	0.6960998711463356	0.0
40135769316	8	6.280053609660701	0.0	0	8	0.7850067012075876	0.0
40135769317	1	0.5015729134515959	0.0	0	1	0.5015729134515959	0.0
40135769318	3	1.7265960838456655	0.0	0	3	0.8632980419228328	0.0
40135769319	3	0.6411471519261704	0.5	1	2	0.6411471519261704	0.5
40135769320	1	0.5016146297566815	0.0	0	1	0.5016146297566815	0.0
40135769321	1	0.5016148991113552	0.0	0	1	0.5016148991113552	0.0
40135769322	2	0.769548625875348	0.0	0	2	0.769548625875348	0.0
40135769323	3	1.5391287325781817	0.0	0	3	0.7695643662890909	0.0
40135769324	3	1.028068474133046	1.0	1	2	0.514034237066523	0.5
40135769325	1	0.5023215847670774	0.0	0	1	0.5023215847670774	0.0
40135769326	6	1.1645435514016427	1.0	2	4	0.5822717757008213	0.5
40135769327	8	3.194462593150843	0.5	1	7	0.6388925186301686	0.14285714285714285
40135769328	20	6.558071908068442	7.0	7	13	0.5044670698514186	0.5384615384615384
40135769329	6	2.060188379251515	2.0	2	4	0.5150470948128788	0.5
40135769330	4	1.005066628750507	2.0	2	2	0.5025333143752535	1.0
40135769331	8	5.407497898107638	1.0	1	7	0.7724996997296626	0.14285714285714285
40135769332	8	3.1906428408541148	2.0	2	6	0.5317738068090191	0.3333333333333333
40135769333	2	1.005173023846609	0.0	0	2	0.5025865119233045	0.0
40135769334	3	1.0052346723975465	1.0	1	2	0.5026173361987732	0.5
40135769335	26	9.653761098633067	7.0	7	19	0.5080926894017403	0.3684210526315789
40135769336	5	3.68618928017556	0.0	0	5	0.7372378560351119	0.0
40135769337	7	5.0403035398220855	0.0	0	7	0.7200433628317265	0.0
40135769338	6	2.189413371446122	2.0	2	4	0.5473533428615305	0.5
40135769339	3	1.5084779551886078	0.0	0	3	0.5028259850628692	0.0
40135769340	4	1.0057029454977315	2.0	2	2	0.5028514727488658	1.0
40135769341	5	1.0241518551617967	1.0	2	3	0.5120759275808984	0.6666666666666666
40135769342	25	8.600916102180639	8.0	8	17	0.5059362413047435	0.47058823529411764
40135769343	7	4.296924033598359	0.0	0	7	0.6138462905140514	0.0
40135769344	3	1.5091023866608562	0.0	0	3	0.5030341288869521	0.0
40135769345	2	0.5030605929836407	1.0	1	1	0.5030605929836407	1.0
40135769346	12	5.206626145174021	2.0	2	10	0.5206626145174021	0.2
40135769347	23	8.152381750183844	7.0	7	16	0.5095238593864903	0.4375
40135769348	9	2.6947634118173367	4.0	4	5	0.5389526823634674	0.8
40135769349	3	1.5099051645964123	0.0	0	3	0.5033017215321375	0.0
40135769350	2	0.5033260756838822	1.0	1	1	0.5033260756838822	1.0
40135769351	29	9.639775833613157	10.0	10	19	0.5073566228217451	0.5263157894736842
40135769352	7	2.695652585264474	2.0	2	5	0.5391305170528948	0.4
40135769353	3	1.5104598668775129	0.0	0	3	0.5034866222925043	0.0
40135769354	3	1.0070309987162893	1.0	1	2	0.5035154993581447	0.5
40135769355	26	9.18960323282173	8.0	8	18	0.5105335129345405	0.4444444444444444
40135769356	10	5.016463126001725	2.0	2	8	0.6270578907502157	0.25
40135769357	1	0.5036267091690385	0.0	0	1	0.5036267091690385	0.0
40135769358	13	4.772737919889004	3.5	4	9	0.5965922399861255	0.4444444444444444
40135769359	7	3.5785906737223674	1.0	1	6	0.5964317789537279	0.16666666666666666
40135769360	3	1.5111316711029943	0.0	0	3	0.5037105570343314	0.0
40135769361	23	8.667696027998343	6.0	6	17	0.5098644722351966	0.35294117647058826
40135769362	7	2.5956101518025703	2.0	2	5	0.5191220303605141	0.4
40135769363	3	1.5116045232326318	0.0	0	3	0.5038681744108773	0.0
40377983817	3	0.4820835876911244	0.5	1	2	0.4820835876911244	0.5
40377983818	3	1.474009681347697	0.0	0	3	0.49133656044923235	0.0
40377983819	4	0.8966380395397173	1.0	1	3	0.2988793465132391	0.3333333333333333
40377983820	8	1.673091067434727	3.0	3	5	0.3346182134869454	0.6
40377983821	5	2.198538838435579	1.0	1	4	0.5496347096088947	0.25
40377983822	29	7.071831033005139	7.0	7	22	0.3214468651365972	0.3181818181818182
40377983823	2	0.2989744623823808	1.0	1	1	0.2989744623823808	1.0
40377983824	3	0.8335778007574725	1.0	1	2	0.4167889003787362	0.5
40377983825	9	1.4970013585913045	4.0	4	5	0.2994002717182609	0.8
40513297512	3	1.2463641411893902	0.0	0	3	0.41545471372979675	0.0
40513297513	4	0.4393935991296073	1.0	2	2	0.4393935991296073	1.0
40513297514	29	8.428171239674919	9.0	9	20	0.42140856198374593	0.45
40513297515	10	2.268232811459775	5.0	5	5	0.45364656229195505	1.0
40513297516	3	1.2468637941090583	0.0	0	3	0.41562126470301947	0.0
40513297517	1	0.41564463122096085	0.0	0	1	0.41564463122096085	0.0
40513297518	24	7.1603902370109	7.0	7	17	0.4211994257065235	0.4117647058823529
40513297519	1	0.41576038639197294	0.0	0	1	0.41576038639197294	0.0
40513297520	3	0.6037349661793221	0.5	1	2	0.6037349661793221	0.5
40513297521	2	1.1520746858558528	0.0	0	2	0.5760373429279264	0.0
40513297522	1	0.4157654704614386	0.0	0	1	0.4157654704614386	0.0
40513297523	8	2.587591496836581	2.0	2	6	0.4312652494727635	0.3333333333333333
40513297524	9	2.0792241454108513	4.0	4	5	0.41584482908217024	0.8
40513297525	4	0.8317476367578491	2.0	2	2	0.41587381837892456	1.0
40513297526	31	8.852530706685318	10.0	10	21	0.42154908127072943	0.47619047619047616
40513297527	1	0.41601445518791746	0.0	0	1	0.41601445518791746	0.0
40513297528	3	1.6224357224632742	0.0	0	3	0.8112178612316371	0.0
40513297529	4	1.2272765579247058	1.0	1	3	0.6136382789623529	0.3333333333333333
40513297530	1	0.416052636212911	0.0	0	1	0.416052636212911	0.0
40513297531	2	1.3913638225091418	0.0	0	2	0.6956819112545709	0.0
40513297532	2	0.41607893196292856	1.0	1	1	0.41607893196292856	1.0
40513297533	4	0.4263700313027167	1.0	2	2	0.4263700313027167	1.0
40513297534	31	9.319393297452374	9.0	9	22	0.42360878624783516	0.4090909090909091
40513297535	3	0.6946884638793868	0.5	1	2	0.6946884638793868	0.5
40513297536	1	0.4162808806295169	0.0	0	1	0.4162808806295169	0.0
40513297537	1	0.4162825977655616	0.0	0	1	0.4162825977655616	0.0
40513297538	2	0.41629209251780863	1.0	1	1	0.41629209251780863	1.0
40513297539	2	0.4163154253664158	1.0	1	1	0.4163154253664158	1.0
40513297540	1	0.4163171425024605	0.0	0	1	0.4163171425024605	0.0
40513297541	1	0.41632993684946007	0.0	0	1	0.41632993684946007	0.0
40513297542	1	0.41633050922814163	0.0	0	1	0.41633050922814163	0.0
40513297543	8	2.082144690798848	3.0	3	5	0.41642893815976956	0.6
40513297544	3	1.2492187283516702	0.0	0	3	0.4164062427838901	0.0
40752327754	52	14.427207320305833	15.0	15	37	0.3899245221704279	0.40540540540540543
40752327755	2	0.3837655628500916	1.0	1	1	0.3837655628500916	1.0
40752327756	1	0.3837767747383834	0.0	0	1	0.3837767747383834	0.0
40752327757	2	0.38381111745927704	1.0	1	1	0.38381111745927704	1.0
40752327758	11	2.1519273151800182	4.0	5	6	0.43038546303600367	0.8333333333333334
40752327759	5	1.3594020622534542	2.0	2	3	0.4531340207511514	0.6666666666666666
40752327760	2	0.3839613836978538	1.0	1	1	0.3839613836978538	1.0
40752327761	2	0.383992595170666	1.0	1	1	0.383992595170666	1.0
40752327762	1	0.384010439917797	0.0	0	1	0.384010439917797	0.0
40752327763	12	4.405041383483717	1.0	1	11	0.40045830758942885	0.09090909090909091
40752327764	2	0.3840599338390849	1.0	1	1	0.3840599338390849	1.0
40752327765	10	2.111232840718427	5.0	5	5	0.42224656814368544	1.0
40752327766	2	0.7682196299154325	0.0	0	2	0.38410981495771623	0.0
40752327767	3	0.7682846453997909	1.0	1	2	0.38414232269989546	0.5
40752327768	1	0.38417020090862086	0.0	0	1	0.38417020090862086	0.0
40752327769	38	9.67957204390737	13.0	13	25	0.38718288175629484	0.52
40752327770	8	2.17779169368771	4.0	4	4	0.5444479234219275	1.0
40979728428	6	0.15015587049925597	5.0	5	1	0.030031174099851194	5.0
40979728429	6	0.29541224682302053	3.0	4	2	0.09847074894100684	2.0
40979728430	14	0.13675295028382745	8.0	8	6	0.009768067877416246	1.3333333333333333
40979728431	1	0.0	1.0	1	0	0.0	inf
40979728432	7	0.15144510297547017	5.0	5	2	0.030289020595094036	2.5
40979728434	3	0.7383442909620362	2.0	2	1	0.3691721454810181	2.0
40979728435	15	2.070479545929972	8.0	8	7	0.2588099432412465	1.1428571428571428
40979728436	12	2.4629767792366066	5.0	5	7	0.30787209740457583	0.7142857142857143
40979728437	1	0.0	1.0	1	0	0.0	inf
40979728438	1	0.0	1.0	1	0	0.0	inf
40979728439	6	0.15034714598689985	5.0	5	1	0.03006942919737997	5.0
40979728441	1	0.0	1.0	1	0	0.0	inf
40979728442	10	0.06941684073431875	7.0	7	3	0.006941684073431875	2.3333333333333335
40979728443	2	0.0	2.0	2	0	0.0	inf
40979728444	1	0.0	1.0	1	0	0.0	inf
40979728445	1	0.0	1.0	1	0	0.0	inf
40979728446	6	0.1504380531892654	5.0	5	1	0.03008761063785308	5.0
40979728447	3	0.11806852362696707	1.0	1	2	0.039356174542322354	0.5
40979728448	15	0.10378545334596923	10.0	10	5	0.006919030223064615	2.0
40979728449	1	0.0	1.0	1	0	0.0	inf
40979728450	5	0.3043522631196517	4.0	4	1	0.060870452623930336	4.0
40979728452	2	0.0	2.0	2	0	0.0	inf
40979728453	20	3.740244352499478	8.0	8	12	0.18701221762497391	0.6666666666666666
40979728454	12	1.1719211422442841	6.0	6	6	0.16741730603489774	1.0
40979728455	9	0.570315458429702	5.0	5	4	0.1140630916859404	1.25
40979728456	8	5.75966081782072	0.0	0	8	0.71995760222759	0.0
40979728457	6	0.9475113934501764	3.0	3	3	0.2368778483625441	1.0
40979728458	2	0.6248805538282252	0.0	0	2	0.6248805538282252	0.0
40979728459	6	2.348438889333511	2.0	2	4	0.46968777786670224	0.5
40979728460	1	0.0	1.0	1	0	0.0	inf
40979728463	1	0.0	1.0	1	0	0.0	inf
40979728464	1	0.0	1.0	1	0	0.0	inf
40979728465	1	0.744184876698016	0.0	0	1	0.744184876698016	0.0
40979728466	2	0.0	2.0	2	0	0.0	inf
40979728467	8	0.5187560581653909	5.0	5	3	0.07410800830934157	1.6666666666666667
40979728468	1	0.0	1.0	1	0	0.0	inf
40979728469	13	0.062170492956425794	10.0	10	3	0.004782345612032753	3.3333333333333335
40979728470	9	0.3586710336690985	8.0	8	1	0.044833879208637316	8.0
40979728471	8	1.1252598557127618	3.0	3	5	0.22505197114255235	0.6
40979728472	8	0.14949019409260084	7.0	7	1	0.02135574201322869	7.0
40979728473	22	4.133496721633763	5.0	8	14	0.5166870902042203	0.5714285714285714
40979728474	8	0.3072133821327685	4.0	5	3	0.07680334553319212	1.6666666666666667
40979728475	1	0.5528050141180568	0.0	0	1	0.5528050141180568	0.0
40979728476	8	2.338373845903605	4.0	4	4	0.5845934614759013	1.0
40979728477	11	2.4800435290620397	6.0	6	5	0.41334058817700664	1.2
40979728478	4	0.3938419865149603	1.0	2	2	0.3938419865149603	1.0
40979728479	5	1.1511891486968098	2.0	2	3	0.3837297162322699	0.6666666666666666
40979728480	2	0.5528536326366553	1.0	1	1	0.5528536326366553	1.0
40979728481	3	1.6585203937009119	0.0	0	3	0.5528401312336373	0.0
40979728482	2	0.0	2.0	2	0	0.0	inf
40979728483	1	0.0	1.0	1	0	0.0	inf
40979728484	7	0.02103707138474598	6.0	6	1	0.0030052959121065685	6.0
40979728485	11	3.2616102217674467	5.0	5	6	0.4659443173953495	0.8333333333333334
40979728487	9	5.953397365448671	1.0	1	8	0.7441746706810839	0.125
40979728488	1	0.9542037460029871	0.0	0	1	0.9542037460029871	0.0
40979728489	3	1.8856372916427964	0.0	0	3	0.6285457638809321	0.0
40979728491	2	0.0	2.0	2	0	0.0	inf
40979728492	9	0.08698142533537265	5.0	5	4	0.009664602815041405	1.25
40979728493	8	0.43935612516063216	6.0	6	2	0.07322602086010536	3.0
40979728494	1	0.0	1.0	1	0	0.0	inf
40979728495	17	3.239978684617899	8.0	8	9	0.3239978684617899	0.8888888888888888
40979728497	3	0.7435825659783432	0.5	1	2	0.7435825659783432	0.5
40979728498	1	0.0	1.0	1	0	0.0	inf
40979728499	1	0.0	1.0	1	0	0.0	inf
40979728501	1	0.1054453515224953	0.0	0	1	0.1054453515224953	0.0
40979728503	10	0.10879986095911745	5.0	5	5	0.010879986095911745	1.0
40979728504	7	1.3538994156249347	4.0	4	3	0.22564990260415577	1.3333333333333333
40979728505	1	0.0	1.0	1	0	0.0	inf
40979728506	14	0.13407553115815743	8.0	8	6	0.009576823654154102	1.3333333333333333
40979728507	9	1.5810854367099512	3.0	3	6	0.2635142394516585	0.5
40979728508	13	0.203532371061517	8.0	8	5	0.025441546382689625	1.6
40979728509	7	0.07256953618168943	5.0	5	2	0.014513907236337886	2.5
40979728510	6	2.580583056574212	2.0	2	4	0.645145764143553	0.5
40979728511	7	0.868443608427394	3.0	3	4	0.1736887216854788	0.75
40979728512	8	2.075233655920347	3.0	3	5	0.3458722759867245	0.6
40979728513	16	2.0829762560151526	7.0	8	8	0.26037203200189407	1.0
40979728514	10	3.2954187113351887	4.0	4	6	0.47077410161931266	0.6666666666666666
40979728515	2	0.055952002613279046	1.0	1	1	0.055952002613279046	1.0
40979728516	2	0.2858750038761821	1.0	1	1	0.2858750038761821	1.0
40979728517	3	0.0	3.0	3	0	0.0	inf
40979728518	2	0.0	2.0	2	0	0.0	inf
40979728519	1	0.0	1.0	1	0	0.0	inf
40979728520	1	0.0	1.0	1	0	0.0	inf
40979728521	13	0.08969759786471776	9.0	9	4	0.006899815220362904	2.25
40979728522	5	0.23758206773953552	4.0	4	1	0.05939551693488388	4.0
40979728523	9	0.896284343183847	5.0	5	4	0.1493807238639745	1.25
40979728524	11	1.6599444381913009	4.0	4	7	0.2371349197416144	0.5714285714285714
40979728525	4	0.474794412520117	2.0	2	2	0.11869860313002925	1.0
40979728526	3	0.025609400639724084	2.0	2	1	0.025609400639724084	2.0
40979728527	1	0.0	1.0	1	0	0.0	inf
40979728528	7	0.16527636446071137	5.0	5	2	0.04131909111517784	2.5
40979728530	1	0.0	1.0	1	0	0.0	inf
40979728531	10	0.11442122566005952	5.0	5	5	0.011442122566005953	1.0
40979728532	5	0.0441889809898562	3.0	3	2	0.00883779619797124	1.5
40979728533	5	0.15460062664691443	4.0	4	1	0.03865015666172861	4.0
40979728535	1	0.0	1.0	1	0	0.0	inf
40979728536	5	4.788619374472928	0.0	0	5	0.9577238748945855	0.0
40979728537	14	0.09166419000655779	10.0	10	4	0.006547442143325556	2.5
40979728538	1	0.6676215851004038	0.0	0	1	0.6676215851004038	0.0
40979728539	2	0.20585878737805346	0.0	0	2	0.10292939368902673	0.0
40979728540	6	0.15479469668929774	5.0	5	1	0.030958939337859547	5.0
40979728542	4	0.5425811187693508	2.0	2	2	0.18086037292311694	1.0
40979728543	14	0.13973992526821916	8.0	8	6	0.009981423233444225	1.3333333333333333
40979728544	10	0.8444229963303456	5.0	5	5	0.1407371660550576	1.0
40979728545	5	3.027439968671358	1.0	1	4	0.7568599921678395	0.25
40979728546	15	1.6681608668264367	8.0	8	7	0.2085201083533046	1.1428571428571428
40979728547	1	0.8321926780174297	0.0	0	1	0.8321926780174297	0.0
40979728548	3	1.4489469023488637	1.0	1	2	0.7244734511744318	0.5
40979728549	1	0.8321997822469479	0.0	0	1	0.8321997822469479	0.0
40979728551	2	0.8321885703586562	1.0	1	1	0.4160942851793281	1.0
40979728552	4	0.0	4.0	4	0	0.0	inf
40979728554	1	0.0	1.0	1	0	0.0	inf
40979728555	11	0.09344216653815643	7.0	7	4	0.008494742412559675	1.75
40979728556	6	3.4799830926071333	1.0	1	5	0.5799971821011889	0.2
40979728557	1	0.44923097052158883	0.0	0	1	0.44923097052158883	0.0
40979728558	2	0.449262181994401	1.0	1	1	0.449262181994401	1.0
40979728559	6	3.8817385510880125	1.0	1	5	0.7763477102176025	0.2
40979728560	2	0.44928763601106336	1.0	1	1	0.44928763601106336	1.0
40979728561	4	0.19063725174463547	1.0	2	2	0.19063725174463547	1.0
40979728562	2	0.15105554877866678	1.0	1	1	0.15105554877866678	1.0
40979728564	1	0.0	1.0	1	0	0.0	inf
40979728565	7	0.09251737093542536	3.0	3	4	0.013216767276489337	0.75
40979728566	5	0.15522000771903155	4.0	4	1	0.03880500192975789	4.0
40979728568	19	8.433006223406066	4.0	4	15	0.49605918961212153	0.26666666666666666
40979728569	7	0.0	7.0	7	0	0.0	inf
40979728570	5	0.0	5.0	5	0	0.0	inf
40979728571	4	0.0	4.0	4	0	0.0	inf
40979728572	18	5.068244339839809	8.0	8	10	0.4607494854399826	0.8
40979728573	12	0.565484009978648	5.0	5	7	0.070685501247331	0.7142857142857143
40979728574	8	7.094213665662232	0.0	0	8	0.886776708207779	0.0
40979728575	14	1.0675413578108495	8.0	8	6	0.13344266972635618	1.3333333333333333
40979728576	6	0.0	6.0	6	0	0.0	inf
40979728577	7	4.52875642280428	1.0	1	6	0.7547927371340467	0.16666666666666666
40979728578	15	2.217612819289242	7.0	7	8	0.27720160241115527	0.875
40979728579	3	2.5393753941206003	0.0	0	3	0.8464584647068668	0.0
40979728580	3	1.3757165381446455	1.0	1	2	0.6878582690723227	0.5
40979728581	1	0.7602595595909675	0.0	0	1	0.7602595595909675	0.0
40979728582	3	1.3721770157165423	1.0	1	2	0.6860885078582711	0.5
40979728583	2	1.3117615704751184	0.0	0	2	0.6558807852375592	0.0
40979728585	2	0.0	2.0	2	0	0.0	inf
40979728586	11	0.04784961201311071	9.0	9	2	0.004349964728464609	4.5
40979728587	6	0.15543101343652221	5.0	5	1	0.031086202687304443	5.0
40979728588	1	0.0	1.0	1	0	0.0	inf
40979728589	7	0.5753940734631877	5.0	5	2	0.11507881469263755	2.5
40979728590	8	0.5775203255878489	5.0	5	3	0.14438008139696223	1.6666666666666667
40979728591	13	2.527382410944527	4.5	5	8	0.3159228013680659	0.625
40979728592	1	0.4940444166530278	0.0	0	1	0.4940444166530278	0.0
40979728593	5	2.6510357343754842	0.0	0	5	0.5302071468750968	0.0
40979728594	9	6.380561925700062	1.0	1	8	0.7975702407125077	0.125
40979728595	3	0.6403411754038645	1.0	1	2	0.32017058770193224	0.5
40979728596	2	0.6997289652265473	0.0	0	2	0.34986448261327363	0.0
40979728597	1	0.36238492957907237	0.0	0	1	0.36238492957907237	0.0
40979728599	2	1.1522680488422177	0.0	0	2	0.5761340244211088	0.0
40979728600	5	0.0	5.0	5	0	0.0	inf
40979728602	6	0.6530734698205091	1.0	2	4	0.32653673491025453	0.5
40979728603	6	0.9882021306156703	2.0	2	4	0.19764042612313407	0.5
40979728604	3	0.9600517726618272	0.0	0	3	0.3200172575539424	0.0
40979728605	31	10.607938043846024	5.0	5	26	0.40799761707100096	0.19230769230769232
40979728607	4	0.0	4.0	4	0	0.0	inf
40979728609	4	0.5234248837322134	2.0	2	2	0.2617124418661067	1.0
40979728610	1	0.0	1.0	1	0	0.0	inf
40979728612	20	6.574229215507542	4.0	4	16	0.4108893259692214	0.25
40979728613	6	0.12951697266087098	3.0	3	3	0.025903394532174197	1.0
40979728614	9	0.4686833610224327	4.0	4	5	0.09373667220448653	0.8
40979728615	3	0.7115612110011048	1.0	1	2	0.3557806055005524	0.5
40979728616	2	1.5041618832362977	0.0	0	2	0.7520809416181489	0.0
40979728618	2	0.5394603418508107	1.0	1	1	0.5394603418508107	1.0
40979728619	1	0.0	1.0	1	0	0.0	inf
40979728621	12	9.657610412605232	0.0	0	12	0.8048008677171027	0.0
40979728622	11	0.0	11.0	11	0	0.0	inf
40979728623	10	1.7291919558438802	5.0	5	5	0.28819865930731337	1.0
40979728624	9	1.9399695299259272	4.0	4	5	0.38799390598518546	0.8
40979728625	9	1.669102261410933	4.0	4	5	0.2781837102351555	0.8
40979728626	7	3.0774138799877457	2.0	2	5	0.6154827759975492	0.4
40979728627	2	0.1384512651706865	1.0	1	1	0.1384512651706865	1.0
40979728628	1	0.0	1.0	1	0	0.0	inf
40979728630	16	0.10079689590286964	12.0	12	4	0.006299805993929352	3.0
40979728631	2	0.24906024679554636	1.0	1	1	0.12453012339777318	1.0
40979728632	6	0.15562134618280826	5.0	5	1	0.031124269236561652	5.0
40979728633	4	0.18129242904280407	1.0	2	2	0.18129242904280407	1.0
40979728634	2	0.0	2.0	2	0	0.0	inf
40979728635	14	0.6907012739836347	6.0	6	8	0.08633765924795433	0.75
40979728636	11	1.158523272428987	5.0	5	6	0.14481540905362336	0.8333333333333334
40979728637	7	0.9935966650120434	3.0	3	4	0.19871933300240868	0.75
40979728638	16	3.46526413912546	4.5	6	10	0.4331580173906825	0.6
40979728639	10	6.305764860036409	2.0	2	8	0.7882206075045511	0.25
40979728640	4	0.13057109217630058	1.0	2	2	0.13057109217630058	1.0
40979728641	2	0.0	2.0	2	0	0.0	inf
40979728642	6	0.15582036561732035	5.0	5	1	0.03116407312346407	5.0
40979728644	1	0.0	1.0	1	0	0.0	inf
40979728645	1	0.0	1.0	1	0	0.0	inf
40979728647	13	0.05101429374345994	11.0	11	2	0.003924176441804611	5.5
40979728648	1	0.0	1.0	1	0	0.0	inf
40979728649	4	0.0	4.0	4	0	0.0	inf
40979728651	6	0.2887240355983177	3.0	3	3	0.07218100889957943	1.0
40979728652	3	0.3822133055350332	2.0	2	1	0.1911066527675166	2.0
40979728653	8	0.40624576923772326	5.0	5	3	0.08124915384754465	1.6666666666666667
40979728654	8	1.5881977131990221	4.0	4	4	0.39704942829975554	1.0
40979728655	15	2.6785335469630143	8.0	8	7	0.3348166933703768	1.1428571428571428
40979728656	8	6.972592757921495	0.0	0	8	0.8715740947401869	0.0
40979728657	2	0.0	2.0	2	0	0.0	inf
40979728658	2	0.0	2.0	2	0	0.0	inf
40979728659	6	0.157745106776738	5.0	5	1	0.0315490213553476	5.0
40979728660	2	0.6813560472497928	1.0	1	1	0.6813560472497928	1.0
40979728661	19	0.12951872346624987	14.0	14	5	0.006816774919276309	2.8
40979728662	13	2.1850773335786258	6.0	6	7	0.31215390479694655	0.8571428571428571
40979728663	4	0.10074309230680292	1.0	2	2	0.10074309230680292	1.0
40979728664	2	0.4531344247831619	1.0	1	1	0.4531344247831619	1.0
40979728665	4	0.4180975432261222	1.0	2	2	0.4180975432261222	1.0
40979728666	5	4.2316308445713435	0.0	0	5	0.8463261689142687	0.0
40979728667	1	0.45313671429788815	0.0	0	1	0.45313671429788815	0.0
40979728668	2	0.0	2.0	2	0	0.0	inf
40979728669	3	1.58551995738001	1.0	1	2	0.792759978690005	0.5
40979728670	6	0.15799250904450907	5.0	5	1	0.031598501808901815	5.0
40979728671	4	1.1958924287667154	2.0	2	2	0.5979462143833577	1.0
40979728672	12	1.8417564523996255	4.5	5	7	0.30695940873327093	0.7142857142857143
40979728673	14	1.1656295221072344	7.0	7	7	0.1457036902634043	1.0
40979728674	6	1.127342203025614	3.0	3	3	0.3757807343418713	1.0
40979728675	11	1.3874875730696101	5.0	5	6	0.23124792884493503	0.8333333333333334
40979728676	17	2.606230166868251	7.0	8	9	0.32577877085853135	0.8888888888888888
40979728677	1	0.7127906804090972	0.0	0	1	0.7127906804090972	0.0
40979728678	2	0.26853132377687644	1.0	1	1	0.26853132377687644	1.0
40979728679	4	0.9581049780885023	0.5	1	3	0.47905248904425113	0.3333333333333333
40979728680	3	1.1839110615109443	1.0	1	2	0.5919555307554721	0.5
40979728681	3	0.9228283708718913	0.0	0	3	0.3076094569572971	0.0
40979728682	19	0.15846394706210984	13.0	13	6	0.008340207740111044	2.1666666666666665
40979728683	4	1.3080457890824289	2.0	2	2	0.6540228945412144	1.0
40979728684	4	0.0	4.0	4	0	0.0	inf
40979728685	3	1.4679365415203327	1.0	1	2	0.7339682707601664	0.5
40979728686	7	1.4429519090461993	3.0	3	4	0.28859038180923985	0.75
40979728687	15	1.8217131650834055	7.0	7	8	0.2277141456354257	0.875
40979728688	12	2.0325007052883786	5.0	5	7	0.2540625881610473	0.7142857142857143
40979728689	14	2.5631273922693256	8.0	8	6	0.3203909240336657	1.3333333333333333
40979728690	14	3.3000994221769875	7.0	7	7	0.41251242777212344	1.0
40979728691	2	0.09600130529274863	1.0	1	1	0.09600130529274863	1.0
40979728692	2	0.7922564706315697	1.0	1	1	0.39612823531578484	1.0
40979728694	3	0.3070539915046209	1.0	1	2	0.15352699575231046	0.5
40979728695	1	0.8617855312568086	0.0	0	1	0.8617855312568086	0.0
40979728696	2	0.4800276371362925	1.0	1	1	0.4800276371362925	1.0
40979728697	6	0.15826277279020837	5.0	5	1	0.031652554558041675	5.0
40979728699	2	0.597691623712733	1.0	1	1	0.597691623712733	1.0
40979728700	11	0.8838199219901728	6.0	6	5	0.14730332033169546	1.2
40979728701	9	1.351156341297556	5.0	5	4	0.2702312682595112	1.25
40979728702	17	2.9218648218654852	7.0	8	9	0.36523310273318565	0.8888888888888888
40979728703	8	2.7206671161073857	3.0	3	5	0.5441334232214772	0.6
40979728704	3	0.7722274591130548	1.0	1	2	0.3861137295565274	0.5
40979728706	2	0.498100763361246	1.0	1	1	0.249050381680623	1.0
40979728707	1	0.1900461529132543	0.0	0	1	0.1900461529132543	0.0
40979728708	14	0.10679603053364177	10.0	10	4	0.0076282878952601265	2.5
40979728709	4	0.0	4.0	4	0	0.0	inf
40979728710	6	2.529886736023026	2.0	2	4	0.6324716840057565	0.5
40979728711	8	0.7683875052158008	4.0	4	4	0.15367750104316016	1.0
40979728712	13	3.321177233456126	5.0	5	8	0.41514715418201575	0.625
40979728713	9	3.8086595642103998	0.6666666666666666	2	7	0.76173191284208	0.2857142857142857
40979728714	2	1.3960686069249	0.0	0	2	0.69803430346245	0.0
40979728716	5	2.07641241931102	1.0	1	4	0.6921374731036734	0.25
40979728717	4	0.8535100466094694	1.0	1	3	0.28450334886982315	0.3333333333333333
40979728718	1	0.0	1.0	1	0	0.0	inf
40979728719	1	0.9471114690984366	0.0	0	1	0.9471114690984366	0.0
40979728721	3	0.44641554079499424	2.0	2	1	0.1488051802649981	2.0
40979728722	6	1.5413777094260364	3.0	3	3	0.5137925698086788	1.0
40979728723	4	0.0	4.0	4	0	0.0	inf
40979728724	4	0.8019010514158679	2.0	2	2	0.40095052570793394	1.0
40979728725	17	0.05429186875141348	15.0	15	2	0.00319363933831844	7.5
40979728726	1	0.4538475749510524	0.0	0	1	0.4538475749510524	0.0
40979728727	1	0.0	1.0	1	0	0.0	inf
40979728728	2	0.0	2.0	2	0	0.0	inf
40979728729	2	0.0	2.0	2	0	0.0	inf
40979728730	5	0.8926462706145128	4.0	4	1	0.17852925412290258	4.0
40979728731	3	1.9241073678705058	1.0	1	2	0.641369122623502	0.5
40979728732	14	1.6478692681704223	6.0	6	8	0.2059836585213028	0.75
40979728733	7	0.9846631132275804	4.0	4	3	0.2461657783068951	1.3333333333333333
40979728734	10	2.2287944388495364	5.0	5	5	0.3714657398082561	1.0
40979728735	1	0.0	1.0	1	0	0.0	inf
40979728736	4	0.9101291734107746	2.0	2	2	0.4550645867053873	1.0
40979728737	2	0.22925244280278756	1.0	1	1	0.22925244280278756	1.0
40979728738	3	0.040737032500031904	2.0	2	1	0.040737032500031904	2.0
40979728740	1	0.22924449683991413	0.0	0	1	0.22924449683991413	0.0
40979728742	1	0.0	1.0	1	0	0.0	inf
40979728743	6	0.15968789469929193	5.0	5	1	0.03193757893985839	5.0
40979728744	2	0.0	2.0	2	0	0.0	inf
40979728745	1	0.8746563076450566	0.0	0	1	0.8746563076450566	0.0
40979728746	3	0.9087284617689928	1.0	1	2	0.4543642308844964	0.5
40979728748	2	0.5645349051166176	1.0	1	1	0.5645349051166176	1.0
40979728749	1	0.0	1.0	1	0	0.0	inf
40979728750	2	1.5835417493178676	0.0	0	2	0.7917708746589338	0.0
40979728751	1	0.0	1.0	1	0	0.0	inf
40979728752	5	0.15981223555052745	4.0	4	1	0.039953058887631863	4.0
40979728754	1	0.0	1.0	1	0	0.0	inf
40979728755	9	0.050321176829424115	7.0	7	2	0.005591241869936012	3.5
40979728756	14	1.823066436633286	7.0	7	7	0.22788330457916076	1.0
40979728757	12	1.297881050753929	6.0	6	6	0.21631350845898814	1.0
40979728758	13	5.087692050303198	3.5	4	9	0.6359615062878997	0.4444444444444444
40979728759	8	1.0178150171089038	4.0	4	4	0.20356300342178074	1.0
40979728760	2	0.6368342785606104	1.0	1	1	0.6368342785606104	1.0
40979728761	7	0.967716192562599	3.0	3	4	0.1612860320937665	0.75
40979728762	4	1.849725815460332	1.0	1	3	0.6165752718201106	0.3333333333333333
40979728763	1	0.13797709993701476	0.0	0	1	0.13797709993701476	0.0
40979728764	1	0.6123524639235609	0.0	0	1	0.6123524639235609	0.0
40979728765	2	0.0	2.0	2	0	0.0	inf
40979728766	6	0.10382531783767321	2.0	2	4	0.017304219639612203	0.5
40979728767	4	0.0	4.0	4	0	0.0	inf
40979728769	10	1.3949421320102542	5.0	5	5	0.23249035533504236	1.0
40979728770	16	0.1837434892345839	9.0	9	7	0.011483968077161493	1.2857142857142858
40979728771	10	1.0104824084967663	4.0	4	6	0.14435462978525232	0.6666666666666666
40979728772	8	0.9532787147149165	4.0	4	4	0.19065574294298332	1.0
40979728773	9	1.6985009435999259	4.0	5	4	0.3397001887199852	1.25
40979728774	12	0.7746893944997844	6.0	6	6	0.1106699134999692	1.0
40979728775	12	2.6030997605201267	5.0	5	7	0.32538747006501584	0.7142857142857143
40979728776	8	5.5408242192409665	1.0	1	7	0.7915463170344238	0.14285714285714285
40979728777	2	0.38520570128223264	1.0	1	1	0.38520570128223264	1.0
40979728778	7	4.419120956308753	1.0	1	6	0.7365201593847921	0.16666666666666666
40979728779	2	1.3459410624365145	0.0	0	2	0.6729705312182572	0.0
40979728780	3	0.7261673722131766	0.5	1	2	0.7261673722131766	0.5
40979728781	4	0.0	4.0	4	0	0.0	inf
40979728782	1	0.0	1.0	1	0	0.0	inf
40979728783	15	0.130824016214882	10.0	10	5	0.008721601080992132	2.0
40979728784	10	1.3780291163648217	5.0	5	5	0.22967151939413696	1.0
40979728785	3	0.9433907383136182	1.0	1	2	0.4716953691568091	0.5
40979728786	1	0.7819423751365165	0.0	0	1	0.7819423751365165	0.0
40979728788	2	0.41856807217169933	1.0	1	1	0.41856807217169933	1.0
40979728789	4	0.7932549010682168	0.5	1	3	0.3966274505341084	0.3333333333333333
40979728790	7	4.314122969229898	1.0	1	6	0.7190204948716498	0.16666666666666666
40979728792	8	0.1503925322494142	6.0	6	2	0.025065422041569033	3.0
40979728794	5	1.4802265218934676	1.5	2	3	0.49340884063115586	0.6666666666666666
40979728795	13	0.08027678347557561	10.0	10	3	0.006175137190428893	3.3333333333333335
40979728796	2	0.15856458470206192	1.0	1	1	0.15856458470206192	1.0
40979728797	4	1.9756908080394424	1.0	1	3	0.6585636026798142	0.3333333333333333
40979728799	1	0.0	1.0	1	0	0.0	inf
40979728801	2	1.5582691093589065	0.0	0	2	0.7791345546794533	0.0
40979728802	5	0.16103059407823075	4.0	4	1	0.04025764851955769	4.0
40979728804	1	0.0	1.0	1	0	0.0	inf
40979728805	5	0.05185080835189383	3.0	3	2	0.010370161670378766	1.5
40979728806	11	0.28768473058994026	5.0	5	6	0.03596059132374253	0.8333333333333334
40979728807	4	0.12640821569464364	2.0	2	2	0.03160205392366091	1.0
40979728808	7	0.7013505140314089	2.0	2	5	0.11689175233856815	0.4
40979728809	6	0.8390834102874025	3.0	3	3	0.20977085257185063	1.0
40979728810	8	1.9602177624794797	3.0	3	5	0.4900544406198699	0.6
40979728811	1	0.0	1.0	1	0	0.0	inf
40979728813	1	0.0	1.0	1	0	0.0	inf
40979728814	2	0.1930155525051887	1.0	1	1	0.1930155525051887	1.0
40979728818	2	0.0	2.0	2	0	0.0	inf
40979728819	9	0.1070667993193542	5.0	5	4	0.0118963110354838	1.25
40979728820	4	0.0	4.0	4	0	0.0	inf
40979728822	1	0.0	1.0	1	0	0.0	inf
40979728823	16	0.1893388948788505	9.0	9	7	0.011833680929928156	1.2857142857142858
40979728824	3	1.3327592150695051	1.0	1	2	0.6663796075347526	0.5
40979728825	3	0.2762372242973942	2.0	2	1	0.2762372242973942	2.0
40979728826	4	1.6354678086317196	1.0	1	3	0.5451559362105732	0.3333333333333333
40979728829	1	0.0	1.0	1	0	0.0	inf
40979728830	2	0.0	2.0	2	0	0.0	inf
40979728831	4	0.0	4.0	4	0	0.0	inf
40979728832	1	0.0	1.0	1	0	0.0	inf
40979728833	12	0.1085286544720603	8.0	8	4	0.009044054539338358	2.0
40979728834	9	1.534984542577011	5.0	5	4	0.21928350608243014	1.25
40979728835	9	0.053413435821888816	7.0	7	2	0.005934826202432091	3.5
40979728836	2	0.01747334070534629	1.0	1	1	0.01747334070534629	1.0
40979728837	9	1.416036239247151	5.0	5	4	0.2832072478494302	1.25
40979728838	1	0.0	1.0	1	0	0.0	inf
40979728839	2	0.28278530375311733	1.0	1	1	0.14139265187655867	1.0
40979728840	1	0.0	1.0	1	0	0.0	inf
40979728841	2	0.5655714155702557	0.0	0	2	0.28278570778512785	0.0
40979728842	2	0.0	2.0	2	0	0.0	inf
40979728843	7	0.13844857162394975	2.0	2	5	0.019778367374849965	0.4
40979728844	6	0.16145247083587522	5.0	5	1	0.03229049416717504	5.0
40979728845	9	0.5955451026488776	4.0	4	5	0.09925751710814627	0.8
40979728846	1	0.38588878473467403	0.0	0	1	0.38588878473467403	0.0
40979728847	4	0.5806491831465993	2.0	2	2	0.29032459157329965	1.0
40979728848	15	0.1369252699363114	10.0	10	5	0.009128351329087427	2.0
40979728849	5	0.1627191111888349	4.0	4	1	0.04067977779720872	4.0
40979728850	2	0.027322092332290604	1.0	1	1	0.013661046166145302	1.0
40979728851	14	0.11103587511330151	10.0	10	4	0.007931133936664394	2.5
40979728852	13	0.2991012610950136	7.0	7	6	0.0373876576368767	1.1666666666666667
40979728853	8	4.684448777612936	1.0	1	7	0.6692069682304195	0.14285714285714285
40979728854	4	2.329480091272178	1.0	1	3	0.7764933637573926	0.3333333333333333
40979728855	2	0.4051361963288507	1.0	1	1	0.4051361963288507	1.0
40979728856	1	0.8047611940182926	0.0	0	1	0.8047611940182926	0.0
40979728857	4	2.059448428293594	0.0	0	4	0.686482809431198	0.0
40979728858	1	0.0	1.0	1	0	0.0	inf
40979728860	1	0.0	1.0	1	0	0.0	inf
40979728862	1	0.0	1.0	1	0	0.0	inf
40979728863	8	2.0142849557637135	3.0	3	5	0.2517856194704642	0.6
40979728865	1	0.0	1.0	1	0	0.0	inf
40979728866	14	0.1367076313599815	9.0	9	5	0.00976483081142725	1.8
40979728867	5	0.01936636535193865	4.0	4	1	0.004841591337984662	4.0
40979728868	13	1.401479403609696	7.0	7	6	0.175184925451212	1.1666666666666667
40979728869	8	1.0065893243901296	4.0	4	4	0.2516473310975324	1.0
40979728870	13	1.3905921887077295	7.0	7	6	0.1545102431897477	1.1666666666666667
40979728871	11	1.963880110638779	5.0	5	6	0.2805543015198256	0.8333333333333334
40979728872	2	0.1707892802361648	1.0	1	1	0.1707892802361648	1.0
40979728873	7	3.4798279779844306	1.0	1	6	0.5799713296640717	0.16666666666666666
40979728874	4	1.3797923793973708	0.5	1	3	0.6898961896986854	0.3333333333333333
40979728875	2	1.3867083299986662	0.0	0	2	0.6933541649993331	0.0
40979728876	2	0.8194730432704479	0.0	0	2	0.40973652163522395	0.0
40979728877	6	0.16296041930711405	5.0	5	1	0.03259208386142281	5.0
40979728879	14	0.11042346359336574	10.0	10	4	0.007887390256668982	2.5
40979728880	6	2.881763668411333	2.0	2	4	0.5763527336822666	0.5
40979728881	2	0.1346727241390305	1.0	1	1	0.1346727241390305	1.0
40979728882	14	0.47448138871997175	9.0	9	5	0.05272015430221908	1.8
40979728884	6	1.7723215985715044	1.5	2	4	0.5907738661905014	0.5
40979728885	10	0.04972926993402191	8.0	8	2	0.004972926993402191	4.0
40979728886	1	0.0	1.0	1	0	0.0	inf
40979728888	2	0.026413458009980063	1.0	1	1	0.013206729004990031	1.0
40979728889	1	0.0	1.0	1	0	0.0	inf
40979728890	2	0.0	2.0	2	0	0.0	inf
40979728891	3	0.16316206494969449	2.0	2	1	0.08158103247484724	2.0
40979728893	1	0.0	1.0	1	0	0.0	inf
40979728894	2	0.026213495834110114	1.0	1	1	0.013106747917055057	1.0
40979728895	14	7.864561971894389	0.0	0	14	0.6049663055303376	0.0
40979728896	8	0.02783709846835842	7.0	7	1	0.0034796373085448024	7.0
40979728897	8	0.963875127577316	4.0	4	4	0.240968781894329	1.0
40979728898	14	0.469059077122876	7.0	7	7	0.0586323846403595	1.0
40979728899	15	0.8345517872574835	7.0	7	8	0.10431897340718543	0.875
40979728900	44	2.492942789707028	16.0	16	28	0.08596354447265614	0.5714285714285714
40979728901	10	2.2287955836068996	5.0	5	5	0.4457591167213799	1.0
40979728902	1	0.8928748180551266	0.0	0	1	0.8928748180551266	0.0
40979728903	7	2.358642987113702	3.0	3	4	0.4717285974227404	0.75
40979728904	3	0.3278278697038516	2.0	2	1	0.1639139348519258	2.0
40979728905	1	0.0	1.0	1	0	0.0	inf
40979728907	1	0.6000546722648893	0.0	0	1	0.6000546722648893	0.0
40979728908	2	0.6722879864751631	0.0	0	2	0.33614399323758154	0.0
40979728909	9	0.08381745066104182	6.0	6	3	0.00931305007344909	2.0
40979728910	7	0.16326209654163076	6.0	6	1	0.02721034942360513	6.0
40979728912	2	0.026000503625901106	1.0	1	1	0.013000251812950553	1.0
40979728913	9	0.34849403970294623	5.0	5	4	0.06969880794058925	1.25
40979728914	8	0.5934206349989295	4.0	4	4	0.1186841269997859	1.0
40979728915	8	1.749334736042689	4.0	4	4	0.3498669472085378	1.0
40979728916	10	1.1708853725159984	6.0	6	4	0.19514756208599973	1.5
40979728917	16	2.6958928159640587	6.0	6	10	0.2695892815964059	0.6
40979728918	5	1.103349469137291	2.0	2	3	0.27583736728432273	0.6666666666666666
40979728919	2	0.8964194245526953	0.0	0	2	0.8964194245526953	0.0
40979728920	6	2.4523634306990996	2.0	2	4	0.6130908576747749	0.5
40979728921	6	1.3974588810730766	1.0	2	4	0.6987294405365383	0.5
40979728922	3	0.7444715710788096	1.0	1	2	0.3722357855394048	0.5
40979728923	4	1.4628358057342714	1.0	1	3	0.7314179028671357	0.3333333333333333
40979728924	1	0.8964606021484335	0.0	0	1	0.8964606021484335	0.0
40979728925	2	0.6288729624707796	1.0	1	1	0.6288729624707796	1.0
40979728926	2	1.7929304296944404	0.0	0	2	0.8964652148472202	0.0
40979728927	7	0.058081689010029657	5.0	5	2	0.008297384144289951	2.5
40979728928	5	0.16336680817102217	4.0	4	1	0.04084170204275554	4.0
40979728930	3	0.6535860517645138	1.0	1	2	0.21786201725483792	0.5
40979728931	1	0.0	1.0	1	0	0.0	inf
40979728932	13	0.1425902027557205	8.0	8	5	0.010968477135055424	1.6
40979728933	6	0.16347024036571361	5.0	5	1	0.032694048073142724	5.0
40979728935	2	0.0	2.0	2	0	0.0	inf
40979728936	14	0.11502888980387176	10.0	10	4	0.008216349271705125	2.5
40979728937	13	1.868764510851744	6.0	6	7	0.233595563856468	0.8571428571428571
40979728938	6	3.58461916801257	1.0	1	5	0.716923833602514	0.2
40979728939	6	4.005009559229022	1.0	1	5	0.8010019118458043	0.2
40979728940	5	1.5925589020591726	2.0	2	3	0.5308529673530575	0.6666666666666666
41198859143	1	0.3550706034154105	0.0	0	1	0.3550706034154105	0.0
41198859144	1	0.3550711757940921	0.0	0	1	0.3550711757940921	0.0
41198859145	2	0.35508181530370225	1.0	1	1	0.35508181530370225	1.0
41198859146	2	0.9288671679783622	0.0	0	2	0.4644335839891811	0.0
41198859147	3	1.0655676951088255	0.0	0	3	0.35518923170294187	0.0
41198859148	6	1.793649539334486	2.0	2	4	0.4484123848336215	0.5
41198859149	30	7.762328439170137	9.0	9	21	0.36963468757953033	0.42857142857142855
41198859150	2	0.8101626979668469	0.0	0	2	0.8101626979668469	0.0
41198859151	3	0.565828514606279	0.5	1	2	0.565828514606279	0.5
41198859152	3	0.7108000483626316	1.0	1	2	0.3554000241813158	0.5
41198859153	1	0.3553966909172291	0.0	0	1	0.3553966909172291	0.0
41198859154	1	0.35540177498669473	0.0	0	1	0.35540177498669473	0.0
41198859155	9	1.777425903306992	4.0	4	5	0.3554851806613984	0.8
41198859156	3	1.066442895782266	0.0	0	3	0.35548096526075534	0.0
41198859157	3	1.2480840717888118	1.0	1	2	0.6240420358944059	0.5
41198859158	28	6.956230101213048	9.0	9	19	0.3661173737480552	0.47368421052631576
41198859159	1	0.3556417700009397	0.0	0	1	0.3556417700009397	0.0
41220324007	9	0.9534375329643825	4.0	4	5	0.1906875065928765	0.8
41220324008	3	0.5720641426405384	0.0	0	3	0.19068804754684612	0.0
41220324009	3	0.38143981992023934	1.0	1	2	0.19071990996011967	0.5
41220324010	23	3.1788304599867403	7.0	7	16	0.19867690374917127	0.4375
41220324011	10	1.3846504939611186	3.0	3	7	0.19780721342301694	0.42857142857142855
41220324012	9	1.1068140099581094	4.0	4	5	0.2213628019916219	0.8
41220324013	3	0.5727148698628045	0.0	0	3	0.19090495662093485	0.0
41220324014	4	0.3818678918353784	2.0	2	2	0.1909339459176892	1.0
41220324015	31	4.136238314510436	10.0	10	21	0.19696372926240172	0.47619047619047616
41220324016	2	0.8463244719798245	0.0	0	2	0.8463244719798245	0.0
41220324017	8	6.54890071812313	0.0	0	8	0.8186125897653912	0.0
41220324018	3	0.36062570686662837	0.5	1	2	0.36062570686662837	0.5
41220324019	4	1.0488703315490047	1.0	1	3	0.5244351657745023	0.3333333333333333
41220324020	11	1.2990777598997354	5.0	5	6	0.21651295998328923	0.8333333333333334
41220324021	3	0.5734677835143963	0.0	0	3	0.1911559278381321	0.0
41220324022	4	0.38235212419997877	2.0	2	2	0.19117606209998939	1.0
41220324023	27	3.7348953053736227	8.0	8	19	0.1965734371249275	0.42105263157894735
41220324024	3	0.28807509285076466	0.5	1	2	0.28807509285076466	0.5
41220324025	9	6.376984121238962	1.0	1	8	0.7971230151548703	0.125
41220324026	1	0.19132481321852673	0.0	0	1	0.19132481321852673	0.0
41220324027	1	0.1913360251068185	0.0	0	1	0.1913360251068185	0.0
41220324028	2	0.19136727024896485	1.0	1	1	0.19136727024896485	1.0
41220324029	11	2.2967879084801504	4.0	4	7	0.3281125583543072	0.5714285714285714
41220324030	3	0.5742953420799305	0.0	0	3	0.19143178069331016	0.0
41220324031	2	0.1914550125339147	1.0	1	1	0.1914550125339147	1.0
41220324032	26	3.5232154268040956	8.0	8	18	0.19573419037800532	0.4444444444444444
41220324033	3	0.38314193944186414	1.0	1	2	0.19157096972093207	0.5
41220324034	1	0.19156868020620582	0.0	0	1	0.19156868020620582	0.0
41220324035	2	0.1915725521796399	1.0	1	1	0.1915725521796399	1.0
41220324036	1	0.19157282153431357	0.0	0	1	0.19157282153431357	0.0
41220324037	2	0.19157426931568458	1.0	1	1	0.19157426931568458	1.0
41220324038	1	0.19158211427055538	0.0	0	1	0.19158211427055538	0.0
41220324039	9	0.958262281217929	4.0	4	5	0.1916524562435858	0.8
41220324040	3	0.5749560690944568	0.0	0	3	0.19165202303148562	0.0
41220324041	10	1.6306851133766007	2.0	2	8	0.2038356391720751	0.25
41220324042	14	1.7143699405301918	4.666666666666666	6	8	0.2857283234216986	0.75
41220324043	4	2.520267373570051	0.0	0	4	0.6300668433925127	0.0
41220324044	7	1.6335632354034935	3.0	3	4	0.40839080885087337	0.75
41220324045	2	0.6311590765942674	0.0	0	2	0.6311590765942674	0.0
41220324046	2	1.183076398715892	0.0	0	2	0.591538199357946	0.0
41220324047	3	0.21386447965037225	0.5	1	2	0.21386447965037225	0.5
41220324048	2	0.38555801719540034	0.0	0	2	0.19277900859770017	0.0
41220324049	20	2.544245292951321	7.0	7	13	0.19571117638087085	0.5384615384615384
41220324050	9	1.11895150191661	4.0	4	5	0.223790300383322	0.8
41220324051	2	0.3837853604186068	0.0	0	2	0.1918926802093034	0.0
41220324052	2	0.19192385801278136	1.0	1	1	0.19192385801278136	1.0
41220324053	30	4.180560760741098	9.0	9	21	0.1990743219400523	0.42857142857142855
41220324054	10	1.1197123615310753	5.0	5	5	0.22394247230621506	1.0
41220324055	2	0.38412962936089845	0.0	0	2	0.19206481468044923	0.0
41220324056	4	0.38419336541055693	2.0	2	2	0.19209668270527847	1.0
41220324057	30	3.949524853305236	10.0	10	20	0.19747624266526181	0.5
41220324058	7	3.8026687122358434	0.5	1	6	0.7605337424471686	0.16666666666666666
41220324059	2	0.7176829020083993	0.0	0	2	0.7176829020083993	0.0
41220324060	3	1.8325573505762525	0.0	0	3	0.6108524501920841	0.0
41220324061	3	0.3630846120132791	0.5	1	2	0.3630846120132791	0.5
41220324062	2	0.19220486227609346	1.0	1	1	0.19220486227609346	1.0
41220324063	1	0.19220839755618546	0.0	0	1	0.19220839755618546	0.0
41220324064	2	0.19220866691085914	1.0	1	1	0.19220866691085914	1.0
41220324065	1	0.19221348162565108	0.0	0	1	0.19221348162565108	0.0
41220324066	9	0.9615158163212569	4.0	4	5	0.1923031632642514	0.8
41220324067	3	0.5769040420944791	0.0	0	3	0.19230134736482637	0.0
41220324068	3	0.3846620425427526	1.0	1	2	0.1923310212713763	0.5
41220324069	23	3.184372533405619	7.0	7	16	0.1990232833378512	0.4375
41220324070	11	2.3357198943038795	5.0	5	6	0.3892866490506466	0.8333333333333334
41220324071	3	2.105176872251509	0.0	0	3	0.7017256240838363	0.0
41220324072	8	3.150009745588787	2.0	2	6	0.5250016242647978	0.3333333333333333
41220324073	2	0.6027352226386408	0.0	0	2	0.6027352226386408	0.0
41220324074	4	0.7166549772349847	0.3333333333333333	1	3	0.7166549772349847	0.3333333333333333
41220324075	1	0.1924713887256955	0.0	0	1	0.1924713887256955	0.0
41220324076	2	0.9564121849724536	0.0	0	2	0.9564121849724536	0.0
41220324077	3	0.5570179905690175	0.5	1	2	0.5570179905690175	0.5
41220324078	2	0.19251596692418882	1.0	1	1	0.19251596692418882	1.0
41220324079	4	0.5781762042182491	1.0	1	3	0.19272540140608305	0.3333333333333333
41220324080	9	1.2068490361664876	3.0	3	6	0.20114150602774794	0.5
41220324081	11	1.4042996817204165	5.0	5	6	0.23404994695340275	0.8333333333333334
41220324082	3	0.40842771044116694	1.0	1	2	0.20421385522058347	0.5
41220324083	31	4.177962632897492	10.0	10	21	0.19895060156654723	0.47619047619047616
41220324084	3	1.3658711197817877	0.0	0	3	0.4552903732605959	0.0
41220324085	1	0.19274687121819725	0.0	0	1	0.19274687121819725	0.0
41220324086	3	0.38583595754929945	1.0	1	2	0.19291797877464972	0.5
41220324087	14	1.5138761595424095	4.5	6	8	0.25231269325706823	0.75
41220324088	4	0.38570700399927715	2.0	2	2	0.19285350199963858	1.0
41220324089	31	4.181982448378093	10.0	10	21	0.1991420213513378	0.47619047619047616
41220324090	8	1.7029851265379439	3.0	3	5	0.3405970253075888	0.6
41220324091	8	1.3118861806810278	4.0	4	4	0.32797154517025695	1.0
41220324092	12	2.0953340127580513	6.0	6	6	0.34922233545967524	1.0
41220324093	10	3.5312062035613603	2.5	3	7	0.5885343672602267	0.42857142857142855
41220324094	2	0.19297366785343215	1.0	1	1	0.19297366785343215	1.0
41220324095	1	0.19298151280830295	0.0	0	1	0.19298151280830295	0.0
41220324096	1	0.1930048456569101	0.0	0	1	0.1930048456569101	0.0
41220324097	1	0.19300511501158377	0.0	0	1	0.19300511501158377	0.0
41220324098	2	0.19302258939603847	1.0	1	1	0.19302258939603847	1.0
41220324099	11	1.3338155904303268	5.0	5	6	0.22230259840505448	0.8333333333333334
41220324100	3	0.40853727045468446	1.0	1	2	0.20426863522734223	0.5
41220324101	25	3.3364009912656023	8.0	8	17	0.19625888183915308	0.47058823529411764
41220324102	10	1.7035085500075637	5.0	5	5	0.3407017100015127	1.0
41220324103	11	2.611446220123979	2.0	3	8	0.43524103668732983	0.375
41220324104	6	3.8004206444600124	0.0	0	6	0.6334034407433354	0.0
41220324105	11	1.5494974397333228	4.5	5	6	0.30989948794666455	0.8333333333333334
41220324106	2	0.193245312041834	1.0	1	1	0.193245312041834	1.0
41220324107	11	1.334989269751534	5.0	5	6	0.22249821162525565	0.8333333333333334
41220324108	4	0.3866391058475317	2.0	2	2	0.19331955292376585	1.0
41220324109	15	2.4516425029150066	3.0	3	12	0.20430354190958389	0.25
41220324110	14	1.7678215237077397	5.0	5	9	0.1964246137453044	0.5555555555555556
41220324111	10	1.1428529582398912	3.5	4	6	0.22857059164797824	0.6666666666666666
41220324112	3	0.5807036601293502	0.0	0	3	0.1935678867097834	0.0
41220324113	3	0.38720185509950855	1.0	1	2	0.19360092754975428	0.5
41220324114	29	4.005208443986198	9.0	9	20	0.2002604221993099	0.45
41220324115	10	1.4376279792436635	5.0	5	5	0.2875255958487327	1.0
41220324116	3	0.6127443413044248	0.5	1	2	0.6127443413044248	0.5
41220324117	8	1.3083583751812293	1.0	2	6	0.32708959379530733	0.3333333333333333
41220324118	9	1.1011777634114468	3.5	4	5	0.2752944408528617	0.8
41220324119	4	1.153423580392286	1.0	1	3	0.576711790196143	0.3333333333333333
41220324120	2	0.1937192415901663	1.0	1	1	0.1937192415901663	1.0
41220324121	2	0.19372092505687677	1.0	1	1	0.19372092505687677	1.0
41220324122	1	0.19372930872109492	0.0	0	1	0.19372930872109492	0.0
41220324123	1	0.1937332480331974	0.0	0	1	0.1937332480331974	0.0
41220324124	14	1.9098455766087283	6.0	6	8	0.23873069707609104	0.75
41220324125	2	0.3875947088910644	0.0	0	2	0.1937973544455322	0.0
41220324126	4	0.38767558263183555	2.0	2	2	0.19383779131591777	1.0
41220324127	30	4.228903561161709	9.0	9	21	0.20137636005531948	0.42857142857142855
41220324128	12	1.149332991971177	5.0	6	6	0.2298665983942354	1.0
41220324129	2	0.3879620413272896	0.0	0	2	0.1939810206636448	0.0
41220324130	4	0.3880407602306713	2.0	2	2	0.19402038011533565	1.0
41220324131	22	2.7690320372805726	8.0	8	14	0.19778800266289803	0.5714285714285714
41220324132	9	1.4630241519898388	2.0	2	7	0.20900345028426268	0.2857142857142857
41220324133	10	1.145525394304098	5.0	5	5	0.2291050788608196	1.0
41220324134	2	0.3882851322583635	0.0	0	2	0.19414256612918174	0.0
41220324135	3	0.4086704663408171	1.0	1	2	0.20433523317040855	0.5
41220324136	30	3.988239907608653	10.0	10	20	0.19941199538043267	0.5
41220324137	3	0.38881488556281507	1.0	1	2	0.19440744278140754	0.5
41220324138	2	0.3886279870886184	0.0	0	2	0.1943139935443092	0.0
41220324139	6	1.2268745124049107	2.0	2	4	0.3067186281012277	0.5
41220324140	31	4.213881145970805	10.0	10	21	0.2006610069509907	0.47619047619047616
41220324141	3	0.3894001259300438	1.0	1	2	0.1947000629650219	0.5
41220324142	3	0.3892073353223605	1.0	1	2	0.19460366766118026	0.5
41220324143	29	3.7787783331235167	10.0	10	19	0.19888307016439563	0.5263157894736842
41220324144	4	0.6052990414306881	1.0	1	3	0.2017663471435627	0.3333333333333333
41220324145	2	0.19475430426243334	1.0	1	1	0.19475430426243334	1.0
41220324146	1	0.19477433751628795	0.0	0	1	0.19477433751628795	0.0
41220324147	4	0.793832633173917	1.0	1	3	0.3969163165869585	0.3333333333333333
41220324148	2	0.19480554898910013	1.0	1	1	0.19480554898910013	1.0
41220324149	1	0.1948167608773919	0.0	0	1	0.1948167608773919	0.0
41220324150	2	0.19483780421127278	1.0	1	1	0.19483780421127278	1.0
41220324151	10	1.1487807812208077	5.0	5	5	0.22975615624416154	1.0
41220324152	3	0.4088627182391531	1.0	1	2	0.20443135911957655	0.5
41220324153	27	4.975809526111865	4.0	4	23	0.21633954461355936	0.17391304347826086
41220324154	1	0.19504571235001616	0.0	0	1	0.19504571235001616	0.0
41220324155	1	0.19505817000367365	0.0	0	1	0.19505817000367365	0.0
41220324156	1	0.19507049297999432	0.0	0	1	0.19507049297999432	0.0
41220324157	1	0.19507833793486512	0.0	0	1	0.19507833793486512	0.0
41220324158	2	0.390175766382227	0.0	0	2	0.1950878831911135	0.0
41220324159	8	2.731376018215379	1.5	2	6	0.5462752036430758	0.3333333333333333
41220324160	1	0.19514032317914473	0.0	0	1	0.19514032317914473	0.0
41220324161	1	0.19516358868908346	0.0	0	1	0.19516358868908346	0.0
41220324162	4	0.39050182021471136	2.0	2	2	0.19525091010735568	1.0
41220324163	4	0.8786328917005327	0.0	0	4	0.21965822292513318	0.0
41220324164	2	0.39320459234904115	0.0	0	2	0.19660229617452057	0.0
41220324165	3	1.6412089014851108	0.0	0	3	0.5470696338283703	0.0
41220324166	1	0.19665352406652023	0.0	0	1	0.19665352406652023	0.0
41220324167	1	0.19667749663247736	0.0	0	1	0.19667749663247736	0.0
41220324168	2	0.6320408091185445	0.0	0	2	0.31602040455927227	0.0
41220324169	2	0.39339953779411385	0.0	0	2	0.19669976889705693	0.0
41220324170	5	2.0154709243919076	1.0	1	4	0.5038677310979769	0.25
41220324171	2	0.3934702097266195	0.0	0	2	0.19673510486330975	0.0
41220324172	1	0.19673668732201757	0.0	0	1	0.19673668732201757	0.0
41220324173	1	0.19675409436780386	0.0	0	1	0.19675409436780386	0.0
41220324174	4	1.2946062029620462	0.0	0	4	0.32365155074051155	0.0
41220324175	1	0.19677604677370844	0.0	0	1	0.19677604677370844	0.0
41220324176	6	1.1161871822393454	2.0	2	4	0.27904679555983636	0.5
41220324177	1	0.19681190461464151	0.0	0	1	0.19681190461464151	0.0
41220324178	3	0.43607568825927084	1.0	1	2	0.21803784412963542	0.5
41220324179	4	0.9974699178808306	1.0	1	3	0.3324899726269435	0.3333333333333333
41220324180	4	0.7708528748746196	1.0	1	3	0.25695095829153985	0.3333333333333333
41220324181	2	0.3937243458612324	0.0	0	2	0.1968621729306162	0.0
41220324182	3	1.9246615651115935	0.0	0	3	0.6415538550371979	0.0
41220324183	1	0.19689183561405474	0.0	0	1	0.19689183561405474	0.0
41220324184	1	0.19690601040375694	0.0	0	1	0.19690601040375694	0.0
41220324185	3	0.6461644551020607	0.0	0	3	0.2153881517006869	0.0
41220324186	1	0.19692210434550905	0.0	0	1	0.19692210434550905	0.0
41220324187	2	0.39386757520895943	0.0	0	2	0.19693378760447972	0.0
41220324188	3	1.3709941109977615	0.0	0	3	0.45699803699925384	0.0
41220324189	1	0.19696557145597346	0.0	0	1	0.19696557145597346	0.0
41220324190	1	0.19698291116309133	0.0	0	1	0.19698291116309133	0.0
41220324191	7	1.6817400123371176	2.0	2	5	0.3363480024674235	0.4
41220324192	7	2.3233988371352687	2.0	2	5	0.46467976742705375	0.4
41220324193	6	4.332164951320708	0.0	0	6	0.7220274918867847	0.0
41220324194	1	0.19705166394354703	0.0	0	1	0.19705166394354703	0.0
41220324195	3	1.3479648251078422	0.0	0	3	0.44932160836928076	0.0
41220324196	2	0.39415066697099255	0.0	0	2	0.19707533348549627	0.0
41220324197	2	0.3941937637187807	0.0	0	2	0.19709688185939034	0.0
41220324198	2	0.3942665568193415	0.0	0	2	0.19713327840967074	0.0
41220324199	1	0.19712388466542632	0.0	0	1	0.19712388466542632	0.0
41220324200	3	0.6730855456639167	0.0	0	3	0.2243618485546389	0.0
41220324201	5	2.00444340937429	0.0	0	5	0.5011108523435726	0.0
41220324202	2	0.3943444676587022	0.0	0	2	0.1971722338293511	0.0
41220324203	3	0.5546608004810136	1.0	1	2	0.2773304002405068	0.5
41220324204	2	0.3944634887551326	0.0	0	2	0.1972317443775663	0.0
41220324205	1	0.19723166020423077	0.0	0	1	0.19723166020423077	0.0
41220324206	1	0.1972523331754354	0.0	0	1	0.1972523331754354	0.0
41220324207	4	1.4406590610558696	0.0	0	4	0.4802196870186232	0.0
41220324208	1	0.19727745049875564	0.0	0	1	0.19727745049875564	0.0
41220324209	3	1.0243490227829275	0.0	0	3	0.34144967426097583	0.0
41220324210	2	0.3946146977350673	0.0	0	2	0.19730734886753365	0.0
41220324211	3	2.1223066847399163	0.0	0	3	0.7074355615799721	0.0
41220324212	1	0.19734435146582982	0.0	0	1	0.19734435146582982	0.0
41220324213	4	2.5452267203741927	0.0	0	4	0.6363066800935482	0.0
41220324214	3	2.1618252240349083	0.0	0	3	0.7206084080116361	0.0
41220324215	2	0.5674244410478072	0.0	0	2	0.2837122205239036	0.0
41220324216	1	0.19739290264575984	0.0	0	1	0.19739290264575984	0.0
41220324217	2	0.8972900461966834	0.0	0	2	0.4486450230983417	0.0
41220324218	1	0.1974262352866272	0.0	0	1	0.1974262352866272	0.0
41220324219	1	0.19744051108433203	0.0	0	1	0.19744051108433203	0.0
41220324220	1	0.19748987032828308	0.0	0	1	0.19748987032828308	0.0
41220324221	1	0.1974981193151644	0.0	0	1	0.1974981193151644	0.0
41220324222	1	0.1975063683020457	0.0	0	1	0.1975063683020457	0.0
41220324223	2	1.0751975623940742	0.0	0	2	0.5375987811970371	0.0
41220324224	4	1.7970299741584492	0.0	0	4	0.4492574935396123	0.0
41220324225	1	0.19754390960968926	0.0	0	1	0.19754390960968926	0.0
41220324226	6	4.7087639963843175	0.0	0	6	0.7847939993973863	0.0
41220324227	1	0.19759316784563768	0.0	0	1	0.19759316784563768	0.0
41220324228	8	2.1504429015733915	2.0	2	6	0.3584071502622319	0.3333333333333333
41220324229	3	1.9007291666701738	0.0	0	3	0.633576388890058	0.0
41220324230	3	0.8844649927642917	0.0	0	3	0.2948216642547639	0.0
41220324231	1	0.19766915953294842	0.0	0	1	0.19766915953294842	0.0
41220324232	1	0.19769420951760025	0.0	0	1	0.19769420951760025	0.0
41220324233	1	0.19773148147057013	0.0	0	1	0.19773148147057013	0.0
41220324234	1	0.19775104335374583	0.0	0	1	0.19775104335374583	0.0
41220324235	4	1.815923925082095	0.0	0	4	0.4539809812705238	0.0
41220324236	1	0.19778084071452118	0.0	0	1	0.19778084071452118	0.0
41220324237	2	0.3986369037383971	0.0	0	2	0.19931845186919855	0.0
41220324238	30	11.011877025989056	8.0	8	22	0.5005398648176844	0.36363636363636365
41220324239	13	3.5875748978548154	1.0	1	12	0.2989645748212346	0.08333333333333333
41220324240	27	4.615925824032545	4.0	4	23	0.2006924271318498	0.17391304347826086
41220324241	2	0.4010729137377853	0.0	0	2	0.20053645686889265	0.0
41220324242	1	0.20054825797053308	0.0	0	1	0.20054825797053308	0.0
41220324243	18	3.020028472809168	3.0	3	15	0.20133523152061122	0.2
41220324244	3	1.4376247469875794	0.0	0	3	0.4792082489958598	0.0
41220324245	2	0.402985601275556	0.0	0	2	0.201492800637778	0.0
41220324246	1	0.20150359165939213	0.0	0	1	0.20150359165939213	0.0
41220324247	5	4.08537395031221	0.0	0	5	0.817074790062442	0.0
41220324248	2	0.5893787997737555	0.0	0	2	0.5893787997737555	0.0
41220324249	2	0.8800236708887226	0.0	0	2	0.8800236708887226	0.0
41220324250	4	0.6484612087351587	0.5	1	3	0.32423060436757933	0.3333333333333333
41220324251	3	0.5213080590211308	0.5	1	2	0.5213080590211308	0.5
41220324252	1	0.20269437500237789	0.0	0	1	0.20269437500237789	0.0
41220324253	2	0.20270733769604854	1.0	1	1	0.20270733769604854	1.0
41220324254	1	0.20271073829880368	0.0	0	1	0.20271073829880368	0.0
41220324255	7	1.1565841207945275	2.0	2	5	0.2313168241589055	0.4
41220324256	5	3.6822076457199526	0.0	0	5	0.7364415291439905	0.0
41220324257	1	0.20305510824909798	0.0	0	1	0.20305510824909798	0.0
41220324258	3	0.4904450638180345	1.0	1	2	0.24522253190901724	0.5
41220324259	3	1.1133984186254446	1.0	1	2	0.5566992093127223	0.5
41220324260	3	0.45371286394488036	1.0	1	2	0.22685643197244018	0.5
41220324261	2	1.105983791515173	0.0	0	2	0.5529918957575864	0.0
41220324262	19	10.141985602521325	0.0	0	19	0.5965873883836074	0.0
41220324263	13	2.047228816828957	3.0	3	10	0.2047228816828957	0.3
41478691536	22	7.0659865079570565	7.0	7	15	0.4710657671971371	0.4666666666666667
41478691537	3	0.20853115610359205	0.0	0	3	0.06951038536786401	0.0
41478691538	3	0.17996515021893317	1.0	1	2	0.08998257510946658	0.5
41478691539	23	1.2403395188726214	7.0	7	16	0.07752121992953884	0.4375
41478691540	4	0.13923552497242733	2.0	2	2	0.06961776248621367	1.0
41478691541	33	7.703063239393309	13.5	14	19	0.42794795774407274	0.7368421052631579
41478691542	3	0.17990966315615597	1.0	1	2	0.08995483157807799	0.5
41478691543	31	1.6793674016940456	10.0	10	21	0.07996987627114503	0.47619047619047616
41478691544	10	1.7773811230924932	5.0	5	5	0.35547622461849865	1.0
41478691545	2	0.06977956047175721	1.0	1	1	0.06977956047175721	1.0
41478691546	11	2.7354066415522613	5.0	5	6	0.4559011069253769	0.8333333333333334
41478691547	1	0.0697834661145255	0.0	0	1	0.0697834661145255	0.0
41478691548	2	0.0697806378904519	1.0	1	1	0.0697806378904519	1.0
41478691549	3	0.13958215076811367	1.0	1	2	0.06979107538405684	0.5
41478691550	2	0.06981117597657988	1.0	1	1	0.06981117597657988	1.0
41478691551	1	0.06980784271249314	0.0	0	1	0.06980784271249314	0.0
41478691552	10	0.5301994231298293	5.0	5	5	0.10603988462596585	1.0
41668390057	28	1.3101299882086626	10.0	10	18	0.0727849993449257	0.5555555555555556
41668390058	8	1.6836542823335958	3.0	3	5	0.3367308564667192	0.6
41668390059	5	0.9109123557938208	0.5	1	4	0.4554561778969104	0.25
41668390060	5	0.4549860698180109	1.5	2	3	0.22749303490900544	0.6666666666666666
41668390061	7	1.5285025560243413	1.5	2	5	0.3821256390060853	0.4
41668390062	2	0.6627928301960865	0.0	0	2	0.6627928301960865	0.0
41668390063	2	0.6627930995507602	0.0	0	2	0.6627930995507602	0.0
41668390064	9	0.3400142495356241	4.0	4	5	0.06800284990712482	0.8
41668390065	2	0.13599121526667274	0.0	0	2	0.06799560763333637	0.0
43229255399	7	6.419137521621185	0.0	0	7	0.9170196459458835	0.0
43229255400	1	0.892043017153482	0.0	0	1	0.892043017153482	0.0
43229255401	1	0.8921129820299692	0.0	0	1	0.8921129820299692	0.0
43229255402	1	0.8921245979502715	0.0	0	1	0.8921245979502715	0.0
43229255403	1	0.8921362138705738	0.0	0	1	0.8921362138705738	0.0
43738941003	3	0.5739140705393426	0.5	1	2	0.5739140705393426	0.5
43738941004	1	0.3847194487575797	0.0	0	1	0.3847194487575797	0.0
43738941005	2	0.3847569227265548	1.0	1	1	0.3847569227265548	1.0
43738941006	9	2.1148995658911733	4.0	4	5	0.4229799131782347	0.8
43738941007	2	0.384827358973721	1.0	1	1	0.384827358973721	1.0
43738941008	1	0.38492415830957316	0.0	0	1	0.38492415830957316	0.0
43738941009	4	1.1193115281073118	1.0	1	3	0.5596557640536559	0.3333333333333333
43738941010	1	0.3849386697926174	0.0	0	1	0.3849386697926174	0.0
43738941011	1	0.384939242171299	0.0	0	1	0.384939242171299	0.0
43738941012	4	0.7699584153420113	2.0	2	2	0.38497920767100563	1.0
43738941013	9	1.9251583898071885	4.0	4	5	0.38503167796143767	0.8
43738941014	2	0.7700433967415559	0.0	0	2	0.38502169837077793	0.0
43738941015	3	0.7701136309727168	1.0	1	2	0.3850568154863584	0.5
43738941016	25	6.64514151339011	8.0	8	17	0.3908906772582417	0.47058823529411764
43738941017	6	1.3854196025624652	0.5	1	5	0.6927098012812326	0.2
43738941018	4	0.6629493926001605	0.3333333333333333	1	3	0.6629493926001605	0.3333333333333333
43738941019	3	0.3865239903938696	0.5	1	2	0.3865239903938696	0.5
43738941020	2	0.38522219925599527	1.0	1	1	0.38522219925599527	1.0
43738941021	1	0.385232771426937	0.0	0	1	0.385232771426937	0.0
43738941022	4	0.7788885665237191	2.0	2	2	0.38944428326185954	1.0
43738941023	2	0.38528037986550917	1.0	1	1	0.38528037986550917	1.0
43738941024	10	2.117473418144815	5.0	5	5	0.42349468362896303	1.0
43738941025	4	0.770710520929582	2.0	2	2	0.385355260464791	1.0
43738941026	31	8.26983159979471	10.0	10	21	0.39380150475212905	0.47619047619047616
43738941027	14	6.825919542344861	3.0	3	11	0.6205381402131692	0.2727272727272727
43738941028	3	1.1565866123252593	0.0	0	3	0.3855288707750864	0.0
43738941029	29	7.43436400664673	10.0	10	19	0.3912823161393016	0.5263157894736842
43738941030	1	0.38568266107064375	0.0	0	1	0.38568266107064375	0.0
43738941031	9	1.9288352494495318	4.0	4	5	0.38576704988990634	0.8
43738941032	3	1.1573089542213888	0.0	0	3	0.3857696514071296	0.0
43738941033	4	0.7715941389365749	2.0	2	2	0.38579706946828746	1.0
43738941034	13	3.9962749932097372	3.0	3	10	0.39962749932097374	0.3
43738941035	19	4.702533553427527	7.0	7	12	0.39187779611896056	0.5833333333333334
43738941036	3	1.1579650685371283	0.0	0	3	0.38598835617904276	0.0
43738941037	2	0.3860122501832201	1.0	1	1	0.3860122501832201	1.0
43738941038	27	7.479799056026345	8.0	8	19	0.3936736345277024	0.42105263157894735
43738941039	1	0.3861706307313414	0.0	0	1	0.3861706307313414	0.0
43738941040	2	0.6623111903702202	0.0	0	2	0.6623111903702202	0.0
43738941041	3	0.7723618334258848	1.0	1	2	0.3861809167129424	0.5
43738941042	6	1.7889037120003262	0.5	1	5	0.5963012373334421	0.2
43738941043	2	0.3862121113510874	1.0	1	1	0.3862121113510874	1.0
43738941044	1	0.3862233232393792	0.0	0	1	0.3862233232393792	0.0
43738941045	5	1.1591184115804731	2.0	2	3	0.3863728038601577	0.6666666666666666
43738941046	14	2.502497540707656	3.0	5	9	0.5004995081415312	0.5555555555555556
43738941047	4	0.7726658338444619	2.0	2	2	0.38633291692223093	1.0
43738941048	31	8.747066197311659	9.0	9	22	0.39759391805962085	0.4090909090909091
43738941049	1	0.38645857087750063	0.0	0	1	0.38645857087750063	0.0
43738941050	2	0.38646978276579236	1.0	1	1	0.38646978276579236	1.0
43738941051	1	0.3864933849690732	0.0	0	1	0.3864933849690732	0.0
43738941052	4	0.7730972390236877	2.0	2	2	0.3865486195118438	1.0
43738941053	9	2.130310457860185	4.0	4	5	0.426062091572037	0.8
43738941054	3	0.7731780790951246	1.0	1	2	0.3865890395475623	0.5
43738941055	31	8.294568291291727	10.0	10	21	0.3949794424424632	0.47619047619047616
43738941056	4	0.773542751653947	2.0	2	2	0.3867713758269735	1.0
43738941057	10	2.131472925293101	3.5	4	6	0.42629458505862017	0.6666666666666666
43738941058	3	0.8088150491957793	1.0	1	2	0.40440752459788964	0.5
43738941059	20	5.45181633768753	6.0	6	14	0.3894154526919665	0.42857142857142855
43738941060	4	0.7739673892969967	2.0	2	2	0.38698369464849836	1.0
43738941061	13	4.043074391350186	3.0	3	10	0.4043074391350186	0.3
43738941062	3	0.7740589362167123	1.0	1	2	0.38702946810835614	0.5
43738941063	1	0.3870485586208529	0.0	0	1	0.3870485586208529	0.0
43738941064	2	0.9572038520277205	0.0	0	2	0.9572038520277205	0.0
43738941065	5	1.9807391206721396	0.5	1	4	0.6602463735573799	0.25
43738941066	3	0.7608760787696768	0.5	1	2	0.7608760787696768	0.5
43738941067	1	0.3871374793325001	0.0	0	1	0.3871374793325001	0.0
43738941068	22	5.912358184343443	7.0	7	15	0.39415721228956285	0.4666666666666667
43738941069	9	2.133738703138726	4.0	4	5	0.42674774062774523	0.8
43738941070	3	1.1616982906449385	0.0	0	3	0.3872327635483128	0.0
43738941071	4	0.7745105093271295	2.0	2	2	0.38725525466356475	1.0
43738941072	30	8.343459464158606	9.0	9	21	0.3973075935313622	0.42857142857142855
43738941073	9	1.9371195554624334	4.0	4	5	0.3874239110924867	0.8
43738941074	3	1.1622675044090836	0.0	0	3	0.38742250146969454	0.0
43738941075	4	0.7749022183613223	2.0	2	2	0.38745110918066117	1.0
43738941076	27	7.0787524717079116	9.0	9	18	0.3932640262059951	0.5
43738941077	3	0.506289111771651	0.5	1	2	0.506289111771651	0.5
43738941078	2	0.8437908882498973	0.0	0	2	0.8437908882498973	0.0
43738941079	7	1.938039064979694	2.0	2	5	0.38760781299593877	0.4
43738941080	3	1.1628118028659133	0.0	0	3	0.38760393428863776	0.0
43738941081	8	4.084531745586295	2.0	2	6	0.6807552909310491	0.3333333333333333
43738941082	21	5.989472878627403	6.0	6	15	0.3992981919084935	0.4
43738941083	3	0.6847074254383335	0.5	1	2	0.6847074254383335	0.5
43738941084	4	2.8613370557251385	0.0	0	4	0.9537790185750462	0.0
43738941085	5	1.571291532428434	0.5	1	4	0.785645766214217	0.25
43738941086	6	2.8614296127248804	0.0	0	6	0.9538098709082935	0.0
43738941087	1	0.3878108323473549	0.0	0	1	0.3878108323473549	0.0
43738941088	4	1.6422931213853234	0.5	1	3	0.8211465606926617	0.3333333333333333
43738941089	13	3.594840639169213	4.0	4	9	0.3994267376854681	0.4444444444444444
43738941090	4	1.1637528270877335	1.0	1	3	0.3879176090292445	0.3333333333333333
43738941091	3	1.1637353527032788	0.0	0	3	0.38791178423442624	0.0
43738941092	3	0.8089465279458672	1.0	1	2	0.4044732639729336	0.5
43738941093	29	7.9355561535977515	9.0	9	20	0.3967778076798876	0.45
43738941094	7	4.336517958532646	1.0	1	6	0.7227529930887743	0.16666666666666666
43738941095	1	0.38804055821466604	0.0	0	1	0.38804055821466604	0.0
43738941096	1	0.3880511977242762	0.0	0	1	0.3880511977242762	0.0
43738941097	3	0.49889522497125227	0.5	1	2	0.49889522497125227	0.5
43738941098	1	0.3880568541724234	0.0	0	1	0.3880568541724234	0.0
43738941099	12	3.024126502153137	5.0	5	7	0.43201807173616247	0.7142857142857143
43738941100	3	1.1644036553180024	0.0	0	3	0.3881345517726675	0.0
43738941101	31	8.334477091839538	10.0	10	21	0.3968798615161685	0.47619047619047616
43738941102	2	0.3882229113287444	1.0	1	1	0.3882229113287444	1.0
43738941103	3	0.7767064233042701	1.0	1	2	0.38835321165213504	0.5
43738941104	11	2.1719891879687214	4.0	5	6	0.4343978375937443	0.8333333333333334
43738941105	1	0.38830058648276566	0.0	0	1	0.38830058648276566	0.0
43738941106	23	6.322936893869916	7.0	7	16	0.39518355586686976	0.4375
43738941107	2	0.38841078621363323	1.0	1	1	0.38841078621363323	1.0
43738941108	11	2.529120859677764	5.0	5	6	0.42152014327962734	0.8333333333333334
43738941109	4	0.7769984711092028	2.0	2	2	0.3884992355546014	1.0
43738941110	26	6.713944124460445	9.0	9	17	0.39493788967414384	0.5294117647058824
43738941111	2	0.38854199560904745	1.0	1	1	0.38854199560904745	1.0
43738941112	2	0.38857152361514913	1.0	1	1	0.38857152361514913	1.0
43738941113	9	2.1415135921250386	4.0	4	5	0.4283027184250077	0.8
43738941114	3	0.7773068822105615	1.0	1	2	0.3886534411052808	0.5
43738941115	32	8.769091766679459	10.0	10	22	0.3985950803036118	0.45454545454545453
43738941116	2	0.3887072110320132	1.0	1	1	0.3887072110320132	1.0
43738941117	2	0.38876249607878516	1.0	1	1	0.38876249607878516	1.0
43738941118	10	2.142596061219873	5.0	5	5	0.4285192122439746	1.0
43738941119	3	0.7776994666474437	1.0	1	2	0.38884973332372186	0.5
43738941120	1	0.38889505224756776	0.0	0	1	0.38889505224756776	0.0
43738941121	9	2.5327246231955383	3.0	3	6	0.42212077053258973	0.5
43738941122	3	1.1670609738511493	0.0	0	3	0.3890203246170498	0.0
43738941123	3	0.6631626541630431	0.5	1	2	0.6631626541630431	0.5
43738941124	1	0.38920326133292116	0.0	0	1	0.38920326133292116	0.0
43738941125	2	0.7812291912992919	0.0	0	2	0.39061459564964596	0.0
43738941126	1	0.3892337320803807	0.0	0	1	0.3892337320803807	0.0
43738941127	2	0.7812510090278596	0.0	0	2	0.3906255045139298	0.0
43738941128	3	0.7785242643275727	1.0	1	2	0.38926213216378636	0.5
43738941129	4	2.1659439600194164	0.0	0	4	0.5414859900048541	0.0
43738941130	3	1.2843536213405937	0.0	0	3	0.4281178737801979	0.0
43738941131	1	0.3893103971543756	0.0	0	1	0.3893103971543756	0.0
43738941132	4	2.390209099023094	0.0	0	4	0.5975522747557735	0.0
43738941133	2	0.7786769210888784	0.0	0	2	0.3893384605444392	0.0
43738941134	2	0.7802328820306998	0.0	0	2	0.3901164410153499	0.0
43738941135	3	0.7788163121325056	1.0	1	2	0.3894081560662528	0.5
43738941136	3	0.8098608523856592	1.0	1	2	0.4049304261928296	0.5
43738941137	2	1.132719397714869	0.0	0	2	0.5663596988574345	0.0
43738941138	2	0.7814949770235413	0.0	0	2	0.39074748851177066	0.0
43738941139	1	0.390748986797143	0.0	0	1	0.390748986797143	0.0
43738941140	1	0.39078130935798405	0.0	0	1	0.39078130935798405	0.0
43738941141	14	5.599183612919556	5.0	5	9	0.6221315125466174	0.5555555555555556
43738941142	1	0.3908058879719569	0.0	0	1	0.3908058879719569	0.0
43738941143	1	0.3908175038922592	0.0	0	1	0.3908175038922592	0.0
43738941144	5	1.5815976819606137	2.0	2	3	0.5271992273202045	0.6666666666666666
43738941145	1	0.39095049776238655	0.0	0	1	0.39095049776238655	0.0
43738941146	1	0.3909621136826888	0.0	0	1	0.3909621136826888	0.0
43738941147	2	1.2476308488810182	0.0	0	2	0.6238154244405091	0.0
43738941148	1	0.39098756769935117	0.0	0	1	0.39098756769935117	0.0
43738941149	1	0.39099581668623246	0.0	0	1	0.39099581668623246	0.0
43738941150	1	0.3910040656731138	0.0	0	1	0.3910040656731138	0.0
43738941151	1	0.3910216073962369	0.0	0	1	0.3910216073962369	0.0
43738941152	2	0.7821162435783742	0.0	0	2	0.3910581217891871	0.0
43738941153	1	0.3910700575681643	0.0	0	1	0.3910700575681643	0.0
43738941154	1	0.39109389545678463	0.0	0	1	0.39109389545678463	0.0
43738941155	1	0.3911055113770869	0.0	0	1	0.3911055113770869	0.0
43738941156	6	4.903505169606409	0.0	0	6	0.8172508616010682	0.0
43738941157	1	0.39115813654645626	0.0	0	1	0.39115813654645626	0.0
43738941158	1	0.3911697524667585	0.0	0	1	0.3911697524667585	0.0
43738941159	2	0.7825317905011873	0.0	0	2	0.39126589525059363	0.0
43738941160	2	0.7824828689585809	0.0	0	2	0.39124143447929044	0.0
43738941161	3	1.6494211551228042	0.0	0	3	0.5498070517076014	0.0
43738941162	1	0.39130944653439353	0.0	0	1	0.39130944653439353	0.0
43738941163	1	0.3913206584226853	0.0	0	1	0.3913206584226853	0.0
43738941164	1	0.3913784013308545	0.0	0	1	0.3913784013308545	0.0
43738941165	2	1.3535904658142288	0.0	0	2	0.6767952329071144	0.0
43738941166	2	0.7829248799780826	0.0	0	2	0.3914624399890413	0.0
43738941167	1	0.3914053031288879	0.0	0	1	0.3914053031288879	0.0
43738941168	1	0.3914165150171796	0.0	0	1	0.3914165150171796	0.0
43738941169	1	0.39143015109753443	0.0	0	1	0.39143015109753443	0.0
43738941170	3	1.296294181363303	0.0	0	3	0.4320980604544344	0.0
43738941171	2	1.354464824754314	0.0	0	2	0.677232412377157	0.0
43738941172	3	1.3783014339399076	0.0	0	3	0.4594338113133025	0.0
43738941173	2	0.7831938642890819	0.0	0	2	0.39159693214454094	0.0
43738941174	1	0.39156620887707483	0.0	0	1	0.39156620887707483	0.0
43738941175	4	2.4416954031628366	0.0	0	4	0.6104238507907092	0.0
43738941176	2	0.7832286110419862	0.0	0	2	0.3916143055209931	0.0
43738941177	1	0.3916028074433605	0.0	0	1	0.3916028074433605	0.0
43738941178	2	0.7833464873810534	0.0	0	2	0.3916732436905267	0.0
43738941179	1	0.39166307555159546	0.0	0	1	0.39166307555159546	0.0
43738941180	2	1.0913028507118219	0.0	0	2	0.5456514253559109	0.0
43738941181	2	0.7834620742053944	0.0	0	2	0.3917310371026972	0.0
43738941182	1	0.3917202797504173	0.0	0	1	0.3917202797504173	0.0
43738941183	1	0.3917314916387091	0.0	0	1	0.3917314916387091	0.0
43738941184	1	0.3918020962325463	0.0	0	1	0.3918020962325463	0.0
43738941185	1	0.391844654270987	0.0	0	1	0.391844654270987	0.0
43738941186	1	0.39185627019128927	0.0	0	1	0.39185627019128927	0.0
43738941187	2	0.7837396778659513	0.0	0	2	0.39186983893297567	0.0
43738941188	2	0.7838364772018036	0.0	0	2	0.3919182386009018	0.0
43738941189	1	0.39189603367499065	0.0	0	1	0.39189603367499065	0.0
43738941190	1	0.39192084797430304	0.0	0	1	0.39192084797430304	0.0
43738941191	2	0.7839387983084661	0.0	0	2	0.39196939915423307	0.0
43738941192	2	1.3454230597297019	0.0	0	2	0.6727115298648509	0.0
43738941193	2	0.3921879131332524	1.0	1	1	0.3921879131332524	1.0
43738941194	23	7.085284457221881	5.0	5	18	0.39362691429010455	0.2777777777777778
43738941195	2	0.39370437994604623	1.0	1	1	0.39370437994604623	1.0
43738941196	16	6.322147246974701	0.0	0	16	0.39513420293591883	0.0
43738941197	2	0.7885683991009345	0.0	0	2	0.39428419955046723	0.0
43738941198	2	0.7890610487990872	0.0	0	2	0.3945305243995436	0.0
43738941199	14	4.743783369887569	2.0	2	12	0.3953152808239641	0.16666666666666666
43738941200	25	8.390742488615642	4.0	4	21	0.3995591661245544	0.19047619047619047
43738941201	1	0.39690528988000484	0.0	0	1	0.39690528988000484	0.0
43738941202	2	0.7943005359114257	0.0	0	2	0.39715026795571284	0.0
43738941203	20	10.983441320427788	2.0	2	18	0.6101911844682104	0.1111111111111111
43738941204	1	0.3975978007460249	0.0	0	1	0.3975978007460249	0.0
43738941205	2	0.9453878685415862	0.0	0	2	0.9453878685415862	0.0
43738941206	1	0.39773722545898627	0.0	0	1	0.39773722545898627	0.0
43738941207	3	2.3294295872708637	0.0	0	3	0.7764765290902879	0.0
43738941208	25	8.3673203826035	4.0	4	21	0.39844382774302384	0.19047619047619047
43738941209	4	1.3247020760545143	0.5	1	3	0.6623510380272571	0.3333333333333333
43738941210	2	0.8098948247438765	0.0	0	2	0.8098948247438765	0.0
43738941211	2	0.809894252365195	0.0	0	2	0.809894252365195	0.0
43738941212	3	0.5107524870611274	0.5	1	2	0.5107524870611274	0.5
43738941213	2	1.2494960626575535	0.0	0	2	0.6247480313287768	0.0
43738941214	3	1.5854907997365846	0.0	0	3	0.7927453998682923	0.0
43738941215	3	0.6739168751948823	0.5	1	2	0.6739168751948823	0.5
43738941216	2	0.3987525915707408	1.0	1	1	0.3987525915707408	1.0
43738941217	3	0.4196362991381627	0.5	1	2	0.4196362991381627	0.5
43738941218	3	1.5352867248515412	0.0	0	3	0.5117622416171804	0.0
43738941219	1	0.3987658572884193	0.0	0	1	0.3987658572884193	0.0
43738941220	1	0.3987759244193479	0.0	0	1	0.3987759244193479	0.0
43738941221	3	0.7975584816975351	1.0	1	2	0.39877924084876754	0.5
43738941222	2	1.366765747661067	0.0	0	2	0.6833828738305335	0.0
43738941223	14	6.130056624749579	4.5	5	9	0.7662570780936974	0.5555555555555556
43738941224	2	0.39905746739200737	1.0	1	1	0.39905746739200737	1.0
43738941225	7	5.524443852462729	0.0	0	7	0.7892062646375326	0.0
43738941226	5	1.1272912949922893	0.5	1	4	0.5636456474961447	0.25
43738941227	1	0.3990736960110963	0.0	0	1	0.3990736960110963	0.0
43738941228	2	1.1376283866426076	0.0	0	2	0.5688141933213038	0.0
43738941229	3	0.6091769743369304	0.5	1	2	0.6091769743369304	0.5
43738941230	2	0.39963065413758914	1.0	1	1	0.39963065413758914	1.0
43738941231	2	0.3996309234922628	1.0	1	1	0.3996309234922628	1.0
43738941232	2	0.8706035972249331	0.0	0	2	0.43530179861246654	0.0
43738941233	2	0.40114883808642765	1.0	1	1	0.40114883808642765	1.0
43738941234	1	0.4011491074411013	0.0	0	1	0.4011491074411013	0.0
43738941235	3	0.47464077934811927	0.5	1	2	0.47464077934811927	0.5
43738941236	3	0.8670701016076534	1.0	1	2	0.4335350508038267	0.5
43738941237	2	0.8911552914877156	0.0	0	2	0.4455776457438578	0.0
43738941238	8	2.0456309375660444	1.0	2	6	0.5114077343915111	0.3333333333333333
43738941239	21	5.224184332601575	8.0	8	13	0.40186033327704423	0.6153846153846154
43738941240	3	0.8049610888554941	1.0	1	2	0.40248054442774706	0.5
43738941241	2	0.401862459624997	1.0	1	1	0.401862459624997	1.0
43738941242	2	0.8037995304946022	0.0	0	2	0.4018997652473011	0.0
43738941243	4	0.8038742764165472	2.0	2	2	0.4019371382082736	1.0
43738941244	42	15.980621884050421	12.0	12	30	0.532687396135014	0.4
43738941245	6	3.093899429766055	0.0	0	6	0.5156499049610092	0.0
43738941246	2	0.8042262219670386	0.0	0	2	0.4021131109835193	0.0
43738941247	33	20.904585147170504	3.0	3	30	0.6968195049056835	0.1
43738941248	33	23.35004198734323	0.0	0	33	0.7296888121044759	0.0
43738941249	5	3.034849107680153	0.0	0	5	0.7587122769200383	0.0
43738941250	17	5.837523644710815	1.0	2	15	0.6486137383012017	0.13333333333333333
43738941251	9	3.081524030292031	3.0	3	6	0.5135873383820052	0.5
43738941252	2	0.7447371547870537	0.0	0	2	0.7447371547870537	0.0
43738941253	4	1.6098982724836997	0.0	0	4	0.4024745681209249	0.0
43738941254	2	0.8049412239483106	0.0	0	2	0.4024706119741553	0.0
43738941255	5	1.6101482672902048	1.0	1	4	0.4025370668225512	0.25
43738941256	1	0.40294011400503904	0.0	0	1	0.40294011400503904	0.0
43738941257	5	1.2999969327236536	2.0	2	3	0.43333231090788454	0.6666666666666666
43738941258	22	7.259946990326835	4.0	4	18	0.4033303883514908	0.2222222222222222
43738941259	2	0.8066184618319545	0.0	0	2	0.40330923091597726	0.0
44074162341	1	0.20346580678778492	0.0	0	1	0.20346580678778492	0.0
44074162342	6	4.4622710363222415	0.0	0	6	0.7437118393870402	0.0
44074162343	3	0.7305357326415138	0.0	0	3	0.2435119108805046	0.0
44074162344	3	0.8740134253776614	0.0	0	3	0.29133780845922047	0.0
44074162345	2	0.4070196925538618	0.0	0	2	0.2035098462769309	0.0
44172855436	2	1.027639122783207	0.0	0	2	0.5138195613916035	0.0
44172855437	2	0.35566732502560466	1.0	1	1	0.35566732502560466	1.0
44172855438	10	1.9454383052042319	5.0	5	5	0.38908766104084636	1.0
44172855439	31	7.72213095775081	10.0	10	21	0.36772052179765763	0.47619047619047616
44172855440	2	0.3558594085772696	1.0	1	1	0.3558594085772696	1.0
44338193675	1	0.3350333092406801	0.0	0	1	0.3350333092406801	0.0
44338193676	1	0.33543777895253823	0.0	0	1	0.33543777895253823	0.0
44338193677	2	0.33596443467824255	1.0	1	1	0.33596443467824255	1.0
44402190064	2	1.7020670311327204	0.0	0	2	0.8510335155663602	0.0
44402190065	1	0.8510636327858104	0.0	0	1	0.8510636327858104	0.0
44402190066	1	0.8511689504632176	0.0	0	1	0.8511689504632176	0.0
44402190067	2	1.7024238924060062	0.0	0	2	0.8512119462030031	0.0
44402190068	1	0.8512454471905415	0.0	0	1	0.8512454471905415	0.0
44402190069	34	29.29240695572082	0.0	0	34	0.8615413810506124	0.0
44402190070	2	1.7027279264939175	0.0	0	2	0.8513639632469587	0.0
44402190071	1	0.851367363849714	0.0	0	1	0.851367363849714	0.0
44402190072	1	0.8513791481166872	0.0	0	1	0.8513791481166872	0.0
44402190073	3	2.5619569788735364	0.0	0	3	0.8539856596245121	0.0
44402190074	2	1.7028406514248509	0.0	0	2	0.8514203257124254	0.0
44402190075	4	3.414416575925005	0.0	0	4	0.8536041439812513	0.0
44402190076	27	23.280955846809512	0.0	0	27	0.8622576239559079	0.0
44402190077	2	1.7216753779896221	0.0	0	2	0.8608376889948111	0.0
44402190078	2	1.703740363373596	0.0	0	2	0.851870181686798	0.0
44402190079	1	0.8519375540245511	0.0	0	1	0.8519375540245511	0.0
44402190080	1	0.8519515941369165	0.0	0	1	0.8519515941369165	0.0
45028605169	2	1.7847719459834792	0.0	0	2	0.8923859729917396	0.0
45028605170	2	1.867266966204776	0.0	0	2	0.933633483102388	0.0
45428894492	30	1.561623652464863	10.0	10	20	0.07808118262324315	0.5
45428894493	12	1.7380298530498544	2.5	4	8	0.3476059706099709	0.5
45428894494	1	0.06939007361362223	0.0	0	1	0.06939007361362223	0.0
45428894495	3	0.5551554703392189	0.5	1	2	0.5551554703392189	0.5
45428894496	3	0.24027356064690508	0.5	1	2	0.24027356064690508	0.5
45438057877	2	1.2256418444101684	0.0	0	2	0.6128209222050842	0.0
45438057878	2	0.5558476445118968	0.0	0	2	0.2779238222559484	0.0
45438057879	2	0.5559408412289886	0.0	0	2	0.2779704206144943	0.0
45438057880	4	2.289200591354718	0.0	0	4	0.5723001478386796	0.0
45438057881	2	0.5559464303384674	0.0	0	2	0.2779732151692337	0.0
45438057882	4	1.800578284282781	0.0	0	4	0.4501445710706953	0.0
45438057883	1	0.2780392070642842	0.0	0	1	0.2780392070642842	0.0
45438057884	4	1.2692807694870447	1.0	1	3	0.4230935898290149	0.3333333333333333
45438057885	1	0.2781085658927557	0.0	0	1	0.2781085658927557	0.0
45438057886	2	0.5562877027100144	0.0	0	2	0.2781438513550072	0.0
45438057887	2	0.6479843162854159	0.0	0	2	0.32399215814270793	0.0
45438057888	2	1.240993040649627	0.0	0	2	0.6204965203248135	0.0
45438057889	1	0.2782232436450731	0.0	0	1	0.2782232436450731	0.0
45438057890	2	0.6488006966319926	0.0	0	2	0.3244003483159963	0.0
45438057891	2	0.5565430172713246	0.0	0	2	0.2782715086356623	0.0
45438057892	1	0.27827364663838466	0.0	0	1	0.27827364663838466	0.0
45438057893	5	2.8207050715478403	0.0	0	5	0.5641410143095681	0.0
45438057894	1	0.2783233425756778	0.0	0	1	0.2783233425756778	0.0
45438057895	2	0.5566671224372207	0.0	0	2	0.27833356121861036	0.0
45438057896	2	0.556709444790322	0.0	0	2	0.278354722395161	0.0
45438057897	3	1.4064925991268127	0.0	0	3	0.4688308663756042	0.0
45438057898	1	0.27837829092910765	0.0	0	1	0.27837829092910765	0.0
45438057899	1	0.2783861358839784	0.0	0	1	0.2783861358839784	0.0
45438057900	2	0.5569427396070593	0.0	0	2	0.27847136980352966	0.0
45438057901	3	1.2032942278606535	0.0	0	3	0.4010980759535512	0.0
45438057902	10	4.832032512994596	0.0	0	10	0.536892501443844	0.0
45438057903	1	0.2784899721106804	0.0	0	1	0.2784899721106804	0.0
45438057904	4	1.4833033940001985	1.0	1	3	0.49443446466673285	0.3333333333333333
45438057905	1	0.2785144497166507	0.0	0	1	0.2785144497166507	0.0
45438057906	14	6.7584582838800955	3.0	3	11	0.6144052985345542	0.2727272727272727
45438057907	3	1.0609910561790685	0.0	0	3	0.35366368539302284	0.0
45438057908	2	0.5571895694961488	0.0	0	2	0.2785947847480744	0.0
45438057909	2	0.5571708493463283	0.0	0	2	0.27858542467316416	0.0
45951237658	19	5.112552712288771	7.0	7	12	0.4260460593573976	0.5833333333333334
45951237659	1	0.4259839787166711	0.0	0	1	0.4259839787166711	0.0
46317989530	1	0.538083097734973	0.0	0	1	0.538083097734973	0.0
46317989531	2	0.5380943096232648	1.0	1	1	0.5380943096232648	1.0
46317989532	4	3.1530659447243132	0.0	0	4	0.7882664861810783	0.0
46317989533	13	9.1187949058432	0.0	0	13	0.7014457619879385	0.0
46317989534	3	1.614597131096637	0.0	0	3	0.5381990436988789	0.0
46317989535	1	0.5382242732533132	0.0	0	1	0.5382242732533132	0.0
46317989536	20	8.25434040646361	5.0	5	15	0.5502893604309074	0.3333333333333333
46317989537	13	5.533447402793013	3.0	3	10	0.5533447402793013	0.3
46317989538	5	2.878730027729727	0.0	0	5	0.5757460055459453	0.0
46345030259	2	1.7727874138102921	0.0	0	2	0.8863937069051461	0.0
46345030260	5	4.432183243869985	0.0	0	5	0.886436648773997	0.0
46345030261	1	0.8864638737976386	0.0	0	1	0.8864638737976386	0.0
46839976419	2	1.6639084635851167	0.0	0	2	0.8319542317925583	0.0
46839976420	1	0.8322197818314684	0.0	0	1	0.8322197818314684	0.0
47181726735	4	1.8925203809739037	0.0	0	4	0.6308401269913012	0.0
47181726736	3	2.0078830348877936	0.0	0	3	0.6692943449625979	0.0
47181726737	1	0.12833245181404818	0.0	0	1	0.12833245181404818	0.0
47181726738	2	1.0105782987605947	0.0	0	2	0.5052891493802973	0.0
47181726739	3	0.669034754395843	1.0	1	2	0.3345173771979215	0.5
47181726740	3	0.7421741103896933	0.0	0	3	0.24739137012989776	0.0
47181726741	2	0.2567832513378426	0.0	0	2	0.1283916256689213	0.0
47181726742	1	0.12840295539988278	0.0	0	1	0.12840295539988278	0.0
47181726743	1	0.12842399873376367	0.0	0	1	0.12842399873376367	0.0
47181726744	1	0.12843561465406594	0.0	0	1	0.12843561465406594	0.0
47181726745	1	0.12844386364094726	0.0	0	1	0.12844386364094726	0.0
47181726746	5	0.42127532232747894	1.0	2	3	0.21063766116373947	0.6666666666666666
47181726747	8	1.0365660080394963	0.0	0	8	0.12957075100493703	0.0
47181726748	1	0.12929428368440965	0.0	0	1	0.12929428368440965	0.0
47181726749	2	0.2598225484675958	0.0	0	2	0.1299112742337979	0.0
47181726750	15	1.7130475100904465	2.0	2	13	0.1317728853915728	0.15384615384615385
47181726751	8	1.463359262873226	2.0	3	5	0.3658398157183065	0.6
47181726752	5	0.6952155573064358	1.5	2	3	0.3476077786532179	0.6666666666666666
47181726753	6	1.45212555685291	2.0	2	4	0.3630313892132275	0.5
47181726754	6	0.49400684167605	2.0	3	3	0.247003420838025	1.0
47181726755	4	0.13354281495229545	1.0	2	2	0.13354281495229545	1.0
47181726756	5	0.6469351461621151	1.5	2	3	0.32346757308105756	0.6666666666666666
47181726757	7	1.1086090231728183	2.0	3	4	0.3695363410576061	0.75
47181726758	2	0.13186123372453845	1.0	1	1	0.13186123372453845	1.0
47181726759	8	1.4572673692267066	2.0	3	5	0.36431684230667666	0.6
47181726760	3	0.572798369811644	1.0	1	2	0.286399184905822	0.5
47181726761	6	1.0767389108448486	1.0	2	4	0.35891297028161623	0.5
47181726762	7	2.193711160949956	1.0	2	5	0.548427790237489	0.4
47181726763	5	0.21836061520203434	0.6666666666666666	2	3	0.21836061520203434	0.6666666666666666
47181726764	8	1.478263835394396	2.0	3	5	0.369565958848599	0.6
47181726765	5	0.7403996691381867	1.0	2	3	0.37019983456909333	0.6666666666666666
47181726766	6	0.6656935780155678	2.0	3	3	0.3328467890077839	1.0
47181726767	10	0.8240737557741645	4.0	4	6	0.13734562596236075	0.6666666666666666
47181726768	4	1.3353973084128183	1.0	1	3	0.4451324361376061	0.3333333333333333
47181726769	2	0.1327943793221535	1.0	1	1	0.1327943793221535	1.0
47181726770	7	1.5666488342649583	0.5	1	6	0.5222162780883194	0.16666666666666666
47181726771	2	0.26742363635071953	0.0	0	2	0.13371181817535976	0.0
47181726772	4	2.8207464174902492	0.0	0	4	0.9402488058300831	0.0
47181726773	5	1.5693108665048945	0.5	1	4	0.7846554332524472	0.25
47181726774	7	2.5988918344692973	0.5	1	6	0.8662972781564324	0.16666666666666666
47181726775	3	1.0741736106020963	0.0	0	3	0.5370868053010481	0.0
47181726776	2	0.2681155411687239	0.0	0	2	0.13405777058436194	0.0
47181726777	5	0.5492932352213423	1.0	1	4	0.18309774507378077	0.25
47181726778	3	0.4022467277363295	0.0	0	3	0.13408224257877652	0.0
47181726779	3	0.26816601150070385	1.0	1	2	0.13408300575035192	0.5
47181726780	1	0.13424229537049684	0.0	0	1	0.13424229537049684	0.0
47181726781	3	0.2623139108524244	0.5	1	2	0.2623139108524244	0.5
47181726782	13	2.015309479934373	5.0	5	8	0.2519136849917966	0.625
47181726783	5	3.6678506039116967	0.0	0	5	0.9169626509779242	0.0
47181726784	3	0.40455199971098244	0.5	1	2	0.40455199971098244	0.5
47181726785	4	1.1824982289088473	0.5	1	3	0.5912491144544236	0.3333333333333333
47181726786	3	1.8361235054477152	0.0	0	3	0.9180617527238576	0.0
47181726787	3	0.4402325715994385	0.5	1	2	0.4402325715994385	0.5
47181726788	1	0.13448811517956008	0.0	0	1	0.13448811517956008	0.0
47181726789	2	0.13467811123250403	1.0	1	1	0.13467811123250403	1.0
47181726790	2	0.1347093563746504	1.0	1	1	0.1347093563746504	1.0
47181726791	6	0.8400116064928886	1.5	2	4	0.2800038688309629	0.5
47181726792	24	19.15762989031507	1.0	1	23	0.8329404300136988	0.043478260869565216
47181726793	10	2.649316914864092	4.0	4	6	0.4415528191440153	0.6666666666666666
47181726794	11	2.20951167445444	5.0	5	6	0.36825194574240666	0.8333333333333334
47181726795	2	0.6008186294581018	0.0	0	2	0.6008186294581018	0.0
47181726796	6	0.3043665389173565	0.6666666666666666	2	4	0.15218326945867824	0.5
47181726797	8	1.2215236471350073	2.0	3	5	0.40717454904500244	0.6
47181726798	2	0.6008461709734851	0.0	0	2	0.6008461709734851	0.0
47181726799	4	0.42784599390645656	1.0	2	2	0.42784599390645656	1.0
47200594414	4	0.0	4.0	4	0	0.0	inf
47200594415	5	0.0	5.0	5	0	0.0	inf
47200594417	4	0.0	4.0	4	0	0.0	inf
47200594418	1	0.0	1.0	1	0	0.0	inf
47200594419	3	0.0	3.0	3	0	0.0	inf
47200594420	4	0.6746965559671706	3.0	3	1	0.22489885198905687	3.0
47200594421	3	0.02924191776891369	2.0	2	1	0.00974730592297123	2.0
47200594422	12	0.7068754834285091	9.0	9	3	0.07068754834285092	3.0
47200594423	3	0.0	3.0	3	0	0.0	inf
47200594424	8	2.0734933553737283	3.0	3	5	0.4146986710747457	0.6
47200594425	4	0.8509405376999407	2.0	2	2	0.42547026884997036	1.0
47200594426	12	1.0120682678073658	5.0	5	7	0.14458118111533796	0.7142857142857143
47200594427	9	0.24321531771545352	4.0	4	5	0.04053588628590892	0.8
47200594428	8	1.198574729945846	3.0	3	5	0.19976245499097434	0.6
47200594429	15	1.423740725655632	8.0	8	7	0.177967590706954	1.1428571428571428
47200594430	12	2.6803864714325627	6.0	6	6	0.33504830892907034	1.0
47200594431	4	1.030579230054379	1.0	1	3	0.34352641001812634	0.3333333333333333
47200594432	1	0.25279919269017204	0.0	0	1	0.25279919269017204	0.0
47200594433	119	18.650323762634287	37.666666666666664	46	73	0.3108387293772381	0.6301369863013698
47200594434	3	0.13174143823342122	2.0	2	1	0.13174143823342122	2.0
47200594435	3	1.4857200778017507	0.0	0	3	0.4952400259339169	0.0
47200594436	2	1.1756227151779373	0.0	0	2	0.5878113575889686	0.0
47200594437	1	0.9690918205503947	0.0	0	1	0.9690918205503947	0.0
47200594438	2	0.0	2.0	2	0	0.0	inf
47200594440	9	2.785503546946516	3.0	3	6	0.46425059115775263	0.5
47200594441	2	0.0	2.0	2	0	0.0	inf
47200594442	2	0.25526048835955156	1.0	1	1	0.25526048835955156	1.0
47200594443	1	0.0	1.0	1	0	0.0	inf
47200594444	2	0.0	2.0	2	0	0.0	inf
47200594445	2	0.0	2.0	2	0	0.0	inf
47200594446	3	0.0	3.0	3	0	0.0	inf
47200594447	10	0.46400948505547884	5.0	5	5	0.07733491417591314	1.0
47200594448	6	0.05963057939166719	3.0	3	3	0.009938429898611198	1.0
47200594449	7	0.0	7.0	7	0	0.0	inf
47200594450	6	0.9708763962714984	2.0	2	4	0.19417527925429967	0.5
47200594451	3	0.24617697336051975	2.0	2	1	0.12308848668025987	2.0
47200594452	13	2.2580507670934917	6.0	6	7	0.28225634588668647	0.8571428571428571
47200594453	9	1.3451006758546464	4.0	4	5	0.22418344597577441	0.8
47200594454	2	0.23028238773625478	1.0	1	1	0.23028238773625478	1.0
47200594456	127	13.240024306565752	39.833333333333336	55	72	0.22440719163670766	0.7638888888888888
47200594457	6	2.909930355992268	2.0	2	4	0.727482588998067	0.5
47200594458	1	0.0	1.0	1	0	0.0	inf
47200594460	1	0.0	1.0	1	0	0.0	inf
47200594462	2	0.0	2.0	2	0	0.0	inf
47200594463	2	0.0	2.0	2	0	0.0	inf
47200594466	5	0.782519703210206	3.0	3	2	0.1565039406420412	1.5
47200594467	4	0.0	4.0	4	0	0.0	inf
47200594469	1	0.0	1.0	1	0	0.0	inf
47200594470	4	0.0	4.0	4	0	0.0	inf
47200594471	6	0.5246346902490275	3.0	3	3	0.17487823008300918	1.0
47200594474	5	0.0	5.0	5	0	0.0	inf
47200594476	2	0.942645635947563	1.0	1	1	0.4713228179737815	1.0
47200594477	4	0.0	4.0	4	0	0.0	inf
47200594478	4	0.0	4.0	4	0	0.0	inf
47200594479	3	0.3499209460867429	2.0	2	1	0.3499209460867429	2.0
47200594480	10	1.302125137669699	5.0	5	5	0.21702085627828316	1.0
47200594481	2	0.11761129406840269	1.0	1	1	0.058805647034201346	1.0
47200594482	4	0.3769552666195453	3.0	3	1	0.12565175553984845	3.0
47200594483	3	0.6101825763417642	2.0	2	1	0.3050912881708821	2.0
47200594484	6	0.9548032958372549	5.0	5	1	0.15913388263954248	5.0
47200594485	4	0.0	4.0	4	0	0.0	inf
47200594486	16	3.9553305912803087	7.0	7	9	0.4944163239100386	0.7777777777777778
47200594487	10	1.152394106829498	2.0	4	6	0.384131368943166	0.6666666666666666
47200594488	15	0.21124436573152672	9.0	9	6	0.02640554571644084	1.5
47200594489	8	0.4581770136290435	2.0	2	6	0.07636283560484058	0.3333333333333333
47200594490	7	0.729598445715791	2.0	2	5	0.12159974095263183	0.4
47200594491	7	0.6983319235421944	3.0	3	4	0.11638865392369907	0.75
47200594492	7	1.8262951911066359	2.0	2	5	0.304382531851106	0.4
47200594493	2	1.6054109246282662	0.0	0	2	0.8027054623141331	0.0
47200594494	16	4.397208650581232	6.0	7	9	0.549651081322654	0.7777777777777778
47200594495	2	1.7710230733590484	0.0	0	2	0.8855115366795242	0.0
47200594496	2	0.6162273665897244	1.0	1	1	0.6162273665897244	1.0
47200594499	11	2.0373773379859417	3.5	4	7	0.33956288966432363	0.5714285714285714
47200594502	4	0.0	4.0	4	0	0.0	inf
47200594503	2	1.8010977684402987	0.0	0	2	0.9005488842201493	0.0
47200594504	1	0.0	1.0	1	0	0.0	inf
47200594505	4	0.0	4.0	4	0	0.0	inf
47200594506	1	0.0	1.0	1	0	0.0	inf
47200594507	2	0.4468010210023583	0.0	0	2	0.22340051050117915	0.0
47200594508	4	0.0	4.0	4	0	0.0	inf
47200594510	1	0.0	1.0	1	0	0.0	inf
47200594512	1	0.0	1.0	1	0	0.0	inf
47200594513	4	0.0	4.0	4	0	0.0	inf
47200594514	2	0.0	2.0	2	0	0.0	inf
47200594515	2	1.4402205853164598	0.0	0	2	0.7201102926582299	0.0
47200594517	3	1.2753283879590784	0.0	0	3	0.6376641939795392	0.0
47200594518	2	1.7205190720448669	0.0	0	2	0.8602595360224334	0.0
47200594519	2	0.0	2.0	2	0	0.0	inf
47200594520	1	0.24722533541979952	0.0	0	1	0.24722533541979952	0.0
47200594521	1	0.7064468728040229	0.0	0	1	0.7064468728040229	0.0
47200594523	3	0.0	3.0	3	0	0.0	inf
47200594524	4	0.4602093619805946	2.0	2	2	0.1534031206601982	1.0
47200594525	2	0.12797336836470435	1.0	1	1	0.12797336836470435	1.0
47200594526	2	0.6483487868282333	1.0	1	1	0.6483487868282333	1.0
47200594527	2	0.0	2.0	2	0	0.0	inf
47200594528	3	0.0	3.0	3	0	0.0	inf
47200594529	5	0.0	5.0	5	0	0.0	inf
47200594530	4	0.0	4.0	4	0	0.0	inf
47200594531	6	0.7698621883848407	5.0	5	1	0.15397243767696814	5.0
47200594532	8	0.4627592416682792	6.0	6	2	0.09255184833365585	3.0
47200594533	5	0.0	5.0	5	0	0.0	inf
47200594534	8	0.14276403752824393	7.0	7	1	0.02039486250403485	7.0
47200594535	8	0.0	8.0	8	0	0.0	inf
47200594536	1	0.0	1.0	1	0	0.0	inf
47200594537	5	0.5127193822269753	4.0	4	1	0.12817984555674383	4.0
47200594538	7	0.018561129554985338	6.0	6	1	0.0037122259109970677	6.0
47200594539	6	0.0	6.0	6	0	0.0	inf
47200594540	1	0.0	1.0	1	0	0.0	inf
47200594541	1	0.0	1.0	1	0	0.0	inf
47200594542	2	0.0	2.0	2	0	0.0	inf
47200594543	3	0.0	3.0	3	0	0.0	inf
47200594544	7	0.0	7.0	7	0	0.0	inf
47200594545	4	0.3702439582315748	3.0	3	1	0.0925609895578937	3.0
47200594546	7	0.0	7.0	7	0	0.0	inf
47200594547	5	0.0	5.0	5	0	0.0	inf
47200594548	12	0.4683168703195627	6.0	6	6	0.06690241004565181	1.0
47200594549	14	4.431381240329115	7.0	7	7	0.5539226550411394	1.0
47200594550	8	0.3774744140837209	4.0	4	4	0.07549488281674419	1.0
47200594551	12	4.3110610126382225	5.0	5	7	0.5388826265797778	0.7142857142857143
47200594552	9	3.7350145284860585	3.0	3	6	0.6225024214143431	0.5
47200594553	17	3.2734255655362308	7.5	8	9	0.40917819569202885	0.8888888888888888
47200594554	3	0.8149559653929075	1.0	1	2	0.40747798269645374	0.5
47200594556	1	0.0	1.0	1	0	0.0	inf
47200594558	5	0.0	5.0	5	0	0.0	inf
47200594559	14	0.5941797101386816	7.0	7	7	0.0742724637673352	1.0
47200594560	9	0.3376148717718558	8.0	8	1	0.04823069596740797	8.0
47200594561	3	0.05249086239521556	2.0	2	1	0.01749695413173852	2.0
47200594562	12	0.7139109264969142	6.0	6	6	0.10198727521384489	1.0
47200594563	14	0.8257193444836517	6.0	6	8	0.10321491806045646	0.75
47200594564	4	1.3233891066976824	2.0	2	2	0.4411297022325608	1.0
47200594565	8	0.6777556169961048	3.0	3	5	0.1129592694993508	0.6
47200594566	2	0.2658528272325117	1.0	1	1	0.2658528272325117	1.0
47200594567	10	6.896865004521624	1.0	1	9	0.862108125565203	0.1111111111111111
47200594568	4	1.2268403043613538	1.0	1	3	0.4089467681204513	0.3333333333333333
47200594569	1	0.0	1.0	1	0	0.0	inf
47200594571	1	0.0	1.0	1	0	0.0	inf
47200594572	4	0.0	4.0	4	0	0.0	inf
47200594573	1	0.0	1.0	1	0	0.0	inf
47200594574	2	0.4551465041955189	1.0	1	1	0.22757325209775944	1.0
47200594575	2	0.0	2.0	2	0	0.0	inf
47200594576	4	0.3956840357895595	3.0	3	1	0.13189467859651985	3.0
47200594577	9	3.2868279133729783	0.0	0	9	0.36520310148588647	0.0
47200594578	4	0.0	4.0	4	0	0.0	inf
47200594579	3	0.0	3.0	3	0	0.0	inf
47200594580	9	0.0026659042133703823	8.0	8	1	0.0003332380266712978	8.0
47200594581	5	0.0	5.0	5	0	0.0	inf
47200594582	3	0.6199857060208547	2.0	2	1	0.30999285301042734	2.0
47200594583	8	0.6142980800701885	7.0	7	1	0.0877568685814555	7.0
47200594584	4	0.32064377652491194	2.0	2	2	0.10688125884163731	1.0
47200594585	8	0.02518516702868496	7.0	7	1	0.00314814587858562	7.0
47200594586	5	0.0	5.0	5	0	0.0	inf
47200594587	14	0.23209514469009176	8.0	8	6	0.02901189308626147	1.3333333333333333
47200594588	9	0.38693118732179876	5.0	5	4	0.09673279683044969	1.25
47200594589	8	1.8303943315386344	4.0	4	4	0.3660788663077269	1.0
47200594590	6	2.7893031313120535	1.0	1	5	0.5578606262624107	0.2
47200594591	8	6.541221248029966	0.0	0	8	0.8176526560037457	0.0
47200594592	7	4.17472418165589	1.0	1	6	0.6957873636093149	0.16666666666666666
47200594593	2	0.29936196274979743	1.0	1	1	0.29936196274979743	1.0
47200594594	3	1.1414726838839746	1.0	1	2	0.5707363419419873	0.5
47200594595	8	0.38934228201387194	4.0	4	4	0.09733557050346799	1.0
47200594597	9	3.513055334843717	5.0	5	4	0.3903394816493019	1.25
47200594599	1	0.0	1.0	1	0	0.0	inf
47200594600	4	0.4290058351313038	2.0	2	2	0.2145029175656519	1.0
47200594601	3	0.0	3.0	3	0	0.0	inf
47200594603	2	0.0	2.0	2	0	0.0	inf
47200594604	2	0.0	2.0	2	0	0.0	inf
47200594605	1	0.0	1.0	1	0	0.0	inf
47200594608	4	0.0	4.0	4	0	0.0	inf
47200594610	1	0.0	1.0	1	0	0.0	inf
47200594611	4	0.0	4.0	4	0	0.0	inf
47200594613	4	0.0	4.0	4	0	0.0	inf
47200594614	2	0.9828238921770548	1.0	1	1	0.4914119460885274	1.0
47200594615	2	0.0	2.0	2	0	0.0	inf
47200594618	4	0.0	4.0	4	0	0.0	inf
47200594620	2	0.9545087901709247	1.0	1	1	0.47725439508546236	1.0
47200594622	4	0.0	4.0	4	0	0.0	inf
47200594623	5	0.0	5.0	5	0	0.0	inf
47200594624	9	0.61560488793886	8.0	8	1	0.0769506109923575	8.0
47200594625	6	0.0	6.0	6	0	0.0	inf
47200594626	15	1.8702371738607315	8.0	8	7	0.23377964673259144	1.1428571428571428
47200594627	7	0.5803344085410751	6.0	6	1	0.09672240142351252	6.0
47200594628	7	6.357138136221209	0.0	0	7	0.9081625908887442	0.0
47200594629	10	0.6940359858517418	6.0	6	4	0.11567266430862362	1.5
47200594630	8	1.4001141121075027	5.0	5	3	0.28002282242150056	1.6666666666666667
47200594631	1	0.5415983445731111	0.0	0	1	0.5415983445731111	0.0
47200594632	4	0.05354343312127152	1.0	2	2	0.05354343312127152	1.0
47200594633	4	0.6646087520673393	1.0	1	3	0.33230437603366964	0.3333333333333333
47200594634	9	0.12559627970018267	5.0	5	4	0.025119255940036535	1.25
47200594635	1	0.0	1.0	1	0	0.0	inf
47200594637	2	0.0	2.0	2	0	0.0	inf
47200594638	4	0.0	4.0	4	0	0.0	inf
47200594639	2	0.19167786985704707	1.0	1	1	0.19167786985704707	1.0
47200594640	2	0.7147592590416556	0.0	0	2	0.3573796295208278	0.0
47200594641	17	0.9312233479863399	13.0	13	4	0.07163256522971845	3.25
47200594642	1	0.5225400199598547	0.0	0	1	0.5225400199598547	0.0
47200594643	2	0.0	2.0	2	0	0.0	inf
47200594644	5	0.0	5.0	5	0	0.0	inf
47200594646	3	0.0	3.0	3	0	0.0	inf
47200594647	2	0.0	2.0	2	0	0.0	inf
47200594650	4	0.0	4.0	4	0	0.0	inf
47200594651	4	1.5770019525183603	0.0	0	4	0.39425048812959007	0.0
47200594652	3	0.49133326085447987	2.0	2	1	0.16377775361815997	2.0
47200594653	3	0.0	3.0	3	0	0.0	inf
47200594654	2	0.0057075581965182745	1.0	1	1	0.0057075581965182745	1.0
47200594655	2	0.0	2.0	2	0	0.0	inf
47200594658	5	0.0	5.0	5	0	0.0	inf
47200594660	1	0.0	1.0	1	0	0.0	inf
47200594662	4	0.0	4.0	4	0	0.0	inf
47200594663	1	0.0	1.0	1	0	0.0	inf
47200594664	8	0.0	8.0	8	0	0.0	inf
47200594665	8	0.18503632432955855	7.0	7	1	0.030839387388259757	7.0
47200594666	8	0.025590074441887857	7.0	7	1	0.003198759305235982	7.0
47200594667	6	0.02694058510636328	5.0	5	1	0.004490097517727213	5.0
47200594668	12	1.0670589772596306	5.0	5	7	0.15243699675137581	0.7142857142857143
47200594669	7	0.8798149883552924	3.0	3	4	0.2199537470888231	0.75
47200594670	14	2.146689208510382	7.0	7	7	0.3066698869300546	1.0
47896833830	1	0.7002311096769471	0.0	0	1	0.7002311096769471	0.0
47896833831	1	0.7002675398965618	0.0	0	1	0.7002675398965618	0.0
47896833832	2	1.4005779745249063	0.0	0	2	0.7002889872624531	0.0
47896833833	1	0.700311141684363	0.0	0	1	0.700311141684363	0.0
47896833834	1	0.7003413767464831	0.0	0	1	0.7003413767464831	0.0
48139432115	3	0.4242873136271883	1.0	1	2	0.21214365681359415	0.5
48139432116	3	1.010706275899925	0.0	0	3	0.33690209196664167	0.0
48355085329	1	0.7842467043698116	0.0	0	1	0.7842467043698116	0.0
48355085330	1	0.7845982458882925	0.0	0	1	0.7845982458882925	0.0
48355085331	1	0.7856960345301918	0.0	0	1	0.7856960345301918	0.0
48355085332	1	0.7857038794850626	0.0	0	1	0.7857038794850626	0.0
48355085333	1	0.7857204447974936	0.0	0	1	0.7857204447974936	0.0
48355085334	2	1.5792227818028157	0.0	0	2	0.7896113909014079	0.0
48355085335	7	5.909244545323755	0.0	0	7	0.8441777921891079	0.0
48355085336	1	0.7862115457062727	0.0	0	1	0.7862115457062727	0.0
48355085337	30	21.36759239715458	3.0	3	27	0.7913923110057253	0.1111111111111111
48355085338	2	1.5729081991798353	0.0	0	2	0.7864540995899176	0.0
48355085339	1	0.7866744990516527	0.0	0	1	0.7866744990516527	0.0
48355085340	1	0.7866857109399444	0.0	0	1	0.7866857109399444	0.0
48355085341	21	16.745014960463614	0.0	0	21	0.7973816647839816	0.0
48355085342	3	2.5358696757040433	0.0	0	3	0.8452898919013477	0.0
48355085343	1	0.7867441945734662	0.0	0	1	0.7867441945734662	0.0
48355085344	2	1.5735598691434594	0.0	0	2	0.7867799345717297	0.0
48355085345	1	0.7868185027940665	0.0	0	1	0.7868185027940665	0.0
48355085346	1	0.7869485337627834	0.0	0	1	0.7869485337627834	0.0
48355085347	1	0.7869566480723279	0.0	0	1	0.7869566480723279	0.0
48355085348	1	0.7869655704458934	0.0	0	1	0.7869655704458934	0.0
48355085349	2	1.6998887262173712	0.0	0	2	0.8499443631086856	0.0
48355085350	3	2.361436969474405	0.0	0	3	0.7871456564914684	0.0
48355085351	2	1.5740675016953352	0.0	0	2	0.7870337508476676	0.0
48355085352	1	0.7870417641492095	0.0	0	1	0.7870417641492095	0.0
48355085353	1	0.7871159713618071	0.0	0	1	0.7871159713618071	0.0
48355085354	4	3.14974981832869	0.0	0	4	0.7874374545821725	0.0
48355085355	25	19.772462538404504	0.0	0	25	0.7908985015361801	0.0
48355085356	2	1.5744847320848587	0.0	0	2	0.7872423660424294	0.0
48355085357	1	0.7872534769227185	0.0	0	1	0.7872534769227185	0.0
48355085358	6	4.901891869788429	0.0	0	6	0.8169819782980715	0.0
48355085359	1	0.7874349883034416	0.0	0	1	0.7874349883034416	0.0
48355085360	1	0.7874462001917334	0.0	0	1	0.7874462001917334	0.0
48355085361	1	0.7874656947362406	0.0	0	1	0.7874656947362406	0.0
48355085362	3	1.5749676850147591	1.0	1	2	0.7874838425073796	0.5
48355085363	1	0.7875441779542829	0.0	0	1	0.7875441779542829	0.0
48355085364	7	4.133715269282116	0.5	1	6	0.8267430538564232	0.16666666666666666
48355085365	2	1.5752579146756447	0.0	0	2	0.7876289573378223	0.0
48355085366	31	23.898704225572143	1.0	1	30	0.7966234741857381	0.03333333333333333
48355085367	2	1.5755393229709673	0.0	0	2	0.7877696614854837	0.0
48355085368	2	1.6950584561930144	0.0	0	2	0.8475292280965072	0.0
48355085369	1	0.7877714122908626	0.0	0	1	0.7877714122908626	0.0
48355085370	3	2.363754025716031	0.0	0	3	0.7879180085720104	0.0
48355085371	2	1.5757690825076125	0.0	0	2	0.7878845412538062	0.0
48355085372	4	3.1525358547265196	0.0	0	4	0.7881339636816299	0.0
48355085373	24	19.13550768995809	0.0	0	24	0.7973128204149204	0.0
48355085374	1	0.7880088484357076	0.0	0	1	0.7880088484357076	0.0
48355085375	5	3.940272654941815	0.0	0	5	0.788054530988363	0.0
48355085376	2	1.5761589060590895	0.0	0	2	0.7880794530295447	0.0
48355085377	1	0.7881795519601495	0.0	0	1	0.7881795519601495	0.0
48355085378	1	0.7881874305843545	0.0	0	1	0.7881874305843545	0.0
48355085379	2	1.5764552635388012	0.0	0	2	0.7882276317694006	0.0
48355085380	4	3.3306153538830525	0.0	0	4	0.8326538384707631	0.0
48355085381	1	0.7882536918340788	0.0	0	1	0.7882536918340788	0.0
48355085382	25	18.26753794374036	2.0	2	23	0.7942407801626244	0.08695652173913043
48355085383	3	0.8004757948294475	0.5	1	2	0.8004757948294475	0.5
48355085384	1	0.7883873590908903	0.0	0	1	0.7883873590908903	0.0
48355085385	2	1.5768500028130727	0.0	0	2	0.7884250014065364	0.0
48355085386	1	0.7885862438480655	0.0	0	1	0.7885862438480655	0.0
48355085387	1	0.7885974894056915	0.0	0	1	0.7885974894056915	0.0
48355085388	6	4.9129507309561955	0.0	0	6	0.8188251218260326	0.0
48355085389	29	22.263907951811234	1.0	1	28	0.7951395697075441	0.03571428571428571
48355085390	4	3.1556628604718884	0.0	0	4	0.7889157151179721	0.0
48355085391	2	1.5775480691192374	0.0	0	2	0.7887740345596187	0.0
48355085392	3	2.5677098223245665	0.0	0	3	0.8559032741081888	0.0
48355085393	2	1.5777083014807403	0.0	0	2	0.7888541507403701	0.0
48355085394	2	1.5780182950408066	0.0	0	2	0.7890091475204033	0.0
48355085395	18	13.591437713229999	1.0	1	17	0.7994963360723528	0.058823529411764705
48355085396	5	4.12614943319191	0.0	0	5	0.8252298866383819	0.0
48355085397	4	3.2449373694829298	0.0	0	4	0.8112343423707324	0.0
48355085398	1	0.78917464913271	0.0	0	1	0.78917464913271	0.0
48355085399	6	4.916319381513185	0.0	0	6	0.8193865635855309	0.0
48355085400	2	1.5784170072965151	0.0	0	2	0.7892085036482576	0.0
48355085401	26	16.787404786910653	5.0	5	21	0.7994002279481263	0.23809523809523808
48355085402	5	3.9471136912744944	0.0	0	5	0.7894227382548988	0.0
48355085403	3	2.368261945534667	0.0	0	3	0.7894206485115557	0.0
48355085404	1	0.7894595927081246	0.0	0	1	0.7894595927081246	0.0
48355085405	22	17.664291283915073	0.0	0	22	0.8029223310870488	0.0
48355085406	1	0.7895649103855317	0.0	0	1	0.7895649103855317	0.0
48355085407	7	6.237178237745026	0.0	0	7	0.8910254625350038	0.0
48355085408	1	0.789603057741191	0.0	0	1	0.789603057741191	0.0
48355085409	1	0.7896207678109852	0.0	0	1	0.7896207678109852	0.0
48355085410	1	0.7896210371656589	0.0	0	1	0.7896210371656589	0.0
48355085411	1	0.7896322490539507	0.0	0	1	0.7896322490539507	0.0
48355085412	3	2.5523947532807147	0.0	0	3	0.8507982510935715	0.0
48355085413	3	2.36923946731477	0.0	0	3	0.7897464891049233	0.0
48355085414	2	1.5794141582984622	0.0	0	2	0.7897070791492311	0.0
48355085415	15	10.309669526394014	2.0	2	13	0.7930515020303088	0.15384615384615385
48355085416	1	0.7898302584084365	0.0	0	1	0.7898302584084365	0.0
48355085417	1	0.7898381033633073	0.0	0	1	0.7898381033633073	0.0
48355085418	2	1.5797187984343894	0.0	0	2	0.7898593992171947	0.0
48355085419	1	0.789860560809225	0.0	0	1	0.789860560809225	0.0
48355085420	8	6.485309648617738	0.0	0	8	0.8106637060772173	0.0
48355085421	6	4.9230157070474325	0.0	0	6	0.8205026178412388	0.0
48355085422	2	1.5798907813935315	0.0	0	2	0.7899453906967657	0.0
48355085423	2	0.789970996225432	1.0	1	1	0.789970996225432	1.0
48355085424	20	15.969014347412378	0.0	0	20	0.7984507173706189	0.0
48355085425	6	4.931013082994201	0.0	0	6	0.8218355138323669	0.0
48355085426	2	1.5803675728352715	0.0	0	2	0.7901837864176358	0.0
48355085427	2	1.5804349788423586	0.0	0	2	0.7902174894211793	0.0
48355085428	21	16.804780688562797	0.0	0	21	0.8002276518363237	0.0
48355085429	3	2.371390937770754	0.0	0	3	0.7904636459235846	0.0
48355085430	2	1.5808015705532312	0.0	0	2	0.7904007852766156	0.0
48355085431	1	0.7904327374747804	0.0	0	1	0.7904327374747804	0.0
48355085432	17	13.481145055000038	0.0	0	17	0.7930085326470611	0.0
48355085433	4	2.372067051671014	1.0	1	3	0.7906890172236714	0.3333333333333333
48355085434	5	4.1428288173272625	0.0	0	5	0.8285657634654525	0.0
48355085435	2	1.5813344887750986	0.0	0	2	0.7906672443875493	0.0
48355085436	11	8.904785109346381	0.0	0	11	0.8095259190314892	0.0
48355085437	1	0.7907485558296651	0.0	0	1	0.7907485558296651	0.0
48355085438	3	2.544634375777446	0.0	0	3	0.8482114585924819	0.0
48355085439	13	10.405682986316412	0.0	0	13	0.8004371527935702	0.0
48355085440	5	4.143736104876205	0.0	0	5	0.828747220975241	0.0
48355085441	1	0.7908651190646983	0.0	0	1	0.7908651190646983	0.0
48355085442	20	16.02852950832638	0.0	0	20	0.801426475416319	0.0
48355085443	5	4.144894599327684	0.0	0	5	0.8289789198655368	0.0
48355085444	22	17.7002677755819	0.0	0	22	0.8045576261628136	0.0
48355085445	2	1.582515710027169	0.0	0	2	0.7912578550135845	0.0
48355085446	1	0.7912593532989567	0.0	0	1	0.7912593532989567	0.0
48355085447	7	3.9653642885600657	0.5	1	6	0.7930728577120132	0.16666666666666666
48355085448	2	1.5827243588912647	0.0	0	2	0.7913621794456324	0.0
48355085449	15	10.331070327596224	2.0	2	13	0.7946977175074019	0.15384615384615385
48355085450	8	6.4985403501886845	0.0	0	8	0.8123175437735856	0.0
48355085451	5	4.14697081882171	0.0	0	5	0.8293941637643419	0.0
48355085452	3	2.3747143704119007	0.0	0	3	0.7915714568039669	0.0
48355085453	2	1.5831837432872187	0.0	0	2	0.7915918716436093	0.0
48355085454	21	16.834541349763878	0.0	0	21	0.8016448261792323	0.0
48355085455	5	4.148080492738585	0.0	0	5	0.829616098547717	0.0
48355085456	22	16.84020907713803	1.0	1	21	0.8019147179589539	0.047619047619047616
48355085457	5	4.149348984904926	0.0	0	5	0.8298697969809853	0.0
48355085458	2	1.5842070890311808	0.0	0	2	0.7921035445155904	0.0
48355085459	1	0.7921315574016526	0.0	0	1	0.7921315574016526	0.0
48355085460	1	0.7923131697903785	0.0	0	1	0.7923131697903785	0.0
48355085461	6	4.150588757129187	0.0	0	6	0.8301177514258373	0.0
48355085462	3	2.377203712636677	0.0	0	3	0.792401237545559	0.0
48355085463	11	8.930591576599232	0.0	0	11	0.8118719615090211	0.0
48355085464	13	10.474362468631542	0.0	0	13	0.8057201898947339	0.0
48355085465	10	4.399705905099547	1.0	2	8	0.8799411810199095	0.25
48355085466	3	2.377860433000432	0.0	0	3	0.7926201443334774	0.0
48355085467	3	1.5852927230434304	1.0	1	2	0.7926463615217152	0.5
48355085468	22	16.069504313664595	2.0	2	20	0.8034752156832298	0.1
48355085469	1	0.7927608035886932	0.0	0	1	0.7927608035886932	0.0
48355085470	1	0.7927720154769848	0.0	0	1	0.7927720154769848	0.0
48355085471	1	0.792778143295811	0.0	0	1	0.792778143295811	0.0
48355085472	1	0.7927978398563236	0.0	0	1	0.7927978398563236	0.0
48355085473	2	1.774558959499057	0.0	0	2	0.8872794797495285	0.0
48355085474	3	2.3786653321040436	0.0	0	3	0.7928884440346812	0.0
48355085475	3	2.4052627256868098	0.0	0	3	0.8017542418956033	0.0
48355085476	21	16.867419824982086	0.0	0	21	0.8032104678562898	0.0
48355085477	1	0.7930786084342961	0.0	0	1	0.7930786084342961	0.0
48355085478	2	1.586188495680073	0.0	0	2	0.7930942478400365	0.0
48355085479	9	4.192111530881665	1.0	2	7	0.8384223061763331	0.2857142857142857
48355085480	3	2.379509994691356	0.0	0	3	0.793169998230452	0.0
48355085481	1	0.7931938922346293	0.0	0	1	0.7931938922346293	0.0
48355085482	5	3.966976443620683	0.0	0	5	0.7933952887241367	0.0
48355085483	3	2.380186849316969	0.0	0	3	0.7933956164389896	0.0
48355085484	1	0.7936177554829922	0.0	0	1	0.7936177554829922	0.0
48355085485	21	16.882534965519405	0.0	0	21	0.803930236453305	0.0
48355085486	1	0.7937403455288488	0.0	0	1	0.7937403455288488	0.0
48355085487	1	0.7937515574171405	0.0	0	1	0.7937515574171405	0.0
48355085488	2	1.5876703504172993	0.0	0	2	0.7938351752086497	0.0
48355085489	2	1.5877582610489203	0.0	0	2	0.7938791305244601	0.0
48355085490	4	3.1760468141116394	0.0	0	4	0.7940117035279098	0.0
48355085491	2	1.5880132389168886	0.0	0	2	0.7940066194584443	0.0
48355085492	20	15.893191915844712	0.0	0	20	0.7946595957922356	0.0
48355085493	7	4.765415277399793	1.0	1	6	0.7942358795666321	0.16666666666666666
48355085494	9	7.15891370202848	0.0	0	9	0.7954348557809422	0.0
48355085495	9	7.14920104185041	0.0	0	9	0.7943556713167123	0.0
48355085496	5	3.976069924742641	0.0	0	5	0.7952139849485282	0.0
48355085497	16	11.139629119489339	2.0	2	14	0.7956877942492385	0.14285714285714285
48355085498	2	1.592046690477844	0.0	0	2	0.796023345238922	0.0
48355085499	38	29.677003612416538	1.0	1	37	0.8020811787139605	0.02702702702702703
48355085500	5	3.1986869835061005	1.0	1	4	0.7996717458765251	0.25
48355085501	3	1.5946971404668124	1.0	1	2	0.7973485702334062	0.5
48355085502	8	4.99939075339748	0.5	1	7	0.8332317922329134	0.14285714285714285
48355085503	1	0.797581612530137	0.0	0	1	0.797581612530137	0.0
48355085504	1	0.7975928244184287	0.0	0	1	0.7975928244184287	0.0
48355085505	5	3.1995001652659267	1.0	1	4	0.7998750413164817	0.25
48355085506	33	26.543368711835182	0.0	0	33	0.8043445064192479	0.0
48355085507	1	0.7976374362862563	0.0	0	1	0.7976374362862563	0.0
48355085508	5	4.175835909402152	0.0	0	5	0.8351671818804304	0.0
48355085509	2	1.595429078123192	0.0	0	2	0.797714539061596	0.0
48355085510	1	0.7978472635770496	0.0	0	1	0.7978472635770496	0.0
48355085511	9	5.186164954081594	0.5	1	8	0.8643608256802656	0.125
48355085512	1	0.7979231542563577	0.0	0	1	0.7979231542563577	0.0
48355085513	1	0.7979310665498969	0.0	0	1	0.7979310665498969	0.0
48355085514	2	1.596073408171958	0.0	0	2	0.798036704085979	0.0
48355085515	1	0.7980282699177597	0.0	0	1	0.7980282699177597	0.0
48355085516	1	0.7980249366536729	0.0	0	1	0.7980249366536729	0.0
48355085517	2	1.643315760073267	0.0	0	2	0.8216578800366335	0.0
48355085518	1	0.798054531998443	0.0	0	1	0.798054531998443	0.0
48355085519	21	15.234730073115987	2.0	2	19	0.801827898585052	0.10526315789473684
48355085520	2	1.596189735721652	0.0	0	2	0.798094867860826	0.0
48355085521	2	1.5962699024064047	0.0	0	2	0.7981349512032023	0.0
48355085522	1	0.7981638563266211	0.0	0	1	0.7981638563266211	0.0
48355085523	3	2.4031973477183994	0.0	0	3	0.8010657825727998	0.0
48355085524	7	4.198758295155956	0.5	1	6	0.8397516590311913	0.16666666666666666
48355085525	1	0.798336479003113	0.0	0	1	0.798336479003113	0.0
48355085526	5	3.2023986235706823	1.0	1	4	0.8005996558926706	0.25
48355085527	26	21.036672773498278	0.0	0	26	0.809102798980703	0.0
48355085528	2	1.5969856114436949	0.0	0	2	0.7984928057218474	0.0
48355085529	5	3.992718669783863	0.0	0	5	0.7985437339567726	0.0
48355085530	2	1.5971361807062796	0.0	0	2	0.7985680903531398	0.0
48355085531	2	0.7986709164998155	1.0	1	1	0.7986709164998155	1.0
48355085532	29	22.47043645591605	1.0	1	28	0.8025155877112875	0.03571428571428571
48355085533	6	4.980990058220003	0.0	0	6	0.8301650097033338	0.0
48355085534	2	1.5978204089160841	0.0	0	2	0.7989102044580421	0.0
48355085535	1	0.7990465652615903	0.0	0	1	0.7990465652615903	0.0
48355085536	1	0.7990577771498821	0.0	0	1	0.7990577771498821	0.0
48355085537	1	0.7990952847881915	0.0	0	1	0.7990952847881915	0.0
48355085538	5	3.995762983644414	0.0	0	5	0.7991525967288828	0.0
48355085539	2	1.5982903654829796	0.0	0	2	0.7991451827414898	0.0
48355085540	1	0.7991727242568731	0.0	0	1	0.7991727242568731	0.0
48355085541	1	0.7991840034838333	0.0	0	1	0.7991840034838333	0.0
48355085542	32	25.766769390683024	0.0	0	32	0.8052115434588445	0.0
48355085543	1	0.7992770991929224	0.0	0	1	0.7992770991929224	0.0
48355085544	1	0.7992856512038117	0.0	0	1	0.7992856512038117	0.0
48355085545	1	0.799300162686856	0.0	0	1	0.799300162686856	0.0
48355085546	2	1.7709250282578304	0.0	0	2	0.8854625141289152	0.0
48355085547	3	2.405851568672799	0.0	0	3	0.8019505228909329	0.0
48355085548	1	0.7993379733491732	0.0	0	1	0.7993379733491732	0.0
48355085549	5	4.184288663094104	0.0	0	5	0.8368577326188207	0.0
48355085550	1	0.7994086789510131	0.0	0	1	0.7994086789510131	0.0
48355085551	1	0.799525376863383	0.0	0	1	0.799525376863383	0.0
48355085552	1	0.7995365887516748	0.0	0	1	0.7995365887516748	0.0
48355085553	5	4.186931402805538	0.0	0	5	0.8373862805611075	0.0
48355085554	4	3.221169950779137	0.0	0	4	0.8052924876947842	0.0
48355085555	1	0.7997913309343034	0.0	0	1	0.7997913309343034	0.0
48355085556	1	0.7998034182252847	0.0	0	1	0.7998034182252847	0.0
48355085557	12	9.636910707949266	0.0	0	12	0.8030758923291055	0.0
48355085558	2	1.6000861530923753	0.0	0	2	0.8000430765461877	0.0
48355085559	9	7.35154693924372	0.0	0	9	0.8168385488048577	0.0
48355085560	5	4.188890318339178	0.0	0	5	0.8377780636678356	0.0
48355085561	3	1.6389509685943562	1.0	1	2	0.8194754842971781	0.5
48355085562	24	17.864512141279757	2.0	2	22	0.8120232791490799	0.09090909090909091
48355085563	1	0.8001958343154959	0.0	0	1	0.8001958343154959	0.0
48355085564	1	0.8002070462037876	0.0	0	1	0.8002070462037876	0.0
48355085565	2	1.6006005195110928	0.0	0	2	0.8003002597555464	0.0
48355085566	2	1.6010997347294165	0.0	0	2	0.8005498673647082	0.0
48355085567	6	4.951454341840778	0.0	0	6	0.8252423903067964	0.0
48355085568	5	4.191940625341218	0.0	0	5	0.8383881250682436	0.0
48355085569	2	1.6390466231728453	0.0	0	2	0.8195233115864227	0.0
48355085570	22	17.876899863730102	0.0	0	22	0.8125863574422774	0.0
48355085571	5	4.004083046490247	0.0	0	5	0.8008166092980493	0.0
48355085572	3	2.402451437288323	0.0	0	3	0.8008171457627743	0.0
48355085573	2	1.6390376334606112	0.0	0	2	0.8195188167303056	0.0
48355085574	22	17.005506215577945	1.0	1	21	0.8097860102656165	0.047619047619047616
48355085575	6	5.096602067223048	0.0	0	6	0.849433677870508	0.0
48355085576	3	2.403110144142797	0.0	0	3	0.8010367147142657	0.0
48355085577	2	1.6021837862829584	0.0	0	2	0.8010918931414792	0.0
48355085578	18	13.658006195628866	1.0	1	17	0.8034121291546392	0.058823529411764705
48355085579	1	0.8012075304698215	0.0	0	1	0.8012075304698215	0.0
48355085580	1	0.8012187423581133	0.0	0	1	0.8012187423581133	0.0
48355085581	3	2.403923999289308	0.0	0	3	0.8013079997631026	0.0
48355085582	2	1.639135005175145	0.0	0	2	0.8195675025875725	0.0
48355085583	10	8.162122692602649	0.0	0	10	0.8162122692602649	0.0
48355085584	1	0.8014529462468742	0.0	0	1	0.8014529462468742	0.0
48355085585	1	0.8014841577196864	0.0	0	1	0.8014841577196864	0.0
48618208579	2	1.6644708424744172	0.0	0	2	0.8322354212372086	0.0
48618208580	4	3.3292138005079153	0.0	0	4	0.8323034501269788	0.0
48618208581	2	1.6645920857469054	0.0	0	2	0.8322960428734527	0.0
48618208582	4	3.3301359025639097	0.0	0	4	0.8325339756409774	0.0
48618208583	2	1.6650572612683434	0.0	0	2	0.8325286306341717	0.0
48618208584	4	3.331098172135616	0.0	0	4	0.832774543033904	0.0
48618208585	4	3.332042260266849	0.0	0	4	0.8330105650667122	0.0
48618208586	19	15.854101179110186	0.0	0	19	0.8344263778479045	0.0
48618208587	4	3.3329358780661025	0.0	0	4	0.8332339695165256	0.0
48618208588	15	12.519134669828574	0.0	0	15	0.8346089779885716	0.0
48618208589	13	10.877767084771335	0.0	0	13	0.8367513142131796	0.0
48618208590	3	2.511721490499675	0.0	0	3	0.8372404968332251	0.0
48618208591	19	15.912613094872743	0.0	0	19	0.8375059523617233	0.0
48618208592	1	0.8384052762270898	0.0	0	1	0.8384052762270898	0.0
48618208593	2	1.6774137049072078	0.0	0	2	0.8387068524536039	0.0
48618208594	2	1.6778372651315627	0.0	0	2	0.8389186325657814	0.0
48618208595	4	3.362232171809764	0.0	0	4	0.840558042952441	0.0
48750837189	4	3.3636858453142575	0.0	0	4	0.8409214613285644	0.0
48750837190	2	1.6819392001183007	0.0	0	2	0.8409696000591503	0.0
48750837191	1	0.8413841369019371	0.0	0	1	0.8413841369019371	0.0
49022520604	34	8.224448805221792	10.0	10	24	0.34268536688424134	0.4166666666666667
49022520605	3	0.5718478508375768	0.5	1	2	0.5718478508375768	0.5
49022520606	3	0.39292382377106844	0.5	1	2	0.39292382377106844	0.5
49022520607	3	0.6243708674469625	0.5	1	2	0.6243708674469625	0.5
49022520608	3	0.5680646634377999	0.5	1	2	0.5680646634377999	0.5
49022520609	4	2.462230498443854	0.0	0	4	0.8207434994812847	0.0
49022520610	2	0.8647161774450679	0.0	0	2	0.8647161774450679	0.0
49022520611	2	0.8647178945811126	0.0	0	2	0.8647178945811126	0.0
49022520612	3	1.629430661322625	0.0	0	3	0.8147153306613125	0.0
49204388889	1	0.06767398131830056	0.0	0	1	0.06767398131830056	0.0
49204388890	4	0.07272717600445809	1.0	2	2	0.07272717600445809	1.0
50448984319	5	3.678946400339091	0.0	0	5	0.7357892800678182	0.0
50448984320	3	2.090700506322815	0.0	0	3	0.6969001687742716	0.0
50448984321	3	1.4224545907581652	1.0	1	2	0.7112272953790826	0.5
50448984322	1	0.6969474405195016	0.0	0	1	0.6969474405195016	0.0
50448984323	16	10.584002615164527	1.0	1	15	0.7056001743443018	0.06666666666666667
50448984324	2	1.3941808346944442	0.0	0	2	0.6970904173472221	0.0
50448984325	9	5.715612439970523	1.0	1	8	0.7144515549963154	0.125
50448984326	5	3.679889882422308	0.0	0	5	0.7359779764844616	0.0
50448984327	24	14.118003575481277	4.0	4	20	0.7059001787740639	0.2
50448984328	2	1.3944878990224345	0.0	0	2	0.6972439495112173	0.0
50448984329	3	2.2861258740853767	0.0	0	3	0.7620419580284589	0.0
50448984330	3	2.0918519975527783	0.0	0	3	0.6972839991842594	0.0
50448984331	3	1.3946142600337226	1.0	1	2	0.6973071300168613	0.5
50448984332	21	14.12116637172891	1.0	1	20	0.7060583185864455	0.05
50448984333	3	2.0924013127404053	0.0	0	3	0.6974671042468018	0.0
50448984334	3	2.315382572692008	0.0	0	3	0.771794190897336	0.0
50448984335	20	11.928205733907815	3.0	3	17	0.7016591608181068	0.17647058823529413
50448984336	5	3.6824962592527966	0.0	0	5	0.7364992518505593	0.0
50448984337	3	2.0930706927738236	0.0	0	3	0.6976902309246079	0.0
50448984338	3	1.3954407075112278	1.0	1	2	0.6977203537556139	0.5
50448984339	14	10.54192756332301	0.0	0	14	0.7529948259516436	0.0
50448984340	19	9.910664448486035	5.0	5	14	0.7079046034632882	0.35714285714285715
50448984341	10	4.438675802593596	1.0	2	8	0.739779300432266	0.25
50448984342	3	2.0937064371423664	0.0	0	3	0.6979021457141221	0.0
50448984343	1	0.6980404817852774	0.0	0	1	0.6980404817852774	0.0
50448984344	2	0.6980550942763243	1.0	1	1	0.6980550942763243	1.0
50448984345	2	0.6980863394184706	1.0	1	1	0.6980863394184706	1.0
50448984346	1	0.6981450924066661	0.0	0	1	0.6981450924066661	0.0
50448984347	2	1.6599491855674244	0.0	0	2	0.8299745927837122	0.0
50448984348	1	0.6981714891646864	0.0	0	1	0.6981714891646864	0.0
50448984349	2	1.3991509334637728	0.0	0	2	0.6995754667318864	0.0
50448984350	4	3.355280262359533	0.0	0	4	0.8388200655898832	0.0
50448984351	1	0.6982451913372709	0.0	0	1	0.6982451913372709	0.0
50448984352	1	0.698257278628252	0.0	0	1	0.698257278628252	0.0
50448984353	1	0.6982698709592464	0.0	0	1	0.6982698709592464	0.0
50448984354	4	3.0086159152855307	0.0	0	4	0.7521539788213827	0.0
50448984355	2	1.681099217568443	0.0	0	2	0.8405496087842215	0.0
50448984356	1	0.6996143211435641	0.0	0	1	0.6996143211435641	0.0
50448984357	1	0.6996371489521581	0.0	0	1	0.6996371489521581	0.0
50448984358	1	0.6996502126538314	0.0	0	1	0.6996502126538314	0.0
50448984359	4	2.1949959827433885	1.0	1	3	0.7316653275811295	0.3333333333333333
50448984360	2	1.3993559797091084	0.0	0	2	0.6996779898545542	0.0
50448984361	7	5.541512521440212	0.0	0	7	0.7916446459200303	0.0
50448984362	1	0.6997470119896836	0.0	0	1	0.6997470119896836	0.0
50448984363	1	0.6997586279099859	0.0	0	1	0.6997586279099859	0.0
50448984364	1	0.6997814557185799	0.0	0	1	0.6997814557185799	0.0
50448984365	1	0.6997923645828638	0.0	0	1	0.6997923645828638	0.0
50448984366	2	1.3996449636046282	0.0	0	2	0.6998224818023141	0.0
50448984367	1	0.6998487943869988	0.0	0	1	0.6998487943869988	0.0
50448984368	2	1.661610935557332	0.0	0	2	0.830805467778666	0.0
50448984369	1	0.699909601204581	0.0	0	1	0.699909601204581	0.0
50448984370	2	1.3999141162622983	0.0	0	2	0.6999570581311492	0.0
50448984371	2	1.3999719938478046	0.0	0	2	0.6999859969239023	0.0
50448984372	4	3.2215802452858133	0.0	0	4	0.8053950613214533	0.0
50448984373	1	0.700009902151191	0.0	0	1	0.700009902151191	0.0
50448984374	2	1.4000486925911337	0.0	0	2	0.7000243462955669	0.0
50448984375	2	1.4003818843224705	0.0	0	2	0.7001909421612352	0.0
50448984376	1	0.7000663319553261	0.0	0	1	0.7000663319553261	0.0
50448984377	1	0.7000779478756283	0.0	0	1	0.7000779478756283	0.0
50448984378	2	1.4001816527919269	0.0	0	2	0.7000908263959634	0.0
50448984379	1	0.7001287549009504	0.0	0	1	0.7001287549009504	0.0
50448984380	2	1.400489154821262	0.0	0	2	0.700244577410631	0.0
50448984381	2	1.4003954867334911	0.0	0	2	0.7001977433667456	0.0
50448984382	1	0.7001991238094482	0.0	0	1	0.7001991238094482	0.0
50448984383	2	1.4004739362821992	0.0	0	2	0.7002369681410996	0.0
50568891850	4	0.0	4.0	4	0	0.0	inf
50568891851	14	1.317424988174488	7.0	7	7	0.164678123521811	1.0
50568891852	11	2.066481750193944	4.0	4	7	0.29521167859913483	0.5714285714285714
50568891853	4	0.6889693907705688	2.0	2	2	0.22965646359018962	1.0
50568891854	1	0.0	1.0	1	0	0.0	inf
50646485256	2	1.784846220534745	0.0	0	2	0.8924231102673725	0.0
50646485257	1	0.8924473521880034	0.0	0	1	0.8924473521880034	0.0
50875585672	1	0.7003525886347748	0.0	0	1	0.7003525886347748	0.0
50875585673	2	1.622706895280997	0.0	0	2	0.8113534476404985	0.0
50875585674	1	0.7004000623960102	0.0	0	1	0.7004000623960102	0.0
50875585675	2	1.4008647699137025	0.0	0	2	0.7004323849568512	0.0
50875585676	1	0.700442957127793	0.0	0	1	0.700442957127793	0.0
50875585677	1	0.7004622833256292	0.0	0	1	0.7004622833256292	0.0
50875585678	1	0.7004705323125106	0.0	0	1	0.7004705323125106	0.0
50875585679	2	1.4010174940136766	0.0	0	2	0.7005087470068383	0.0
50875585680	3	2.21137988480172	0.0	0	3	0.73712662826724	0.0
50875585681	2	1.4011119364961342	0.0	0	2	0.7005559682480671	0.0
50875585682	2	1.40119836567705	0.0	0	2	0.700599182838525	0.0
50875585683	1	0.7005927183263566	0.0	0	1	0.7005927183263566	0.0
50875585684	1	0.7006056810200273	0.0	0	1	0.7006056810200273	0.0
50875585685	1	0.7006272630632555	0.0	0	1	0.7006272630632555	0.0
50875585686	1	0.700668642674999	0.0	0	1	0.700668642674999	0.0
50875585687	2	1.4014277211816846	0.0	0	2	0.7007138605908423	0.0
50875585688	1	0.7007522436318411	0.0	0	1	0.7007522436318411	0.0
50875585689	1	0.7007996163850737	0.0	0	1	0.7007996163850737	0.0
50875585690	4	3.111907506837316	0.0	0	4	0.777976876709329	0.0
50875585691	2	1.4017987572446726	0.0	0	2	0.7008993786223363	0.0
50875585692	3	2.2068909544875783	0.0	0	3	0.7356303181625261	0.0
50875585693	2	1.5932859576620917	0.0	0	2	0.7966429788310458	0.0
50875585694	2	1.402277333161126	0.0	0	2	0.701138666580563	0.0
50875585695	2	1.4050454238038221	0.0	0	2	0.7025227119019111	0.0
50875585696	2	0.7011926048539665	1.0	1	1	0.7011926048539665	1.0
50875585697	2	1.6830811965960168	0.0	0	2	0.8415405982980084	0.0
50875585698	2	1.4043853028373114	0.0	0	2	0.7021926514186557	0.0
50875585699	2	1.4043890064640745	0.0	0	2	0.7021945032320372	0.0
50875585700	1	0.701263411463809	0.0	0	1	0.701263411463809	0.0
50875585701	2	1.4025475295681569	0.0	0	2	0.7012737647840784	0.0
50875585702	3	1.4026341270957434	1.0	1	2	0.7013170635478717	0.5
50875585703	19	12.042945437800165	2.0	2	17	0.7084085551647156	0.11764705882352941
50875585704	24	15.587699743746066	2.0	2	22	0.7085318065339121	0.09090909090909091
50875585705	31	17.009845687717533	7.0	7	24	0.7087435703215639	0.2916666666666667
50875585706	17	12.053878442996657	0.0	0	17	0.7090516731174504	0.0
50875585707	27	17.728754119821826	2.0	2	25	0.7091501647928731	0.08
50875585708	29	19.19945531771276	2.0	2	27	0.7110909376930652	0.07407407407407407
50875585709	8	4.951781708777295	1.0	1	7	0.707397386968185	0.14285714285714285
50875585710	1	0.7025735862659015	0.0	0	1	0.7025735862659015	0.0
50875585711	1	0.7026095787841714	0.0	0	1	0.7026095787841714	0.0
50875585712	1	0.7026226424858446	0.0	0	1	0.7026226424858446	0.0
50875585713	3	2.286994610246649	0.0	0	3	0.7623315367488831	0.0
50875585714	1	0.7026468507371413	0.0	0	1	0.7026468507371413	0.0
50875585715	2	1.405340703864839	0.0	0	2	0.7026703519324194	0.0
50875585716	1	0.7027139200508865	0.0	0	1	0.7027139200508865	0.0
50875585717	2	1.5955307258431701	0.0	0	2	0.7977653629215851	0.0
50875585718	2	1.4055041348130914	0.0	0	2	0.7027520674065457	0.0
50875585719	1	0.7027416299129409	0.0	0	1	0.7027416299129409	0.0
50875585720	1	0.7027525387772248	0.0	0	1	0.7027525387772248	0.0
50875585721	2	1.5158025841685376	0.0	0	2	0.7579012920842688	0.0
50875585722	1	0.7027861744421	0.0	0	1	0.7027861744421	0.0
50875585723	1	0.7027973863303917	0.0	0	1	0.7027973863303917	0.0
50875585724	2	1.4057569241743362	0.0	0	2	0.7028784620871681	0.0
50875585725	2	1.405695174615396	0.0	0	2	0.702847587307698	0.0
50875585726	2	1.4057510657101837	0.0	0	2	0.7028755328550919	0.0
50875585727	2	1.4058109971250765	0.0	0	2	0.7029054985625383	0.0
50875585728	1	0.702920077384251	0.0	0	1	0.702920077384251	0.0
50875585729	2	1.4058705245079588	0.0	0	2	0.7029352622539794	0.0
50875585730	2	1.4668338034863049	0.0	0	2	0.7334169017431524	0.0
50875585731	2	1.4059514655873984	0.0	0	2	0.7029757327936992	0.0
50875585732	1	0.7029926347994724	0.0	0	1	0.7029926347994724	0.0
50875585733	1	0.7030223984909135	0.0	0	1	0.7030223984909135	0.0
50875585734	2	1.5184935383665596	0.0	0	2	0.7592467691832798	0.0
50875585735	2	1.6855213815928471	0.0	0	2	0.8427606907964236	0.0
50875585736	2	1.4062081605914112	0.0	0	2	0.7031040802957056	0.0
50875585737	1	0.7031082889624818	0.0	0	1	0.7031082889624818	0.0
50875585738	1	0.7031440457954122	0.0	0	1	0.7031440457954122	0.0
50875585739	2	1.4064338461386172	0.0	0	2	0.7032169230693086	0.0
50875585740	1	0.7031983544314921	0.0	0	1	0.7031983544314921	0.0
50875585741	2	1.4064205130822702	0.0	0	2	0.7032102565411351	0.0
50875585742	2	1.5187466980904807	0.0	0	2	0.7593733490452403	0.0
50875585743	1	0.7032675449132926	0.0	0	1	0.7032675449132926	0.0
50875585744	1	0.7032791608335948	0.0	0	1	0.7032791608335948	0.0
50875585745	1	0.7033043118262493	0.0	0	1	0.7033043118262493	0.0
50875585746	1	0.7033399676511771	0.0	0	1	0.7033399676511771	0.0
50875585747	4	3.3701554078826037	0.0	0	4	0.8425388519706509	0.0
50875585748	1	0.7034707056759124	0.0	0	1	0.7034707056759124	0.0
50875585749	2	1.4069954843025652	0.0	0	2	0.7034977421512826	0.0
50875585750	1	0.7035308727761447	0.0	0	1	0.7035308727761447	0.0
50875585751	1	0.7035537005847387	0.0	0	1	0.7035537005847387	0.0
50875585752	2	1.4073179018469548	0.0	0	2	0.7036589509234774	0.0
50875585753	2	1.68355785336042	0.0	0	2	0.84177892668021	0.0
50875585754	3	2.3303817897116414	0.0	0	3	0.7767939299038805	0.0
50875585755	2	1.4073610322640773	0.0	0	2	0.7036805161320386	0.0
50875585756	1	0.703711273068839	0.0	0	1	0.703711273068839	0.0
50875585757	2	1.407555169645129	0.0	0	2	0.7037775848225645	0.0
50875585758	2	1.4075766843496886	0.0	0	2	0.7037883421748443	0.0
50875585759	2	1.4076929108913798	0.0	0	2	0.7038464554456899	0.0
50875585760	4	2.818473872108448	0.0	0	4	0.704618468027112	0.0
50875585761	2	1.4085727916022754	0.0	0	2	0.7042863958011377	0.0
50875585762	4	2.819650514331066	0.0	0	4	0.7049126285827665	0.0
50875585763	2	1.4094210904776827	0.0	0	2	0.7047105452388414	0.0
50875585764	1	0.7049356247380315	0.0	0	1	0.7049356247380315	0.0
50875585765	21	13.402958127098843	2.0	2	19	0.705418848794676	0.10526315789473684
50875585766	1	0.7051362939699198	0.0	0	1	0.7051362939699198	0.0
50875585767	1	0.7053354480817688	0.0	0	1	0.7053354480817688	0.0
50875585768	3	2.117821660068543	0.0	0	3	0.705940553356181	0.0
50875585769	12	5.701649363041852	4.0	4	8	0.7127061703802315	0.5
50875585770	10	5.702865061692153	2.0	2	8	0.7128581327115191	0.25
50875585771	3	1.4162069427715929	1.0	1	2	0.7081034713857964	0.5
50875585772	6	4.28779230411274	0.0	0	6	0.7146320506854567	0.0
50875585773	6	3.58106846736551	1.0	1	5	0.716213693473102	0.2
50875585774	8	4.288738008372015	2.0	2	6	0.7147896680620024	0.3333333333333333
50875585775	6	3.541918203248101	1.0	1	5	0.7083836406496202	0.2
50875585776	3	1.4169858828185287	1.0	1	2	0.7084929414092643	0.5
50875585777	7	4.29070392712717	1.0	1	6	0.7151173211878618	0.16666666666666666
50875585778	3	1.4172290427501895	1.0	1	2	0.7086145213750947	0.5
50875585779	9	5.709989627488211	1.0	1	8	0.7137487034360264	0.125
50875585780	10	5.7113878139299254	2.0	2	8	0.7139234767412407	0.25
50875585781	4	2.1270138933477374	1.0	1	3	0.7090046311159125	0.3333333333333333
50875585782	5	3.5855900569338335	0.0	0	5	0.7171180113867667	0.0
50875585783	3	1.4182329949576469	1.0	1	2	0.7091164974788234	0.5
50875585784	10	4.295593556187739	4.0	4	6	0.7159322593646231	0.6666666666666666
50875585785	11	4.296505490104801	5.0	5	6	0.7160842483508002	0.8333333333333334
50875585786	3	1.5251683828655815	1.0	1	2	0.7625841914327908	0.5
50875585787	1	0.710199387440335	0.0	0	1	0.710199387440335	0.0
50875585788	1	0.7102083434832347	0.0	0	1	0.7102083434832347	0.0
50875585789	2	0.7102086128379084	1.0	1	1	0.7102086128379084	1.0
50875585790	2	1.421971705166933	0.0	0	2	0.7109858525834665	0.0
50875585791	1	0.7109741524898288	0.0	0	1	0.7109741524898288	0.0
50875585792	3	1.4219869573753299	1.0	1	2	0.7109934786876649	0.5
50875585793	3	1.4520371075119414	1.0	1	2	0.7260185537559707	0.5
50875585794	2	1.4223165464879064	0.0	0	2	0.7111582732439532	0.0
50875585795	1	0.7111611183026938	0.0	0	1	0.7111611183026938	0.0
50875585796	2	1.4223735823400572	0.0	0	2	0.7111867911700286	0.0
50875585797	5	3.5562999920170006	0.0	0	5	0.7112599984034002	0.0
50875585798	1	0.7112851897992557	0.0	0	1	0.7112851897992557	0.0
50875585799	23	14.946278961140772	2.0	2	21	0.711727569578132	0.09523809523809523
50875585800	2	1.4226414218936934	0.0	0	2	0.7113207109468467	0.0
50875585801	10	7.1148218907371525	0.0	0	10	0.7114821890737153	0.0
50875585802	2	1.4229245473250605	0.0	0	2	0.7114622736625302	0.0
50875585803	5	3.5576563948149627	0.0	0	5	0.7115312789629925	0.0
50875585804	2	1.423922203367021	0.0	0	2	0.7119611016835105	0.0
50875585805	4	2.851435544251488	0.0	0	4	0.712858886062872	0.0
50875585806	2	1.4257085298935035	0.0	0	2	0.7128542649467517	0.0
50875585807	2	1.425877381604564	0.0	0	2	0.712938690802282	0.0
50875585808	18	10.0207701072338	4.0	4	14	0.7157692933738428	0.2857142857142857
50875585809	2	1.564546723052925	0.0	0	2	0.7822733615264625	0.0
50875585810	2	1.4264159226052442	0.0	0	2	0.7132079613026221	0.0
50875585811	1	0.7132179442602152	0.0	0	1	0.7132179442602152	0.0
50875585812	1	0.7132202337749415	0.0	0	1	0.7132202337749415	0.0
50875585813	1	0.7132324557432594	0.0	0	1	0.7132324557432594	0.0
50875585814	1	0.713233028121941	0.0	0	1	0.713233028121941	0.0
50875585815	1	0.7132710071309293	0.0	0	1	0.7132710071309293	0.0
50875585816	2	0.7132826567205658	1.0	1	1	0.7132826567205658	1.0
50875585817	7	3.790912054116586	0.5	1	6	0.7581824108233172	0.16666666666666666
50875585818	2	1.426637231139003	0.0	0	2	0.7133186155695015	0.0
50875585819	2	0.7133605338905923	1.0	1	1	0.7133605338905923	1.0
50875585820	45	23.732139436699246	12.0	12	33	0.7191557405060377	0.36363636363636365
50875585821	3	1.4271187699568666	1.0	1	2	0.7135593849784333	0.5
50875585822	5	3.7535539413204786	0.0	0	5	0.7507107882640958	0.0
50875585823	2	1.4272029096230558	0.0	0	2	0.7136014548115279	0.0
50875585824	4	2.1505650539179033	1.0	1	3	0.7168550179726344	0.3333333333333333
50875585825	1	0.7137889761684075	0.0	0	1	0.7137889761684075	0.0
50875585826	2	1.4277244139406262	0.0	0	2	0.7138622069703131	0.0
50875585827	1	0.714028567150642	0.0	0	1	0.714028567150642	0.0
50875585828	5	2.865592421867869	1.0	1	4	0.7163981054669672	0.25
50875585829	27	18.72841190470892	1.0	1	26	0.7203235347964969	0.038461538461538464
50875585830	3	1.4281685797975174	1.0	1	2	0.7140842898987587	0.5
50875585831	8	3.770638704239713	0.5	1	7	0.7541277408479427	0.14285714285714285
50875585832	1	0.714157015660651	0.0	0	1	0.714157015660651	0.0
50875585833	1	0.7142914573121495	0.0	0	1	0.7142914573121495	0.0
50875585834	5	3.7569986509034474	0.0	0	5	0.7513997301806895	0.0
50875585835	1	0.7143996705522986	0.0	0	1	0.7143996705522986	0.0
50875585836	31	20.10753079641409	3.0	3	28	0.7181260998719318	0.10714285714285714
50875585837	2	1.4291661011621408	0.0	0	2	0.7145830505810704	0.0
50875585838	5	3.573155736124943	0.0	0	5	0.7146311472249887	0.0
50875585839	2	1.4292427325668016	0.0	0	2	0.7146213662834008	0.0
50875585840	1	0.7146508774548354	0.0	0	1	0.7146508774548354	0.0
50875585841	2	0.7147263977714672	1.0	1	1	0.7147263977714672	1.0
50875585842	1	0.7147266671261409	0.0	0	1	0.7147266671261409	0.0
50875585843	6	5.214605474357654	0.0	0	6	0.8691009123929424	0.0
50875585844	6	4.474658489417913	0.0	0	6	0.7457764149029855	0.0
50875585845	46	26.00324067341766	10.0	10	36	0.7223122409282684	0.2777777777777778
50875585846	6	2.8687202356772588	2.0	2	4	0.7171800589193147	0.5
50875585847	2	1.4300844322527038	0.0	0	2	0.7150422161263519	0.0
50875585848	5	3.7609170543494095	0.0	0	5	0.7521834108698819	0.0
50875585849	2	0.7151080733440656	1.0	1	1	0.7151080733440656	1.0
50875585850	1	0.7151298910726333	0.0	0	1	0.7151298910726333	0.0
50875585851	5	2.8696039883615887	1.0	1	4	0.7174009970903972	0.25
50875585852	35	20.905779398454914	6.0	6	29	0.7208889447743074	0.20689655172413793
50875585853	2	0.7152014720771626	1.0	1	1	0.7152014720771626	1.0
50875585854	5	3.5762503519708027	0.0	0	5	0.7152500703941606	0.0
50875585855	1	0.7152726153803471	0.0	0	1	0.7152726153803471	0.0
50875585856	3	0.7350428780654624	0.5	1	2	0.7350428780654624	0.5
50875585857	2	0.9777572297572135	0.0	0	2	0.9777572297572135	0.0
50875585858	6	4.567823894028868	0.0	0	6	0.7613039823381446	0.0
50875585859	1	0.7155808918043689	0.0	0	1	0.7155808918043689	0.0
50875585860	30	18.008519721997693	5.0	5	25	0.7203407888799077	0.2
50875585861	5	3.763877935599789	0.0	0	5	0.7527755871199578	0.0
50875585862	2	1.4314692856380729	0.0	0	2	0.7157346428190364	0.0
50875585863	5	2.163245396551863	2.0	2	3	0.7210817988506211	0.6666666666666666
50875585864	1	0.7159589647582069	0.0	0	1	0.7159589647582069	0.0
50875585865	6	4.48814985897431	0.0	0	6	0.7480249764957184	0.0
50875585866	2	1.4323785596777334	0.0	0	2	0.7161892798388667	0.0
50875585867	1	0.7161921248976073	0.0	0	1	0.7161921248976073	0.0
50875585868	6	4.489755919885436	0.0	0	6	0.7482926533142393	0.0
50875585869	1	0.7163032673698327	0.0	0	1	0.7163032673698327	0.0
50875585870	1	0.7164303691064734	0.0	0	1	0.7164303691064734	0.0
50875585871	2	1.4328920170244275	0.0	0	2	0.7164460085122137	0.0
50875585872	5	2.866124026985702	1.0	1	4	0.7165310067464254	0.25
50875585873	3	2.1495611017104457	0.0	0	3	0.7165203672368152	0.0
50875585874	9	6.466865722015135	0.0	0	9	0.7185406357794595	0.0
50875585875	1	0.7165858877611869	0.0	0	1	0.7165858877611869	0.0
50875585876	21	12.247582937418436	4.0	4	17	0.7204460551422609	0.23529411764705882
50875585877	6	4.492098127119716	0.0	0	6	0.7486830211866193	0.0
50875585878	3	2.150242232341503	0.0	0	3	0.716747410780501	0.0
50875585879	2	1.4673675971108613	0.0	0	2	0.7336837985554306	0.0
50875585880	12	7.3610892999293585	2.0	2	10	0.7361089299929359	0.2
50875585881	22	11.634940816212673	6.0	6	16	0.727183801013292	0.375
50875585882	6	4.32701425024268	0.0	0	6	0.7211690417071134	0.0
50875585883	3	2.1510515084585617	0.0	0	3	0.7170171694861872	0.0
50875585884	3	1.4341079850294018	1.0	1	2	0.7170539925147009	0.5
50875585885	25	15.222942809571935	4.0	4	21	0.7249020385510445	0.19047619047619047
50875585886	1	0.7171902859795808	0.0	0	1	0.7171902859795808	0.0
50875585887	1	0.7172014978678726	0.0	0	1	0.7172014978678726	0.0
50875585888	3	1.4344578767505065	1.0	1	2	0.7172289383752533	0.5
50875585889	6	4.495224358470399	0.0	0	6	0.7492040597450664	0.0
50875585890	3	2.151944856903141	0.0	0	3	0.717314952301047	0.0
50875585891	2	1.4674732851509449	0.0	0	2	0.7337366425754724	0.0
50875585892	21	14.478752747796452	1.0	1	20	0.7239376373898226	0.05
50875585893	2	1.4349038270821108	0.0	0	2	0.7174519135410554	0.0
50875585894	1	0.7174673846001246	0.0	0	1	0.7174673846001246	0.0
50875585895	1	0.7174752295549954	0.0	0	1	0.7174752295549954	0.0
50875585896	5	3.778934626172917	0.0	0	5	0.7557869252345835	0.0
50875585897	3	2.1526723502074048	0.0	0	3	0.717557450069135	0.0
50875585898	2	1.435185336385436	0.0	0	2	0.717592668192718	0.0
50875585899	12	8.644886670199478	0.0	0	12	0.7204072225166231	0.0
50875585900	2	1.435402806615095	0.0	0	2	0.7177014033075475	0.0
50875585901	3	1.4354532432777407	1.0	1	2	0.7177266216388704	0.5
50875585902	1	0.7177232715401165	0.0	0	1	0.7177232715401165	0.0
50875585903	9	6.588225254714406	0.0	0	9	0.7320250283016007	0.0
50875585904	6	3.971020837715257	0.0	0	6	0.7942041675430513	0.0
50875585905	3	2.1534645223026847	0.0	0	3	0.7178215074342282	0.0
50875585906	3	1.4676026090636434	1.0	1	2	0.7338013045318217	0.5
50875585907	2	1.4358431678372203	0.0	0	2	0.7179215839186102	0.0
50875585908	1	0.7179249845213653	0.0	0	1	0.7179249845213653	0.0
50875585909	22	14.521248767323588	2.0	2	20	0.7260624383661793	0.1
50875585910	3	2.1540233995812277	0.0	0	3	0.7180077998604092	0.0
50875585911	2	1.4360876745422493	0.0	0	2	0.7180438372711246	0.0
50875585912	1	0.7180651836290135	0.0	0	1	0.7180651836290135	0.0
50875585913	25	14.522870518144455	5.0	5	20	0.7261435259072228	0.25
50875585914	5	3.7817292819203048	0.0	0	5	0.7563458563840609	0.0
50875585915	2	1.436366961669517	0.0	0	2	0.7181834808347585	0.0
50875585916	26	12.275750298386058	9.0	9	17	0.7221029587285916	0.5294117647058824
50875585917	2	1.517148414795558	0.0	0	2	0.758574207397779	0.0
50875585918	1	0.7183432923295836	0.0	0	1	0.7183432923295836	0.0
50875585919	2	1.6046977744603756	0.0	0	2	0.8023488872301878	0.0
50875585920	7	3.5965306377305226	0.5	1	6	0.7193061275461046	0.16666666666666666
50875585921	2	1.4368577932236222	0.0	0	2	0.7184288966118111	0.0
50875585922	2	1.4369558719941744	0.0	0	2	0.7184779359970872	0.0
50875585923	13	8.815197340849855	1.0	1	12	0.7345997784041546	0.08333333333333333
50875585924	15	10.189079539997437	1.0	1	14	0.7277913957141026	0.07142857142857142
50875585925	7	4.693246237948524	0.0	0	7	0.782207706324754	0.0
50875585926	2	1.4374130678834045	0.0	0	2	0.7187065339417023	0.0
50875585927	26	14.505133748568255	6.0	6	20	0.7252566874284128	0.3
50875585928	1	0.7188485343587306	0.0	0	1	0.7188485343587306	0.0
50875585929	3	2.156917144179193	0.0	0	3	0.7189723813930643	0.0
50875585930	4	2.8756668927113536	0.0	0	4	0.7189167231778384	0.0
50875585931	1	0.7189114960137023	0.0	0	1	0.7189114960137023	0.0
50875585932	1	0.7189687675511927	0.0	0	1	0.7189687675511927	0.0
50875585933	21	14.509057202414347	1.0	1	20	0.7254528601207173	0.05
50875585934	2	1.43818712587688	0.0	0	2	0.71909356293844	0.0
50875585935	5	3.595542207086135	0.0	0	5	0.719108441417227	0.0
50875585936	3	1.4676421368620054	1.0	1	2	0.7338210684310027	0.5
50875585937	3	1.4385184657948353	1.0	1	2	0.7192592328974177	0.5
50875585938	5	3.788036793983101	0.0	0	5	0.7576073587966202	0.0
50875585939	2	1.467597423986175	0.0	0	2	0.7337987119930875	0.0
50875585940	2	1.441732102737125	0.0	0	2	0.7208660513685625	0.0
50875585941	2	1.4417359747105591	0.0	0	2	0.7208679873552796	0.0
50875585942	4	3.1507921872464806	0.0	0	4	0.7876980468116201	0.0
50875585943	1	0.7194732351856529	0.0	0	1	0.7194732351856529	0.0
50875585944	1	0.7195045813358019	0.0	0	1	0.7195045813358019	0.0
50875585945	1	0.7195124262906727	0.0	0	1	0.7195124262906727	0.0
50875585946	1	0.7195236381789645	0.0	0	1	0.7195236381789645	0.0
50875585947	5	3.8356800803161764	0.0	0	5	0.7671360160632352	0.0
50875585948	1	0.7195588899718818	0.0	0	1	0.7195588899718818	0.0
50875585949	2	1.4391411127923706	0.0	0	2	0.7195705563961853	0.0
50875585950	2	1.4392248147572153	0.0	0	2	0.7196124073786077	0.0
50875585951	4	2.8793503178738677	0.0	0	4	0.7198375794684669	0.0
50875585952	2	1.4418996413441512	0.0	0	2	0.7209498206720756	0.0
50875585953	1	0.7210645489283943	0.0	0	1	0.7210645489283943	0.0
50875585954	1	0.7210773096060596	0.0	0	1	0.7210773096060596	0.0
50875585955	2	1.4422742126872314	0.0	0	2	0.7211371063436157	0.0
50875585956	1	0.7211392275116709	0.0	0	1	0.7211392275116709	0.0
50875585957	2	1.4424829962286643	0.0	0	2	0.7212414981143321	0.0
50875585958	1	0.7211994282812374	0.0	0	1	0.7211994282812374	0.0
50875585959	2	1.6579679472652034	0.0	0	2	0.8289839736326017	0.0
50875585960	1	0.721274914928535	0.0	0	1	0.721274914928535	0.0
50875585961	1	0.7213506372611721	0.0	0	1	0.7213506372611721	0.0
50875585962	1	0.7213618491494638	0.0	0	1	0.7213618491494638	0.0
50875585963	2	1.4427883434206097	0.0	0	2	0.7213941717103048	0.0
50875585964	6	4.973560616602679	0.0	0	6	0.8289267694337799	0.0
50875585965	2	1.4430034231275397	0.0	0	2	0.7215017115637699	0.0
50875585966	1	0.7215278389671164	0.0	0	1	0.7215278389671164	0.0
50875585967	1	0.7215436972235291	0.0	0	1	0.7215436972235291	0.0
50875585968	1	0.7215553131438314	0.0	0	1	0.7215553131438314	0.0
50875585969	1	0.7215777369204148	0.0	0	1	0.7215777369204148	0.0
50875585970	1	0.7215889488087066	0.0	0	1	0.7215889488087066	0.0
50875585971	1	0.7216031909370771	0.0	0	1	0.7216031909370771	0.0
50875585972	1	0.7216294866870947	0.0	0	1	0.7216294866870947	0.0
50875585973	2	1.4433155378556615	0.0	0	2	0.7216577689278307	0.0
50875585974	1	0.7216746035949354	0.0	0	1	0.7216746035949354	0.0
50875585975	1	0.7216978354355399	0.0	0	1	0.7216978354355399	0.0
50875585976	1	0.7217129529666	0.0	0	1	0.7217129529666	0.0
50875585977	2	1.4435296411518994	0.0	0	2	0.7217648205759497	0.0
50875585978	2	1.4439216532101	0.0	0	2	0.72196082660505	0.0
50875585979	2	1.4436405816081195	0.0	0	2	0.7218202908040597	0.0
50875585980	2	1.4436468104349482	0.0	0	2	0.7218234052174741	0.0
50875585981	1	0.7218559802983218	0.0	0	1	0.7218559802983218	0.0
50875585982	1	0.7218696163786765	0.0	0	1	0.7218696163786765	0.0
50875585983	2	1.4438841119024564	0.0	0	2	0.7219420559512282	0.0
50875585984	1	0.7219152383265304	0.0	0	1	0.7219152383265304	0.0
50875585985	3	2.713217573897539	0.0	0	3	0.9044058579658464	0.0
50875585986	1	0.721955203826237	0.0	0	1	0.721955203826237	0.0
50875585987	3	2.645411036410456	0.0	0	3	0.8818036788034854	0.0
50875585988	1	0.7220042937155144	0.0	0	1	0.7220042937155144	0.0
50875585989	1	0.7220374243403765	0.0	0	1	0.7220374243403765	0.0
50875585990	1	0.7220779958880988	0.0	0	1	0.7220779958880988	0.0
50875585991	2	1.4441924893344809	0.0	0	2	0.7220962446672404	0.0
50875585992	1	0.7221472873779019	0.0	0	1	0.7221472873779019	0.0
50875585993	2	1.689465340063474	0.0	0	2	0.844732670031737	0.0
50875585994	3	2.227610019010716	0.0	0	3	0.742536673003572	0.0
50875585995	2	1.4443871317555457	0.0	0	2	0.7221935658777728	0.0
50875585996	1	0.7221968486378583	0.0	0	1	0.7221968486378583	0.0
50875585997	2	1.4444565915920198	0.0	0	2	0.7222282957960099	0.0
50875585998	1	0.723792539394047	0.0	0	1	0.723792539394047	0.0
50875585999	4	3.008614837866836	0.0	0	4	0.752153709466709	0.0
50875586000	2	1.4479737575822078	0.0	0	2	0.7239868787911039	0.0
50875586001	5	3.807482753641111	0.0	0	5	0.7614965507282222	0.0
50875586002	2	1.4480521734615817	0.0	0	2	0.7240260867307908	0.0
50875586003	1	0.7240631735024226	0.0	0	1	0.7240631735024226	0.0
50875586004	20	10.900728324936818	5.0	5	15	0.7267152216624545	0.3333333333333333
50875586005	9	5.069594816834949	2.0	2	7	0.7242278309764213	0.2857142857142857
50875586006	5	2.89698032199129	1.0	1	4	0.7242450804978225	0.25
50875586007	3	2.1726971193898095	0.0	0	3	0.7242323731299365	0.0
50875586008	9	6.519186419595257	0.0	0	9	0.7243540466216952	0.0
50875586009	2	1.4486217239190688	0.0	0	2	0.7243108619595344	0.0
50875586010	1	0.724402425713917	0.0	0	1	0.724402425713917	0.0
50875586011	9	7.035194757065148	0.0	0	9	0.781688306340572	0.0
50875586012	27	16.688115065084336	4.0	4	23	0.7255702202210581	0.17391304347826086
50875586013	1	0.7251797833021448	0.0	0	1	0.7251797833021448	0.0
50875586014	22	14.55729694100294	2.0	2	20	0.727864847050147	0.1
50875586015	9	6.549489628447786	0.0	0	9	0.7277210698275317	0.0
50875586016	12	8.026767996099206	1.0	1	11	0.7297061814635643	0.09090909090909091
50875586017	9	5.833604803563508	1.0	1	8	0.7292006004454386	0.125
50875586018	8	5.109967412461498	1.0	1	7	0.7299953446373568	0.14285714285714285
50875586019	8	5.8433256453897915	0.0	0	8	0.7304157056737239	0.0
50875586020	24	16.75005317229605	1.0	1	23	0.728263181404176	0.043478260869565216
50875586021	12	8.03241841743557	1.0	1	11	0.7302198561305064	0.09090909090909091
50875586022	1	0.7278966965568425	0.0	0	1	0.7278966965568425	0.0
50875586023	1	0.7279079084451343	0.0	0	1	0.7279079084451343	0.0
50875586024	2	1.455874199515788	0.0	0	2	0.727937099757894	0.0
50875586025	1	0.7279388505632728	0.0	0	1	0.7279388505632728	0.0
50875586026	11	8.025916094605037	0.0	0	11	0.7296287358731852	0.0
50875586027	1	0.7282420765871631	0.0	0	1	0.7282420765871631	0.0
50875586028	12	8.764612903496246	0.0	0	12	0.7303844086246872	0.0
50875586029	2	1.456880003536627	0.0	0	2	0.7284400017683135	0.0
50875586030	4	2.922574032721273	0.0	0	4	0.7306435081803182	0.0
50875586031	9	5.848531564175922	1.0	1	8	0.7310664455219903	0.125
50875586032	2	1.4573223512494706	0.0	0	2	0.7286611756247353	0.0
50875586033	12	7.307288902449399	2.0	2	10	0.7307288902449399	0.2
50875586034	2	1.554749249821982	0.0	0	2	0.777374624910991	0.0
50875586035	1	0.7288719624915536	0.0	0	1	0.7288719624915536	0.0
50875586036	11	7.3095626262578985	1.0	1	10	0.7309562626257898	0.1
50875586037	2	1.4583796020129818	0.0	0	2	0.7291898010064909	0.0
50875586038	12	8.038045640600664	1.0	1	11	0.7307314218727877	0.09090909090909091
50875586039	10	5.849083135208942	2.0	2	8	0.7311353919011178	0.25
50875586040	3	2.188692073299353	0.0	0	3	0.7295640244331176	0.0
50875586041	5	2.1958219588502152	2.0	2	3	0.7319406529500717	0.6666666666666666
50875586042	12	8.048190951723326	1.0	1	11	0.7316537228839387	0.09090909090909091
50875586043	22	16.09125924892402	0.0	0	22	0.7314208749510918	0.0
50875586044	1	0.7315084733761592	0.0	0	1	0.7315084733761592	0.0
50875586045	2	1.4634652539373172	0.0	0	2	0.7317326269686586	0.0
50875586046	6	3.659318659945684	1.0	1	5	0.7318637319891368	0.2
50875586047	5	3.659979993008226	0.0	0	5	0.7319959986016452	0.0
50875586048	5	3.660771963087501	0.0	0	5	0.7321543926175001	0.0
50875586049	5	3.661416697168278	0.0	0	5	0.7322833394336555	0.0
50875586050	5	3.6620659766091728	0.0	0	5	0.7324131953218346	0.0
50875586051	2	1.4650515509492614	0.0	0	2	0.7325257754746307	0.0
50875586052	3	2.197673603885064	0.0	0	3	0.7325578679616881	0.0
50875586053	5	3.6638415626180425	0.0	0	5	0.7327683125236085	0.0
50875586054	3	2.1981013054375267	0.0	0	3	0.7327004351458423	0.0
50875586055	3	1.46559463731006	1.0	1	2	0.73279731865503	0.5
50875586056	5	3.664755786049832	0.0	0	5	0.7329511572099664	0.0
50875586057	6	3.665388331831625	1.0	1	5	0.733077666366325	0.2
50875586058	5	3.666051786062222	0.0	0	5	0.7332103572124444	0.0
50875586059	6	3.666825238007682	1.0	1	5	0.7333650476015363	0.2
50875586060	1	0.7339697017068703	0.0	0	1	0.7339697017068703	0.0
50875586061	1	0.733980913595162	0.0	0	1	0.733980913595162	0.0
50875586062	13	9.547989726947423	0.0	0	13	0.7344607482267248	0.0
50875586063	1	0.7344041371261748	0.0	0	1	0.7344041371261748	0.0
50875586064	1	0.7344561899168627	0.0	0	1	0.7344561899168627	0.0
50875586065	2	0.7344678395064992	1.0	1	1	0.7344678395064992	1.0
50875586066	6	4.584181230982508	0.0	0	6	0.7640302051637513	0.0
50875586067	1	0.7344988152939719	0.0	0	1	0.7344988152939719	0.0
50875586068	2	1.5084286296139908	0.0	0	2	0.7542143148069954	0.0
50875586069	23	15.628467011308217	2.0	2	21	0.7442127148242008	0.09523809523809523
50875586070	1	0.7347686413383264	0.0	0	1	0.7347686413383264	0.0
50875586071	5	3.851196020607922	0.0	0	5	0.7702392041215844	0.0
50875586072	2	1.4697129355932237	0.0	0	2	0.7348564677966118	0.0
50875586073	19	11.800449499079429	3.0	3	16	0.7375280936924643	0.1875
50875586074	2	1.4700039059794616	0.0	0	2	0.7350019529897308	0.0
50875586075	1	0.7350047980484715	0.0	0	1	0.7350047980484715	0.0
50875586076	1	0.7350248313023261	0.0	0	1	0.7350248313023261	0.0
50875586077	1	0.7350360431906179	0.0	0	1	0.7350360431906179	0.0
50875586078	2	1.4704134597607856	0.0	0	2	0.7352067298803928	0.0
50875586079	2	1.4702125211742234	0.0	0	2	0.7351062605871117	0.0
50875586080	2	1.4702870987494974	0.0	0	2	0.7351435493747487	0.0
50875586081	18	12.000562749251978	2.0	2	16	0.7500351718282486	0.125
50875586082	3	2.5197846899948244	0.0	0	3	0.8399282299982748	0.0
50875586083	9	6.775030599532664	0.0	0	9	0.7527811777258515	0.0
50875586084	6	4.5891548313625945	0.0	0	6	0.7648591385604324	0.0
50875586085	1	0.7353996383307458	0.0	0	1	0.7353996383307458	0.0
50875586086	21	14.90685563872293	1.0	1	20	0.7453427819361466	0.05
50875586087	1	0.7355157301951	0.0	0	1	0.7355157301951	0.0
50875586088	1	0.7355224640619419	0.0	0	1	0.7355224640619419	0.0
50875586089	1	0.7355230027712892	0.0	0	1	0.7355230027712892	0.0
50875586090	1	0.7355232721259629	0.0	0	1	0.7355232721259629	0.0
50875586091	3	2.2067498799772407	0.0	0	3	0.7355832933257469	0.0
50875586092	23	16.422096719404852	1.0	1	22	0.7464589417911296	0.045454545454545456
50875586093	5	3.856093124260684	0.0	0	5	0.7712186248521368	0.0
50875586094	3	2.207573600238675	0.0	0	3	0.7358578667462251	0.0
50875586095	3	1.47211749843446	1.0	1	2	0.73605874921723	0.5
50875586096	5	3.680570474344018	0.0	0	5	0.7361140948688036	0.0
50875586097	2	1.472276956401276	0.0	0	2	0.736138478200638	0.0
50875586098	38	26.756723370426947	2.0	2	36	0.743242315845193	0.05555555555555555
50875586099	3	1.472652470485714	1.0	1	2	0.736326235242857	0.5
50875586100	3	1.4727082942418335	1.0	1	2	0.7363541471209167	0.5
50875586101	7	3.9204665344157665	0.5	1	6	0.7840933068831533	0.16666666666666666
50875586102	2	1.4728537120962841	0.0	0	2	0.7364268560481421	0.0
50875586103	4	2.955334126560401	0.0	0	4	0.7388335316401002	0.0
50875586104	1	0.7365725095879321	0.0	0	1	0.7365725095879321	0.0
50875586105	9	3.902563303651234	1.0	2	7	0.7805126607302468	0.2857142857142857
50875586106	33	21.43039142924202	4.0	4	29	0.738979014801449	0.13793103448275862
50875586107	4	2.9561901693826766	0.0	0	4	0.7390475423456692	0.0
50875586108	3	2.2730934848929234	0.0	0	3	0.7576978282976411	0.0
50875586109	7	4.780371667026311	0.0	0	7	0.7967286111710519	0.0
50875586110	1	0.736962939187425	0.0	0	1	0.736962939187425	0.0
50875586111	1	0.7369741510757167	0.0	0	1	0.7369741510757167	0.0
50875586112	1	0.7369887635667636	0.0	0	1	0.7369887635667636	0.0
50875586113	1	0.737025799834394	0.0	0	1	0.737025799834394	0.0
50875586114	5	3.6855953531201053	0.0	0	5	0.737119070624021	0.0
50875586115	32	22.23903819910543	2.0	2	30	0.7413012733035144	0.06666666666666667
50875586116	1	0.7372854577398174	0.0	0	1	0.7372854577398174	0.0
50875586117	2	1.4745988273576942	0.0	0	2	0.7372994136788471	0.0
50875586118	1	0.7373278811009213	0.0	0	1	0.7373278811009213	0.0
50875586119	3	1.4747249526836428	1.0	1	2	0.7373624763418214	0.5
50875586120	2	1.4748163985953557	0.0	0	2	0.7374081992976779	0.0
50875586121	3	2.2285406730775996	0.0	0	3	0.7428468910258665	0.0
50875586122	3	2.261616989303623	0.0	0	3	0.7538723297678743	0.0
50875586123	5	3.8674843354264326	0.0	0	5	0.7734968670852865	0.0
50875586124	1	0.7376314101488195	0.0	0	1	0.7376314101488195	0.0
50875586125	39	26.80388441088614	3.0	3	36	0.7445523447468373	0.08333333333333333
50875586126	1	0.7377418792343607	0.0	0	1	0.7377418792343607	0.0
50875586127	2	0.7377491181412157	1.0	1	1	0.7377491181412157	1.0
50875586128	1	0.7377542022106813	0.0	0	1	0.7377542022106813	0.0
50875586129	3	2.4296016140001404	0.0	0	3	0.8098672046667135	0.0
50875586130	4	2.9596979752979546	0.0	0	4	0.7399244938244887	0.0
50875586131	2	1.4756176277415383	0.0	0	2	0.7378088138707691	0.0
50875586132	5	3.6892964883524133	0.0	0	5	0.7378592976704826	0.0
50875586133	2	1.4760224341467385	0.0	0	2	0.7380112170733693	0.0
50875586134	1	0.7380138937854389	0.0	0	1	0.7380138937854389	0.0
50875586135	1	0.7380285062764858	0.0	0	1	0.7380285062764858	0.0
50875586136	1	0.7380397181647775	0.0	0	1	0.7380397181647775	0.0
50875586137	1	0.7380651721814399	0.0	0	1	0.7380651721814399	0.0
50875586138	4	2.9605570820296427	0.0	0	4	0.7401392705074107	0.0
50875586139	29	17.85611450428791	5.0	5	24	0.7440047710119962	0.20833333333333334
50875586140	2	1.476379699452035	0.0	0	2	0.7381898497260175	0.0
50875586141	7	5.5751010829168965	0.0	0	7	0.7964430118452709	0.0
50875586142	2	0.7384107205584315	1.0	1	1	0.7384107205584315	1.0
50875586143	1	0.7385201795639464	0.0	0	1	0.7385201795639464	0.0
50875586144	1	0.7385346910469907	0.0	0	1	0.7385346910469907	0.0
50875586145	2	1.5901961228616899	0.0	0	2	0.7950980614308449	0.0
50875586146	5	2.962181358050575	1.0	1	4	0.7405453395126438	0.25
50875586147	2	1.4771578651042838	0.0	0	2	0.7385789325521419	0.0
50875586148	6	4.611216494256668	0.0	0	6	0.7685360823761114	0.0
50875586149	1	0.7388095001528082	0.0	0	1	0.7388095001528082	0.0
50875586150	5	3.873693196339995	0.0	0	5	0.774738639267999	0.0
50875586151	2	1.4777583913492438	0.0	0	2	0.7388791956746219	0.0
50875586152	6	3.740032370371296	1.0	1	5	0.7480064740742592	0.2
50875586153	2	1.4780452540767084	0.0	0	2	0.7390226270383542	0.0
50875586154	2	1.4964523800970195	0.0	0	2	0.7482261900485098	0.0
50875586155	1	0.7390277111078197	0.0	0	1	0.7390277111078197	0.0
50875586156	1	0.7390282834865013	0.0	0	1	0.7390282834865013	0.0
50875586157	21	14.229389241307679	2.0	2	19	0.74891522322672	0.10526315789473684
50875586158	3	2.2173407373994958	0.0	0	3	0.7391135791331652	0.0
50875586159	20	14.968122009047825	0.0	0	20	0.7484061004523912	0.0
50875586160	2	1.478768740730201	0.0	0	2	0.7393843703651005	0.0
50875586161	21	14.199781270537244	2.0	2	19	0.7473569089756444	0.10526315789473684
50875586162	1	0.7395083408536597	0.0	0	1	0.7395083408536597	0.0
50875586163	2	1.4790479605188	0.0	0	2	0.7395239802594	0.0
50875586164	2	0.7395304279369012	1.0	1	1	0.7395304279369012	1.0
50875586165	1	0.7395416398251928	0.0	0	1	0.7395416398251928	0.0
50875586166	2	1.4791318644996498	0.0	0	2	0.7395659322498249	0.0
50875586167	1	0.7395670938418551	0.0	0	1	0.7395670938418551	0.0
50875586168	3	2.2189192904645716	0.0	0	3	0.7396397634881905	0.0
50875586169	2	1.479339099251709	0.0	0	2	0.7396695496258545	0.0
50875586170	16	12.020297760144175	0.0	0	16	0.7512686100090109	0.0
50875586171	2	0.7397808267754168	1.0	1	1	0.7397808267754168	1.0
50875586172	1	0.7397920386637086	0.0	0	1	0.7397920386637086	0.0
50875586173	1	0.7397971227331742	0.0	0	1	0.7397971227331742	0.0
50875586174	8	5.251430500585223	1.0	1	7	0.7502043572264604	0.14285714285714285
50875586175	2	1.47975430948118	0.0	0	2	0.73987715474059	0.0
50875586176	24	15.762069690336737	3.0	3	21	0.7505747471588923	0.14285714285714285
50875586177	5	3.881220986082545	0.0	0	5	0.776244197216509	0.0
50875586178	2	1.4801051776129768	0.0	0	2	0.7400525888064884	0.0
50875586179	22	15.766348658682746	1.0	1	21	0.7507785075563213	0.047619047619047616
50875586180	2	1.4807410566588568	0.0	0	2	0.7403705283294284	0.0
50875586181	6	4.063480129049171	0.0	0	6	0.8126960258098341	0.0
50875586182	2	1.4805559763287073	0.0	0	2	0.7402779881643536	0.0
50875586183	22	13.439365485235541	4.0	4	18	0.7466314158464189	0.2222222222222222
50875586184	3	0.7419089643827937	0.5	1	2	0.7419089643827937	0.5
50902126630	2	0.7859194305626714	0.0	0	2	0.7859194305626714	0.0
50902126631	2	0.5312558994986535	1.0	1	1	0.5312558994986535	1.0
50902126632	3	1.5940936849897764	0.0	0	3	0.5313645616632588	0.0
50902126633	2	1.0626938827567116	0.0	0	2	0.5313469413783558	0.0
50902126634	6	1.7530351305496448	3.0	3	3	0.5843450435165483	1.0
50902126635	2	0.5315764988989959	1.0	1	1	0.5315764988989959	1.0
50902126636	12	6.432425865092298	3.0	3	9	0.7147139850102553	0.3333333333333333
50902126637	2	0.531784676392413	1.0	1	1	0.531784676392413	1.0
50902126638	8	3.642601902849358	0.5	1	7	0.6071003171415597	0.14285714285714285
50902126639	2	1.0639200525699517	0.0	0	2	0.5319600262849759	0.0
50902126640	7	2.833254507810394	2.0	2	5	0.5666509015620788	0.4
50902126641	3	1.0643748242671187	1.0	1	2	0.5321874121335594	0.5
50902126642	10	2.834323677518215	5.0	5	5	0.5668647355036429	1.0
50902126643	2	1.06475148310892	0.0	0	2	0.53237574155446	0.0
50902126644	9	2.8352465876382302	4.0	4	5	0.5670493175276461	0.8
50902126645	3	1.0651690501917856	1.0	1	2	0.5325845250958928	0.5
50902126646	1	0.5326092383872025	0.0	0	1	0.5326092383872025	0.0
50902126647	9	2.8489424647306145	2.0	3	6	0.5697884929461229	0.5
50902126648	2	0.532769740103379	1.0	1	1	0.532769740103379	1.0
50902126649	7	2.664707268539236	2.0	2	5	0.5329414537078472	0.4
50902126650	3	1.0659293710969036	1.0	1	2	0.5329646855484518	0.5
50902126651	6	2.8381989505470546	1.0	1	5	0.5676397901094109	0.2
50902126652	3	1.0662941109943944	1.0	1	2	0.5331470554971972	0.5
50902126653	7	2.6664988474818556	2.0	2	5	0.5332997694963711	0.4
50902126654	4	1.0666593896012329	2.0	2	2	0.5333296948006164	1.0
50902126655	22	8.130722301156236	7.0	7	15	0.5420481534104158	0.4666666666666667
50902126656	2	1.0668990479221359	0.0	0	2	0.5334495239610679	0.0
50902126657	2	1.066986049481733	0.0	0	2	0.5334930247408665	0.0
50902126658	2	1.245004977506023	0.0	0	2	0.6225024887530115	0.0
50902126659	47	17.24302724081456	15.0	15	32	0.538844601275455	0.46875
50902126660	6	2.253604293809788	2.0	2	4	0.563401073452447	0.5
50902126661	2	0.5336467589208669	1.0	1	1	0.5336467589208669	1.0
50902126662	13	7.837294423883517	0.5	1	12	0.7837294423883516	0.08333333333333333
50902126663	3	1.0674338516267188	1.0	1	2	0.5337169258133594	0.5
50902126664	6	2.1359842457144915	2.0	2	4	0.5339960614286229	0.5
50902126665	3	1.067707785329847	1.0	1	2	0.5338538926649234	0.5
50902126666	2	0.5338634210865048	1.0	1	1	0.5338634210865048	1.0
50902126667	5	2.846850791012187	0.0	0	5	0.5693701582024374	0.0
50902126668	3	2.188823956081451	0.0	0	3	0.7296079853604837	0.0
50902126669	1	0.533953486555515	0.0	0	1	0.533953486555515	0.0
50902126670	37	12.367040287412209	14.0	14	23	0.5376974038005308	0.6086956521739131
50902126671	2	0.5340613294329879	1.0	1	1	0.5340613294329879	1.0
50902126672	8	3.382031322783631	2.0	2	6	0.5636718871306051	0.3333333333333333
50902126673	2	1.0685156473348685	0.0	0	2	0.5342578236674342	0.0
50902126674	2	0.5342689345477234	1.0	1	1	0.5342689345477234	1.0
50902126675	2	1.0686090460679656	0.0	0	2	0.5343045230339828	0.0
50902126676	3	1.0686709303042425	1.0	1	2	0.5343354651521213	0.5
50902126677	40	15.169842363880855	12.0	12	28	0.5417800844243162	0.42857142857142855
50902126678	1	0.5344446211336283	0.0	0	1	0.5344446211336283	0.0
50902126679	2	0.5344558666912542	1.0	1	1	0.5344558666912542	1.0
50902126680	7	3.38418706924506	1.0	1	6	0.56403117820751	0.16666666666666666
50902126681	2	1.0689672204452858	0.0	0	2	0.5344836102226429	0.0
50902126682	5	1.6041240490054467	2.0	2	3	0.5347080163351489	0.6666666666666666
50902126683	40	14.645252319168993	13.0	13	27	0.5424167525618145	0.48148148148148145
50902126684	2	0.5346112169992967	1.0	1	1	0.5346112169992967	1.0
50902126685	2	0.5346224625569226	1.0	1	1	0.5346224625569226	1.0
50902126686	8	3.385133547899022	2.0	2	6	0.5641889246498369	0.3333333333333333
50902126687	3	1.0693601079061759	1.0	1	2	0.5346800539530879	0.5
50902126688	6	2.1397171984676278	2.0	2	4	0.5349292996169069	0.5
50902126689	1	0.5347804054036992	0.0	0	1	0.5347804054036992	0.0
50902126690	7	3.3869946540167835	1.0	1	6	0.5644991090027972	0.16666666666666666
50902126691	3	1.069712659504683	1.0	1	2	0.5348563297523415	0.5
50902126692	29	10.867225418246361	9.0	9	20	0.5433612709123181	0.45
50902126693	2	0.5349954851106292	1.0	1	1	0.5349954851106292	1.0
50902126694	2	0.5350067306682551	1.0	1	1	0.5350067306682551	1.0
50902126695	5	2.8597375940035183	0.0	0	5	0.5719475188007037	0.0
50902126696	2	1.0701397213397956	0.0	0	2	0.5350698606698978	0.0
50902126697	2	0.5351883093876467	1.0	1	1	0.5351883093876467	1.0
50902126698	2	0.5351995549452727	1.0	1	1	0.5351995549452727	1.0
50902126699	5	2.860707035143412	0.0	0	5	0.5721414070286823	0.0
50902126700	2	1.303071784670332	0.0	0	2	0.651535892335166	0.0
50902126701	41	14.584681355272853	14.0	14	27	0.5401733835286242	0.5185185185185185
50902126702	9	2.6772514523856525	4.0	4	5	0.5354502904771306	0.8
50902126703	8	2.8614974564333124	3.0	3	5	0.5722994912866625	0.6
50902126704	1	0.5354501557997936	0.0	0	1	0.5354501557997936	0.0
50902126705	4	1.0712076789515854	2.0	2	2	0.5356038394757927	1.0
50902126706	1	0.5355620726667059	0.0	0	1	0.5355620726667059	0.0
50902126707	1	0.5355733182243319	0.0	0	1	0.5355733182243319	0.0
50902126708	6	2.86233424039642	1.0	1	5	0.5724668480792839	0.2
50902126709	2	0.535630084721809	1.0	1	1	0.535630084721809	1.0
50902126710	17	5.927774867437938	6.0	6	11	0.5388886243125398	0.5454545454545454
50902126711	5	2.6789737061691348	0.0	0	5	0.535794741233827	0.0
50902126712	2	1.071574910379808	0.0	0	2	0.535787455189904	0.0
50902126713	34	13.167364233544374	10.0	10	24	0.5486401763976823	0.4166666666666667
50902126714	1	0.5359355329217571	0.0	0	1	0.5359355329217571	0.0
50902126715	11	3.4003213805288963	5.0	5	6	0.5667202300881494	0.8333333333333334
50902126716	2	1.0720375270318458	0.0	0	2	0.5360187635159229	0.0
50902126717	4	1.072114865492525	2.0	2	2	0.5360574327462625	1.0
50902126718	13	4.894452159024171	4.0	4	9	0.5438280176693523	0.4444444444444444
50902126719	7	4.96660241098695	1.0	1	6	0.827767068497825	0.16666666666666666
50902126720	2	0.8536896725074768	0.0	0	2	0.8536896725074768	0.0
50902126721	1	0.5361620602023184	0.0	0	1	0.5361620602023184	0.0
50902126722	3	2.469807984123697	0.0	0	3	0.8232693280412323	0.0
50902126723	1	0.5361826321655203	0.0	0	1	0.5361826321655203	0.0
50902126724	3	1.072716065124169	1.0	1	2	0.5363580325620845	0.5
50902126725	19	7.121688852457172	6.0	6	13	0.5478222194197825	0.46153846153846156
50902126726	8	2.8831183204039164	0.5	1	7	0.5766236640807832	0.14285714285714285
50902126727	31	12.056171391994988	9.0	9	22	0.5480077905452267	0.4090909090909091
50902126728	4	1.6097043371186532	1.0	1	3	0.5365681123728844	0.3333333333333333
50902126729	10	6.883191820560496	0.0	0	10	0.7647990911733884	0.0
50902126730	1	0.5365337696519907	0.0	0	1	0.5365337696519907	0.0
50902126731	31	11.449081714363034	10.0	10	21	0.5451943673506207	0.47619047619047616
50902126732	2	0.5366258889503878	1.0	1	1	0.5366258889503878	1.0
50902126733	1	0.5366261583050614	0.0	0	1	0.5366261583050614	0.0
50902126734	4	1.0733945695471578	2.0	2	2	0.5366972847735789	1.0
50902126735	5	1.7938066404479072	2.0	2	3	0.597935546815969	0.6666666666666666
50902126736	22	7.551469385299303	8.0	8	14	0.5393906703785216	0.5714285714285714
50902126737	4	1.073874559575648	2.0	2	2	0.536937279787824	1.0
50902126738	9	3.868160045294682	2.0	2	7	0.5525942921849546	0.2857142857142857
50902126739	3	2.07990264983384	0.0	0	3	0.6933008832779467	0.0
50902126740	27	10.384873687977594	8.0	8	19	0.5465722993672418	0.42105263157894735
50902126741	1	0.5371129495390617	0.0	0	1	0.5371129495390617	0.0
50902126742	1	0.5371241614273535	0.0	0	1	0.5371241614273535	0.0
50902126743	6	2.685983021834193	1.0	1	5	0.5371966043668386	0.2
50902126744	2	1.0744526957133584	0.0	0	2	0.5372263478566792	0.0
50902126745	31	12.077160787602494	9.0	9	22	0.5489618539819315	0.4090909090909091
50902126746	1	0.5373746949432061	0.0	0	1	0.5373746949432061	0.0
50902126747	2	0.7925442087617237	0.0	0	2	0.7925442087617237	0.0
50902126748	8	3.40803021028149	2.0	2	6	0.568005035046915	0.3333333333333333
50902126749	3	1.6123908806338938	0.0	0	3	0.5374636268779646	0.0
50902126750	29	10.325686466378796	10.0	10	19	0.5434571824409893	0.5263157894736842
50902126751	3	1.6131804265211058	0.0	0	3	0.5377268088403686	0.0
50902126752	26	9.17922876821044	9.0	9	17	0.5399546334241435	0.5294117647058824
50902126753	7	2.6896928437547274	2.0	2	5	0.5379385687509455	0.4
50902126754	3	1.6138129049642305	0.0	0	3	0.5379376349880768	0.0
50902126755	3	2.335047282014377	0.0	0	3	0.7783490940047924	0.0
50902126756	26	9.183580563326345	9.0	9	17	0.5402106213721379	0.5294117647058824
50902126757	3	1.0761373408505284	1.0	1	2	0.5380686704252642	0.5
50902126758	1	0.5380698320172944	0.0	0	1	0.5380698320172944	0.0
51624359187	3	0.947355706448792	1.0	1	2	0.473677853224396	0.5
51624359188	1	0.1592501260159006	0.0	0	1	0.1592501260159006	0.0
52351695904	2	0.21152233975475998	0.0	0	2	0.10576116987737999	0.0
52351695905	3	0.8335547035942048	0.0	0	3	0.2778515678647349	0.0
52351695906	2	0.1059279004203852	1.0	1	1	0.1059279004203852	1.0
52351695907	7	0.9519994483616283	0.0	0	7	0.13599992119451834	0.0
52351695908	2	0.10609452995538779	1.0	1	1	0.10609452995538779	1.0
52351695909	11	0.7948962137722593	5.0	5	6	0.13248270229537654	0.8333333333333334
52351695910	2	0.2122222915436403	0.0	0	2	0.10611114577182015	0.0
52351695911	2	0.10614493294869935	1.0	1	1	0.10614493294869935	1.0
52351695912	21	8.27107463794439	4.0	4	17	0.4865338022320229	0.23529411764705882
52351695913	32	5.503879969900962	4.0	4	28	0.211687691150037	0.14285714285714285
52351695914	20	2.4229726944729806	2.0	2	18	0.13460959413738782	0.1111111111111111
52351695915	57	17.37338156981722	4.5	8	49	0.4136519421385052	0.16326530612244897
52351695916	10	0.5321524465299828	5.0	5	5	0.10643048930599656	1.0
52351695917	21	6.028802027917466	3.0	3	18	0.3349334459954148	0.16666666666666666
52351695918	8	0.4262153543813585	4.0	4	4	0.10655383859533962	1.0
52351695919	9	0.5340595449582748	4.0	4	5	0.10681190899165496	0.8
52351695920	19	4.233655448976026	2.0	2	17	0.24903855582211917	0.11764705882352941
52351695921	6	0.7704949698519731	3.0	3	3	0.2568316566173244	1.0
52351695922	25	11.114952729769888	5.0	5	20	0.5557476364884943	0.25
52351695923	24	1.877906442145629	8.0	8	16	0.11736915263410182	0.5
52351695924	3	0.21871922728069926	1.0	1	2	0.10935961364034963	0.5
52351695925	5	2.2834861982833554	1.0	1	4	0.5708715495708389	0.25
52351695926	13	0.8402793450385222	3.5	5	8	0.16805586900770444	0.625
52351695927	2	0.21879818186942043	0.0	0	2	0.10939909093471022	0.0
52351695928	39	21.694343757235753	0.0	0	39	0.6198383930638787	0.0
52351695929	52	9.475318879739097	16.0	16	36	0.2632033022149749	0.4444444444444444
52351695930	12	1.4113831709287386	3.0	5	7	0.2822766341857477	0.7142857142857143
52351695931	6	1.2092086841158889	2.0	2	4	0.3023021710289722	0.5
52351695932	36	12.485902094222487	10.0	10	26	0.48022700362394183	0.38461538461538464
52351695933	12	5.569795233546832	0.0	0	12	0.4641496027955693	0.0
52351695934	25	10.950506482744112	3.0	3	22	0.5763424464602164	0.13636363636363635
52351695935	28	7.327906554937899	3.0	6	22	0.4579941596836187	0.2727272727272727
52351695936	2	0.22177078004810474	0.0	0	2	0.11088539002405237	0.0
52351695937	14	1.5175546016434607	2.0	2	12	0.1264628834702884	0.16666666666666666
52351695938	1	0.11148633713568981	0.0	0	1	0.11148633713568981	0.0
52351695939	2	0.11163808482497181	1.0	1	1	0.11163808482497181	1.0
52351695940	2	0.22343784979281744	0.0	0	2	0.11171892489640872	0.0
52351695941	4	0.4508359203446851	0.0	0	4	0.11270898008617128	0.0
52351695942	2	0.22423392753086577	0.0	0	2	0.11211696376543288	0.0
52351695943	10	1.039608604764002	2.0	2	8	0.12995107559550026	0.25
52351695944	10	1.5365819504692446	3.0	3	7	0.21951170720989208	0.42857142857142855
52351695945	4	0.339265308865469	1.0	1	3	0.11308843628848968	0.3333333333333333
52351695946	2	0.11307081600358673	1.0	1	1	0.11307081600358673	1.0
52351695947	2	0.2261784999281328	0.0	0	2	0.1130892499640664	0.0
52351695948	1	0.113085327486631	0.0	0	1	0.113085327486631	0.0
52351695949	13	1.8689728566918324	6.0	6	7	0.2669961223845475	0.8571428571428571
52351695950	15	3.3345217710460355	7.0	7	8	0.41681522138075444	0.875
52351695951	7	4.058214851226828	0.0	0	7	0.5797449787466897	0.0
52351695952	13	3.5851418170875036	5.0	5	8	0.44814272713593795	0.625
52351695953	2	1.0580926652129818	0.0	0	2	0.5290463326064909	0.0
52351695954	3	0.5259893759109449	0.5	1	2	0.5259893759109449	0.5
52351695955	5	0.2934028272880661	0.6666666666666666	2	3	0.2934028272880661	0.6666666666666666
52351695956	17	3.783317935785644	6.0	7	10	0.4729147419732055	0.7
52351695957	8	4.124793030393947	1.0	1	7	0.6874655050656578	0.14285714285714285
52351695958	2	0.9990169901184208	0.0	0	2	0.9990169901184208	0.0
52351695959	11	4.578930363635207	1.5	2	9	0.5723662954544009	0.2222222222222222
52351695960	3	0.16077134020481798	0.5	1	2	0.16077134020481798	0.5
52351695961	3	0.6398352599880333	0.5	1	2	0.6398352599880333	0.5
52351695962	3	0.34162829007895695	0.0	0	3	0.11387609669298565	0.0
52351695963	4	0.34163367717243043	1.0	1	3	0.11387789239081014	0.3333333333333333
52351695964	2	0.8001898075046724	0.0	0	2	0.8001898075046724	0.0
52351695965	3	0.1426652180323392	0.5	1	2	0.1426652180323392	0.5
52351695966	1	0.11407837082980464	0.0	0	1	0.11407837082980464	0.0
52351695967	3	0.503056148631525	0.5	1	2	0.503056148631525	0.5
52351695968	2	0.34310411800535995	0.0	0	2	0.17155205900267997	0.0
52351695969	1	0.11411742725748761	0.0	0	1	0.11411742725748761	0.0
52351695970	46	4.610606843622138	8.0	8	38	0.12133175904268785	0.21052631578947367
52351695971	9	1.4962599598520123	2.5	3	6	0.2992519919704025	0.5
52351695972	8	0.9965169747147002	4.0	4	4	0.24912924367867506	1.0
52351695973	9	2.228850127928319	3.5	4	5	0.5572125319820798	0.8
52351695974	3	1.700633592898087	0.0	0	3	0.8503167964490435	0.0
52351695975	8	1.7740497108191389	4.0	4	4	0.4435124277047847	1.0
52351695976	7	2.550792092972345	2.0	2	5	0.510158418594469	0.4
52351695977	5	1.4179153247893805	0.5	1	4	0.7089576623946903	0.25
52351695978	4	1.1881059575294344	0.5	1	3	0.5940529787647172	0.3333333333333333
52351695979	3	0.3188051951917363	0.5	1	2	0.3188051951917363	0.5
52351695980	2	0.8123475684023669	0.0	0	2	0.8123475684023669	0.0
52351695981	6	0.46701245297362004	2.0	2	4	0.11675311324340501	0.5
52351695982	12	0.8942509510829354	4.5	5	7	0.14904182518048922	0.7142857142857143
52351695983	9	4.537139851337095	0.5	1	8	0.7561899752228491	0.125
52351695984	4	0.22897005809677287	2.0	2	2	0.11448502904838644	1.0
52351695985	7	3.1823700160841772	2.0	2	5	0.6364740032168354	0.4
52351695986	6	2.8036938424545186	1.0	1	5	0.7009234606136296	0.2
52351695987	4	0.6651959115866178	1.0	1	3	0.3325979557933089	0.3333333333333333
52351695988	6	0.7392723524901856	1.0	2	4	0.3696361762450928	0.5
52351695989	3	0.5505459364699393	0.5	1	2	0.5505459364699393	0.5
52351695990	40	3.2201384570562963	13.0	13	27	0.11926438729838135	0.48148148148148145
52351695991	13	3.3912150040519355	5.0	5	8	0.42390187550649194	0.625
52351695992	10	0.6294494151417798	3.5	4	6	0.12588988302835596	0.6666666666666666
52351695993	2	0.11476074722622766	1.0	1	1	0.11476074722622766	1.0
52351695994	9	4.42626040395053	0.5	1	8	0.6323229148500757	0.125
52351695995	2	0.8765283562964366	0.0	0	2	0.8765283562964366	0.0
52351695996	11	6.812375682296431	0.5	1	10	0.8515469602870539	0.1
52351695997	9	4.626145308698469	0.5	1	8	0.7710242181164114	0.125
52351695998	5	1.4266993173912852	0.5	1	4	0.7133496586956426	0.25
52351695999	3	0.6711884133585507	0.5	1	2	0.6711884133585507	0.5
52351696000	2	0.876542901448815	0.0	0	2	0.876542901448815	0.0
52351696001	1	0.11490895963541768	0.0	0	1	0.11490895963541768	0.0
52351696002	6	0.4687580396057092	2.0	2	4	0.1171895099014273	0.5
52351696003	4	0.22989313656345928	2.0	2	2	0.11494656828172964	1.0
52351696004	9	0.8524500012912191	1.5	2	7	0.14207500021520317	0.2857142857142857
52351696005	4	0.23004626469544387	2.0	2	2	0.11502313234772193	1.0
52351696006	42	3.533848438232781	13.0	13	29	0.1218568426976821	0.4482758620689655
52351696007	4	0.8204154142656364	0.5	1	3	0.4102077071328182	0.3333333333333333
52351696008	4	1.1008934595533824	0.0	0	4	0.2752233648883456	0.0
52351696009	3	0.23033965927374506	1.0	1	2	0.11516982963687253	0.5
52351696010	2	0.11515982984461232	1.0	1	1	0.11515982984461232	1.0
52351696011	1	0.11517097439423565	0.0	0	1	0.11517097439423565	0.0
52351696012	1	0.11517269153028033	0.0	0	1	0.11517269153028033	0.0
52351696013	6	0.4696745188828906	2.0	2	4	0.11741862972072264	0.5
52351696014	6	0.33462705505410884	1.0	2	4	0.16731352752705442	0.5
52351696015	16	3.9802755276094097	3.0	4	12	0.398027552760941	0.3333333333333333
52351696016	4	0.27030303781231213	0.5	1	3	0.13515151890615607	0.3333333333333333
52351696017	11	1.5863262032569896	3.5	4	7	0.2643877005428316	0.5714285714285714
52351696018	10	1.626349580549118	5.0	5	5	0.3252699161098236	1.0
52351696019	14	2.046729702618636	6.0	6	8	0.2558412128273295	0.75
52351696020	11	1.205609398619564	4.0	5	6	0.2411218797239128	0.8333333333333334
52351696021	12	1.9989748024426564	4.0	5	7	0.39979496048853125	0.7142857142857143
52351696022	1	0.11539810772281263	0.0	0	1	0.11539810772281263	0.0
52351696023	4	0.7454599007151939	0.5	1	3	0.37272995035759693	0.3333333333333333
52351696024	7	2.3558517319690697	2.0	2	5	0.47117034639381394	0.4
52351696025	2	0.9726469318802367	0.0	0	2	0.9726469318802367	0.0
52351696026	3	0.22283631346783134	0.5	1	2	0.22283631346783134	0.5
52351696027	50	4.419348931370684	14.0	14	36	0.12275969253807456	0.3888888888888889
52351696028	4	0.6650194506060262	0.5	1	3	0.3325097253030131	0.3333333333333333
52351696029	11	0.8548870213706335	5.0	5	6	0.14248117022843892	0.8333333333333334
52351696030	6	0.6103608891357375	1.0	2	4	0.30518044456786875	0.5
52351696031	6	0.4227921258336148	1.0	2	4	0.2113960629168074	0.5
52351696032	7	0.4627835172582442	3.0	3	4	0.11569587931456105	0.75
52351696033	2	0.2313821628688724	0.0	0	2	0.1156910814344362	0.0
52351696034	4	0.2314563364121358	2.0	2	2	0.1157281682060679	1.0
52351696035	1	0.11574406013181476	0.0	0	1	0.11574406013181476	0.0
52351696036	2	0.7922819246482321	0.0	0	2	0.7922819246482321	0.0
52351696037	3	0.46389925165527707	0.5	1	2	0.46389925165527707	0.5
52351696038	1	0.11590079088255978	0.0	0	1	0.11590079088255978	0.0
52351696039	2	0.5476501043732526	0.0	0	2	0.2738250521866263	0.0
52351696040	5	0.3559162424134152	2.0	2	3	0.1186387474711384	0.6666666666666666
52351696041	37	3.205757644698089	11.0	11	26	0.12329837094992649	0.4230769230769231
52351696042	2	0.11595799508138165	1.0	1	1	0.11595799508138165	1.0
52351696043	4	0.23205834410780085	2.0	2	2	0.11602917205390043	1.0
52351696044	3	0.28942994685935314	0.5	1	2	0.28942994685935314	0.5
52351696045	1	0.11610627482924007	0.0	0	1	0.11610627482924007	0.0
52351696046	2	0.11611018047200837	1.0	1	1	0.11611018047200837	1.0
52351696047	4	0.9935601674537603	1.0	1	3	0.49678008372688015	0.3333333333333333
52351696048	3	1.201481571914819	0.0	0	3	0.4004938573049397	0.0
52351696049	6	0.47290997355374803	2.0	2	4	0.11822749338843701	0.5
52351696050	4	0.23233934837111297	2.0	2	2	0.11616967418555649	1.0
52351696051	13	0.8447120475645338	3.5	5	8	0.16894240951290676	0.625
52351696052	2	0.11623620478995436	1.0	1	1	0.11623620478995436	1.0
52351696053	22	1.8045756759867986	7.0	7	15	0.12030504506578657	0.4666666666666667
52351696054	1	0.11632620292029623	0.0	0	1	0.11632620292029623	0.0
52351696055	3	0.40420129992585674	0.5	1	2	0.40420129992585674	0.5
52351696056	3	0.415404501529379	1.0	1	2	0.2077022507646895	0.5
52351696057	2	0.11636835692672647	1.0	1	1	0.11636835692672647	1.0
52351696058	6	1.5095370914348347	2.0	2	4	0.3773842728587087	0.5
52351696059	13	0.9145852761240617	4.0	5	8	0.15243087935401028	0.625
52351696060	3	0.23294260183214377	1.0	1	2	0.11647130091607188	0.5
52351696061	36	12.14749959571547	8.0	8	28	0.4338392712755525	0.2857142857142857
52351696062	2	0.11661282996242132	1.0	1	1	0.11661282996242132	1.0
52351696063	1	0.11662404185071307	0.0	0	1	0.11662404185071307	0.0
52351696064	3	0.44700017511420725	0.0	0	3	0.14900005837140243	0.0
52351696065	3	1.22114213990908	0.0	0	3	0.40704737996969337	0.0
52351696066	7	4.156824351494112	1.0	1	6	0.6928040585823521	0.16666666666666666
52351696067	10	0.744670792529327	5.0	5	5	0.1489341585058654	1.0
52351696068	2	0.2334790216647688	0.0	0	2	0.1167395108323844	0.0
52351696069	4	0.8521311190269212	1.0	1	3	0.2840437063423071	0.3333333333333333
52351696070	47	3.9258550756706505	15.0	15	32	0.12268297111470783	0.46875
52351696071	3	0.4751493883106873	1.0	1	2	0.23757469415534366	0.5
52351696072	1	0.11687757193731026	0.0	0	1	0.11687757193731026	0.0
52351696073	3	0.23380510916658734	1.0	1	2	0.11690255458329367	0.5
52351696074	1	0.11690204954328053	0.0	0	1	0.11690204954328053	0.0
52351696075	2	0.33847690773562045	0.0	0	2	0.16923845386781022	0.0
52351696076	3	0.9086664765247132	0.0	0	3	0.4543332382623566	0.0
52351696077	4	0.4981130863375667	1.0	1	3	0.16603769544585556	0.3333333333333333
52351696078	9	0.7472562607032709	4.0	4	5	0.1494512521406542	0.8
52351696079	2	0.2340026471503942	0.0	0	2	0.1170013235751971	0.0
52351696080	7	4.088951216063962	1.0	1	6	0.6814918693439936	0.16666666666666666
52351696081	9	1.9193215413673057	3.0	3	6	0.3198869235612176	0.5
52351696082	16	2.6065712372237924	4.5	6	10	0.32582140465297404	0.6
52351696083	8	1.290829547413106	3.0	3	5	0.2581659094826212	0.6
52351696084	2	0.1171259506157734	1.0	1	1	0.1171259506157734	1.0
52351696085	3	0.11893736079624205	0.5	1	2	0.11893736079624205	0.5
52351696086	1	0.1171416068561808	0.0	0	1	0.1171416068561808	0.0
52351696087	2	0.4939436443357389	0.0	0	2	0.24697182216786945	0.0
52351696088	4	0.24145020286952287	2.0	2	2	0.12072510143476144	1.0
52351696089	3	0.8389509214572882	1.0	1	2	0.4194754607286441	0.5
52351696090	9	0.7483713890522881	4.0	4	5	0.1496742778104576	0.8
52351696091	2	0.11724625114690378	1.0	1	1	0.11724625114690378	1.0
52351696092	31	2.84314231586502	9.0	9	22	0.1292337416302282	0.4090909090909091
52351696093	3	0.13108559327235525	0.5	1	2	0.13108559327235525	0.5
52351696094	12	4.028280590938565	4.0	4	8	0.5035350738673207	0.5
52351696095	8	4.225070980848647	0.0	0	8	0.5281338726060809	0.0
52351696096	2	0.11736288172060533	1.0	1	1	0.11736288172060533	1.0
52351696097	2	0.11738001941171794	1.0	1	1	0.11738001941171794	1.0
52351696098	3	0.18470478239559804	0.5	1	2	0.18470478239559804	0.5
52351696099	1	0.1173805917903995	0.0	0	1	0.1173805917903995	0.0
52351696100	3	1.1134334010636884	0.0	0	3	0.5567167005318442	0.0
52351696101	5	0.35259247307892627	2.0	2	3	0.11753082435964209	0.6666666666666666
52351696102	10	0.7511440923937708	5.0	5	5	0.15022881847875416	1.0
52351696103	2	0.2349056586938918	0.0	0	2	0.1174528293469459	0.0
52351696104	4	0.23499505077621788	2.0	2	2	0.11749752538810894	1.0
52351696105	30	2.5011630229769306	10.0	10	20	0.12505815114884652	0.5
52351696106	16	2.88548702540422	8.0	8	8	0.3606858781755275	1.0
52351696107	10	1.1962363610156652	5.0	5	5	0.23924727220313305	1.0
52351696108	7	2.181483872877119	2.0	2	5	0.4362967745754238	0.4
52351696109	10	5.474674078319653	0.5	1	9	0.6843342597899567	0.1111111111111111
52351696110	4	0.33546552248392686	0.3333333333333333	1	3	0.33546552248392686	0.3333333333333333
52351696111	3	0.13738519304161256	0.5	1	2	0.13738519304161256	0.5
52351696112	2	1.0604020448464084	0.0	0	2	0.5302010224232042	0.0
52351696113	5	0.353225456562064	2.0	2	3	0.11774181885402134	0.6666666666666666
52351696114	20	1.8104163290614466	9.0	9	11	0.16458330264194967	0.8181818181818182
52351696115	22	1.9969254847466638	6.0	6	16	0.12480784279666648	0.375
52351696116	4	0.23568944712495365	2.0	2	2	0.11784472356247683	1.0
52351696117	6	0.5079502557135429	2.0	2	4	0.12698756392838573	0.5
52351696118	11	0.8708953756751923	5.0	5	6	0.1451492292791987	0.8333333333333334
52351696119	3	0.27350650661567066	1.0	1	2	0.13675325330783533	0.5
52351696120	26	2.2732009237383854	8.0	8	18	0.12628894020768808	0.4444444444444444
52351696121	15	3.7066559593694635	5.5	6	9	0.46333199492118293	0.6666666666666666
52351696122	14	3.845919126865277	6.0	6	8	0.4807398908581596	0.75
52351696123	3	1.5833716181721074	0.0	0	3	0.7916858090860537	0.0
52351696124	6	3.072725660884419	1.0	1	5	0.6145451321768838	0.2
52351696125	4	0.5040112803043789	0.3333333333333333	1	3	0.5040112803043789	0.3333333333333333
52351696126	6	1.4311648475181509	1.0	2	4	0.7155824237590754	0.5
52351696127	3	1.6229395503803845	0.0	0	3	0.8114697751901923	0.0
52351696128	3	0.5790189813228459	0.5	1	2	0.5790189813228459	0.5
52351696129	4	0.23620283713297943	2.0	2	2	0.11810141856648972	1.0
52351696130	10	1.7092197781615108	4.0	4	6	0.28486996302691847	0.6666666666666666
52351696131	7	1.7186214010301537	3.0	3	4	0.4296553502575384	0.75
52351696132	30	2.70453768687701	9.0	9	21	0.12878750889890525	0.42857142857142855
52351696133	2	1.0226789901368043	0.0	0	2	0.5113394950684022	0.0
52351696134	2	0.11825040537036655	1.0	1	1	0.11825040537036655	1.0
52351696135	2	0.5995476794303634	0.0	0	2	0.5995476794303634	0.0
52351696136	2	0.5540332377606836	0.0	0	2	0.2770166188803418	0.0
52351696137	10	0.7550990944060185	5.0	5	5	0.1510198188812037	1.0
52351696138	4	0.5116925685415895	0.0	0	4	0.12792314213539738	0.0
52351696139	7	1.1240209588911907	1.5	2	5	0.2810052397227977	0.4
52351696140	29	2.3641182605735094	10.0	10	19	0.12442727687228997	0.5263157894736842
52351696141	3	0.38353620734545685	0.5	1	2	0.38353620734545685	0.5
52351696142	10	2.9122835057601666	4.0	4	6	0.4853805842933611	0.6666666666666666
52351696143	2	0.11847437378152784	1.0	1	1	0.11847437378152784	1.0
52351696144	1	0.11848558566981959	0.0	0	1	0.11848558566981959	0.0
52351696145	2	0.1184988513874981	1.0	1	1	0.1184988513874981	1.0
52351696146	2	0.11850588827834789	1.0	1	1	0.11850588827834789	1.0
52351696147	2	0.41235688807407606	0.0	0	2	0.20617844403703803	0.0
52351696148	1	0.11851710016663963	0.0	0	1	0.11851710016663963	0.0
52351696149	3	1.020075003829045	0.0	0	3	0.3400250012763483	0.0
52351696150	1	0.11854443966601771	0.0	0	1	0.11854443966601771	0.0
52351696151	7	0.5936683066213743	2.0	2	5	0.11873366132427485	0.4
52351696152	9	0.593202424043918	4.0	4	5	0.1186404848087836	0.8
52351696153	3	0.35591752184811515	0.0	0	3	0.11863917394937172	0.0
52351696154	4	0.23734362151466415	2.0	2	2	0.11867181075733207	1.0
52351696155	18	1.8440793671054039	4.0	4	14	0.13171995479324314	0.2857142857142857
52351696156	13	1.1798607079442154	4.0	4	9	0.13109563421602394	0.4444444444444444
52351696157	10	0.7581776499794599	5.0	5	5	0.15163552999589197	1.0
52351696158	3	0.23767055074983795	1.0	1	2	0.11883527537491897	0.5
52351696159	31	2.8761348291181963	9.0	9	22	0.13073340132355438	0.4090909090909091
52351696160	11	2.834473169362105	3.5	4	7	0.47241219489368413	0.5714285714285714
52351696161	11	3.5281834717440383	5.0	5	6	0.5880305786240064	0.8333333333333334
52351696162	2	0.5063528141519754	0.0	0	2	0.5063528141519754	0.0
52351696163	6	2.7962883397338176	0.0	0	6	0.6990720849334544	0.0
52351696164	3	0.21474294624923113	0.5	1	2	0.21474294624923113	0.5
52351696165	1	0.11898166964006168	0.0	0	1	0.11898166964006168	0.0
52351696166	2	0.8894407479817675	0.0	0	2	0.8894407479817675	0.0
52351696167	3	0.504987690996453	0.5	1	2	0.504987690996453	0.5
52351696168	10	0.7593078958595372	5.0	5	5	0.15186157917190743	1.0
52351696169	3	0.3572033537215742	0.0	0	3	0.11906778457385807	0.0
52351696170	5	1.0530769444957995	2.0	2	3	0.3510256481652665	0.6666666666666666
52351696171	32	2.8455671813147854	10.0	10	22	0.1293439627870357	0.45454545454545453
52351696172	8	1.3427826768716624	1.5	2	6	0.3356956692179156	0.3333333333333333
52351696173	9	1.396340756153315	3.5	4	5	0.34908518903832875	0.8
52351696174	3	1.3751822058107412	0.0	0	3	0.6875911029053706	0.0
52351696175	5	0.8872755741067602	0.5	1	4	0.2957585247022534	0.25
52351696176	3	0.16939193552780402	0.5	1	2	0.16939193552780402	0.5
52351696177	3	1.2522397093636135	0.0	0	3	0.6261198546818068	0.0
52351696178	10	1.5944943837362033	4.0	4	6	0.26574906395603387	0.6666666666666666
52351696179	3	0.35810737534509807	0.0	0	3	0.11936912511503268	0.0
52351696180	3	0.2737985880899377	1.0	1	2	0.13689929404496884	0.5
52351696181	26	2.334803718050706	8.0	8	18	0.12971131766948366	0.4444444444444444
52351696182	12	1.9479735724008695	4.5	5	7	0.3246622620668116	0.7142857142857143
52351696183	9	3.0705010269651973	2.0	2	7	0.5117501711608662	0.2857142857142857
52351696184	11	2.16225955844621	4.0	5	6	0.43245191168924196	0.8333333333333334
52351696185	4	0.5178006234685293	0.3333333333333333	1	3	0.5178006234685293	0.3333333333333333
52351696186	8	1.7843151877955936	3.0	3	5	0.35686303755911875	0.6
52351696187	2	0.39845734517905806	0.0	0	2	0.39845734517905806	0.0
52351696188	2	0.11953351002775464	1.0	1	1	0.11953351002775464	1.0
52351696189	2	0.4866590818635182	0.0	0	2	0.2433295409317591	0.0
52351696190	2	0.6125115851970347	0.0	0	2	0.3062557925985174	0.0
52351696191	10	0.9114686742029634	3.0	3	7	0.13020981060042333	0.42857142857142855
52351696192	9	0.5981588193942233	4.0	4	5	0.11963176387884467	0.8
52351696193	2	0.23925058526561924	0.0	0	2	0.11962529263280962	0.0
52351696194	3	0.2738376108482864	1.0	1	2	0.1369188054241432	0.5
52351696195	3	0.5793985020580549	1.0	1	2	0.28969925102902744	0.5
52351696196	7	1.1715054606441342	1.0	2	5	0.5857527303220671	0.4
52351696197	3	0.2480286183953687	0.5	1	2	0.2480286183953687	0.5
52351696198	1	0.11977094617259972	0.0	0	1	0.11977094617259972	0.0
52351696199	26	2.1453021329489554	9.0	9	17	0.12619424311464444	0.5294117647058824
52351696200	9	0.7627903487661553	4.0	4	5	0.15255806975323105	0.8
52351696201	4	0.918113755010544	0.0	0	4	0.306037918336848	0.0
52351696202	3	0.27383922697632845	1.0	1	2	0.13691961348816423	0.5
52351696203	30	2.5478366324847728	10.0	10	20	0.12739183162423864	0.5
52351696204	15	1.63921934685734	5.5	6	9	0.2049024183571675	0.6666666666666666
52351696205	9	0.9711903291436674	4.0	4	5	0.19423806582873349	0.8
52351696206	7	2.401419068162793	0.5	1	6	0.48028381363255856	0.16666666666666666
52351696207	11	3.5498919096529207	4.0	4	7	0.5916486516088201	0.5714285714285714
52351696208	8	6.3246900897715355	0.0	0	8	0.9035271556816479	0.0
52351696209	6	2.5644757480964118	0.5	1	5	0.6411189370241029	0.2
52351696210	2	0.9463966354638357	0.0	0	2	0.9463966354638357	0.0
52351696211	3	0.2725797918608896	0.5	1	2	0.2725797918608896	0.5
52351696212	3	0.6597299645323866	0.5	1	2	0.6597299645323866	0.5
52351696213	2	0.9464260287926005	0.0	0	2	0.9464260287926005	0.0
52351696214	4	0.24029305519141236	2.0	2	2	0.12014652759570618	1.0
52351696215	8	0.6596820194004724	4.0	4	4	0.1649205048501181	1.0
52351696216	2	0.24032271787485088	0.0	0	2	0.12016135893742544	0.0
52351696217	4	0.24038796904454882	2.0	2	2	0.12019398452227441	1.0
52351696218	2	0.12021012896802784	1.0	1	1	0.12021012896802784	1.0
52351696219	14	1.2139288217480464	4.0	4	10	0.12139288217480464	0.4
52351696220	10	0.6019618043625155	5.0	5	5	0.12039236087250309	1.0
52351696221	4	0.5493324936650306	0.0	0	4	0.13733312341625764	0.0
52351696222	1	0.12033918352605268	0.0	0	1	0.12033918352605268	0.0
52351696223	3	0.6137488322212297	0.0	0	3	0.20458294407374322	0.0
52351696224	2	0.7731460258889571	0.0	0	2	0.38657301294447854	0.0
52351696225	2	0.12038194358049868	1.0	1	1	0.12038194358049868	1.0
52351696226	3	0.36541944566336787	0.0	0	3	0.1218064818877893	0.0
52351696227	2	0.24086327903558366	0.0	0	2	0.12043163951779183	0.0
52351696228	2	0.24091411973023996	0.0	0	2	0.12045705986511998	0.0
52351696229	3	0.24100532995661333	1.0	1	2	0.12050266497830667	0.5
52351696230	6	0.8689061914100976	1.0	2	4	0.4344530957050488	0.5
52351696231	25	3.0440415429753527	5.0	5	20	0.15220207714876763	0.25
52351696232	11	3.271856271538063	0.0	0	11	0.297441479230733	0.0
52351696233	2	0.2435830878530234	0.0	0	2	0.1217915439265117	0.0
52351696234	1	0.12180427093484286	0.0	0	1	0.12180427093484286	0.0
52351696235	1	0.1218172336285135	0.0	0	1	0.1218172336285135	0.0
52351696236	1	0.12182844551680526	0.0	0	1	0.12182844551680526	0.0
52351696237	2	0.24377766293541983	0.0	0	2	0.12188883146770992	0.0
52351696238	6	2.5373196119124395	0.0	0	6	0.42288660198540656	0.0
52351696239	2	0.24465784667032336	0.0	0	2	0.12232892333516168	0.0
52351696240	1	0.12188447128892979	0.0	0	1	0.12188447128892979	0.0
52351696241	1	0.12189723196659517	0.0	0	1	0.12189723196659517	0.0
52351696242	3	0.7799612715116323	1.0	1	2	0.38998063575581615	0.5
52351696243	5	2.0396410956715143	0.0	0	5	0.4079282191343029	0.0
52351696244	1	0.12192945351943361	0.0	0	1	0.12192945351943361	0.0
52351696245	2	1.1055014446332883	0.0	0	2	0.5527507223166441	0.0
52351696246	2	0.24395021827324329	0.0	0	2	0.12197510913662164	0.0
52351696247	4	2.177340288923964	0.0	0	4	0.544335072230991	0.0
52351696248	3	0.7471798649839497	0.0	0	3	0.37358993249197486	0.0
52351696249	1	0.12210904574810685	0.0	0	1	0.12210904574810685	0.0
52351696250	2	0.24440354218903937	0.0	0	2	0.12220177109451968	0.0
52351696251	1	0.12222449789511107	0.0	0	1	0.12222449789511107	0.0
52351696252	1	0.12224059183686319	0.0	0	1	0.12224059183686319	0.0
52351696253	2	0.24460683762899604	0.0	0	2	0.12230341881449802	0.0
52351696254	3	2.1133266692742447	0.0	0	3	0.7044422230914149	0.0
52351696255	6	1.6392091450490742	1.0	1	5	0.32784182900981484	0.2
52351696256	2	0.4004411423506791	0.0	0	2	0.20022057117533956	0.0
52351696257	1	0.12237843409111669	0.0	0	1	0.12237843409111669	0.0
52351696258	3	0.606720998422356	0.0	0	3	0.20224033280745202	0.0
52351696259	2	0.3064653168653028	0.0	0	2	0.1532326584326514	0.0
52351696260	2	0.6207428956778912	0.0	0	2	0.3103714478389456	0.0
52351696261	1	0.1224511261836749	0.0	0	1	0.1224511261836749	0.0
52351696262	2	0.2450339668027772	0.0	0	2	0.1225169834013886	0.0
52351696263	2	0.24500416944200182	0.0	0	2	0.12250208472100091	0.0
52351696264	2	0.24505194622724505	0.0	0	2	0.12252597311362252	0.0
52351696265	3	1.2227299183717295	0.0	0	3	0.40757663945724315	0.0
52351696266	6	4.6442829790371025	0.0	0	6	0.7740471631728504	0.0
52351696267	4	0.6949684243933383	0.0	0	4	0.17374210609833457	0.0
52351696268	1	0.12260250351028061	0.0	0	1	0.12260250351028061	0.0
52351696269	3	1.0359869291604278	0.0	0	3	0.34532897638680926	0.0
52351696270	3	0.48025359203817214	0.0	0	3	0.1600845306793907	0.0
52351696271	2	0.38654553876776365	0.0	0	2	0.19327276938388183	0.0
52351696272	5	1.6771554274444869	0.0	0	5	0.3354310854888974	0.0
52351696273	5	2.537800814036961	0.0	0	5	0.5075601628073921	0.0
52351696274	5	1.4904011926755596	0.0	0	5	0.3726002981688899	0.0
52351696275	1	0.12272482420146356	0.0	0	1	0.12272482420146356	0.0
52351696276	3	1.5046818724338287	0.0	0	3	0.5015606241446096	0.0
52351696277	2	0.24550042175891498	0.0	0	2	0.12275021087945749	0.0
52351696278	1	0.12276499171717543	0.0	0	1	0.12276499171717543	0.0
52351696279	4	1.3499581507010443	0.0	0	4	0.3374895376752611	0.0
52351696280	2	0.2456126753191693	0.0	0	2	0.12280633765958465	0.0
52351696281	2	0.7924179150891041	0.0	0	2	0.39620895754455204	0.0
52351696282	1	0.12286771685584848	0.0	0	1	0.12286771685584848	0.0
52351696283	3	1.2225623460953692	0.0	0	3	0.4075207820317897	0.0
52351696284	1	0.12288717773102155	0.0	0	1	0.12288717773102155	0.0
52351696285	1	0.12289586441924759	0.0	0	1	0.12289586441924759	0.0
52351696286	1	0.12290781703289194	0.0	0	1	0.12290781703289194	0.0
52351696287	3	0.5245766106475162	0.0	0	3	0.1748588702158387	0.0
52351696288	3	1.4059925085057996	0.0	0	3	0.4686641695019332	0.0
52351696289	2	0.24593718036228002	0.0	0	2	0.12296859018114001	0.0
52351696290	1	0.12300599681144671	0.0	0	1	0.12300599681144671	0.0
52351696291	2	0.7760614198688195	0.0	0	2	0.38803070993440975	0.0
52351696292	3	0.27225649891381043	1.0	1	2	0.13612824945690521	0.5
52351696293	3	0.24875358649956664	1.0	1	2	0.12437679324978332	0.5
52351696294	2	0.12441613586680708	1.0	1	1	0.12441613586680708	1.0
52351696295	6	4.895400152798173	0.0	0	6	0.8159000254663621	0.0
52351696296	8	2.2955363519889165	3.0	3	5	0.4591072703977833	0.6
52351696297	6	1.0027286301830025	1.0	2	4	0.5013643150915013	0.5
52351696298	2	0.5209722074123915	0.0	0	2	0.5209722074123915	0.0
52351696299	6	0.8754296249131794	1.0	2	4	0.4377148124565897	0.5
52351696300	3	0.5209727461217388	0.5	1	2	0.5209727461217388	0.5
52351696301	3	0.24912293909584438	1.0	1	2	0.12456146954792219	0.5
52351696302	1	0.12455919686786304	0.0	0	1	0.12455919686786304	0.0
52351696303	6	1.1119801652605399	1.0	2	4	0.37066005508684663	0.5
52351696304	2	0.24927677428384737	0.0	0	2	0.12463838714192368	0.0
52351696305	4	1.5411135734991634	1.0	1	3	0.5137045244997211	0.3333333333333333
52351696306	21	1.84779743801282	7.0	7	14	0.13198553128663	0.5
52351696307	9	0.6241699625297347	4.0	4	5	0.12483399250594693	0.8
52351696308	3	0.3745038023957549	0.0	0	3	0.12483460079858498	0.0
52351696309	3	0.5968587790617279	1.0	1	2	0.29842938953086395	0.5
52351696310	30	2.667160045867061	10.0	10	20	0.13335800229335304	0.5
52351696311	12	4.271993608752303	4.0	4	8	0.5339992010940379	0.5
52351696312	5	2.6214455746828422	0.0	0	5	0.8738151915609474	0.0
52351696313	6	3.588864736379046	0.0	0	6	0.7177729472758092	0.0
52351696314	4	1.3524691759770513	0.0	0	4	0.6762345879885256	0.0
52351696315	2	0.8291306204177509	0.0	0	2	0.8291306204177509	0.0
52351696316	4	0.42888186464274464	0.3333333333333333	1	3	0.42888186464274464	0.3333333333333333
52351696317	5	1.3048305696814313	0.5	1	4	0.6524152848407156	0.25
52351696318	2	0.8291654345093235	0.0	0	2	0.8291654345093235	0.0
52351696319	10	0.8000851632139494	5.0	5	5	0.16001703264278988	1.0
52351696320	3	0.3752204541744032	0.0	0	3	0.12507348472480107	0.0
52351696321	3	0.5967564579550654	1.0	1	2	0.2983782289775327	0.5
52351696322	30	2.637851698501752	10.0	10	20	0.1318925849250876	0.5
52351696323	10	0.8009547747779111	5.0	5	5	0.16019095495558222	1.0
52351696324	3	0.3758451213319912	0.0	0	3	0.12528170711066375	0.0
52351696325	4	0.333751652364663	0.5	1	3	0.1668758261823315	0.3333333333333333
52351696326	20	1.854792747234847	6.0	6	14	0.1324851962310605	0.42857142857142855
52351696327	10	0.9775502980291623	3.0	3	7	0.1396500425755946	0.42857142857142855
52351696328	9	0.8017133785469844	4.0	4	5	0.1603426757093969	0.8
52351696329	3	0.3763000950451636	0.0	0	3	0.12543336501505453	0.0
52351696330	4	0.6752653656993052	0.5	1	3	0.3376326828496526	0.3333333333333333
52351696331	31	2.8035125667591343	10.0	10	21	0.13350059841710163	0.47619047619047616
52351696332	9	3.7309300005451065	0.5	1	8	0.6218216667575177	0.125
52351696333	4	1.100547944845725	1.0	1	3	0.5502739724228625	0.3333333333333333
52351696334	4	0.39378845227356724	1.0	2	2	0.39378845227356724	1.0
52351696335	6	0.888723086123093	1.0	2	4	0.4443615430615465	0.5
52351696336	2	0.5608872367870338	0.0	0	2	0.5608872367870338	0.0
52351696337	3	0.6864936846261476	1.0	1	2	0.3432468423130738	0.5
52351696338	4	0.6865176571921048	1.0	1	3	0.3432588285960524	0.3333333333333333
52351696339	2	0.6758649828722414	0.0	0	2	0.3379324914361207	0.0
52351696340	9	0.6283701446336957	4.0	4	5	0.12567402892673912	0.8
52351696341	3	0.37702287464263795	0.0	0	3	0.12567429154754597	0.0
52351696342	3	0.5964326262986388	1.0	1	2	0.2982163131493194	0.5
52351696343	20	2.1531696799430127	3.0	3	17	0.1266570399966478	0.17647058823529413
52351696344	5	1.1659441957047558	2.0	2	3	0.3886480652349186	0.6666666666666666
52351696345	9	0.6306836992645641	4.0	4	5	0.12613673985291282	0.8
52351696346	2	0.25162103534751484	0.0	0	2	0.12581051767375742	0.0
52351696347	2	1.0076942846002155	0.0	0	2	0.5038471423001077	0.0
52351696348	1	0.12584270555726165	0.0	0	1	0.12584270555726165	0.0
52351696349	1	0.12586260413377945	0.0	0	1	0.12586260413377945	0.0
52351696350	3	0.29090355260969836	1.0	1	2	0.14545177630484918	0.5
52351696351	2	1.0083253152619691	0.0	0	2	0.5041626576309846	0.0
52351696352	4	1.499440297822769	0.0	0	4	0.37486007445569225	0.0
52351696353	9	4.1214952874548025	2.0	2	7	0.5887850410649718	0.2857142857142857
52351696354	3	0.4162980183206295	0.0	0	3	0.1387660061068765	0.0
52351696355	6	0.9661944059950001	0.0	0	6	0.16103240099916669	0.0
52351696356	4	1.8916317462361136	0.0	0	4	0.6305439154120379	0.0
52351696357	2	1.0089452350434336	0.0	0	2	0.5044726175217168	0.0
52351696358	1	0.12597051434992074	0.0	0	1	0.12597051434992074	0.0
52351696359	3	0.2520287709847913	1.0	1	2	0.12601438549239566	0.5
52351696360	7	2.299066110310099	0.5	1	6	0.5747665275775248	0.16666666666666666
52351696361	24	9.12749751966432	4.0	4	20	0.456374875983216	0.2
52351696362	64	10.636210924507056	13.0	17	47	0.2799002874870278	0.3617021276595745
52351696363	58	10.661307406509433	13.5	16	42	0.30460878304312666	0.38095238095238093
52351696364	43	8.770178309763732	9.5	11	32	0.3132206539201333	0.34375
52351696365	9	3.5677263539676636	0.0	0	9	0.3964140393297404	0.0
52351696366	52	8.486100945310328	13.5	17	35	0.2828700315103443	0.4857142857142857
52351696367	59	10.885746178269628	13.0	17	42	0.3298710963112008	0.40476190476190477
52351696368	47	8.332422420719407	7.5	12	35	0.3332968968287763	0.34285714285714286
52351696369	25	5.776050376327198	6.0	6	19	0.30400265138564203	0.3157894736842105
52351696370	19	2.4886336536375655	3.5	6	13	0.3110792067046957	0.46153846153846156
52351696371	9	2.6872646113715417	1.0	1	8	0.3359080764214427	0.125
52351696372	20	2.8079393098129914	6.5	7	13	0.23399494248441596	0.5384615384615384
52351696373	3	1.0752490091367461	0.0	0	3	0.3584163363789154	0.0
52351696374	2	0.390712825932202	0.0	0	2	0.195356412966101	0.0
52351696375	6	1.9904425891219701	0.0	0	6	0.49761064728049254	0.0
52351696376	2	0.2546728238002598	0.0	0	2	0.1273364119001299	0.0
52351696377	2	1.0091030432128734	0.0	0	2	0.5045515216064367	0.0
52351696378	1	0.12737189937838664	0.0	0	1	0.12737189937838664	0.0
52351696379	4	1.8917804636853168	0.0	0	4	0.6305934878951056	0.0
52351696380	2	0.25482615394824965	0.0	0	2	0.12741307697412482	0.0
52351696381	1	0.12740465964057246	0.0	0	1	0.12740465964057246	0.0
52351696382	2	0.25484319063135963	0.0	0	2	0.12742159531567981	0.0
52351696383	2	0.2549425825059459	0.0	0	2	0.12747129125297296	0.0
52351696384	2	0.2926443245269955	0.0	0	2	0.14632216226349776	0.0
52351696385	2	1.094070133290497	0.0	0	2	0.5470350666452485	0.0
52351696386	2	1.0092488987686687	0.0	0	2	0.5046244493843344	0.0
52351696387	2	0.2550750376667259	0.0	0	2	0.12753751883336295	0.0
52351696388	1	0.12756913433818565	0.0	0	1	0.12756913433818565	0.0
52351696389	2	0.29168353640599454	0.0	0	2	0.14584176820299727	0.0
52351696390	1	0.12758947061604814	0.0	0	1	0.12758947061604814	0.0
52351696391	4	1.8933078056930603	0.0	0	4	0.6311026018976867	0.0
52351696392	6	3.598933584443717	0.0	0	6	0.7197867168887434	0.0
52351696393	2	0.2552720706105196	0.0	0	2	0.1276360353052598	0.0
52351696394	5	3.04912584812632	0.0	0	5	0.609825169625264	0.0
52351696395	1	0.1276811522131005	0.0	0	1	0.1276811522131005	0.0
52351696396	4	1.8535341538527632	0.0	0	4	0.4633835384631908	0.0
52351696397	2	0.2556875501946643	0.0	0	2	0.12784377509733216	0.0
52351696398	1	0.12771371045928104	0.0	0	1	0.12771371045928104	0.0
52351696399	15	2.546493024033811	4.5	6	9	0.36378471771911586	0.6666666666666666
52351696400	2	0.9431161985624743	0.0	0	2	0.47155809928123715	0.0
52351696401	2	1.1092645987792105	0.0	0	2	0.5546322993896052	0.0
52351696402	1	0.12776909651405557	0.0	0	1	0.12776909651405557	0.0
52351696403	6	3.286431221277322	0.0	0	6	0.5477385368795537	0.0
52351696404	3	1.2433640014953224	0.0	0	3	0.4144546671651075	0.0
52351696405	2	0.292646647711056	0.0	0	2	0.146323323855528	0.0
52351696406	1	0.12784596360405576	0.0	0	1	0.12784596360405576	0.0
52351696407	3	0.42061092535552375	0.0	0	3	0.14020364178517458	0.0
52351696408	1	0.12786582851123934	0.0	0	1	0.12786582851123934	0.0
52351696409	1	0.12787367346611014	0.0	0	1	0.12787367346611014	0.0
52351696410	5	1.6618500214995535	1.0	1	4	0.4154625053748884	0.25
52351696411	1	0.12791707323790613	0.0	0	1	0.12791707323790613	0.0
52351696412	7	3.788617320643541	0.0	0	7	0.5412310458062202	0.0
52351696413	4	0.5855200583880127	0.0	0	4	0.14638001459700317	0.0
52351696414	1	0.12795976595368372	0.0	0	1	0.12795976595368372	0.0
52351696415	1	0.12796761090855452	0.0	0	1	0.12796761090855452	0.0
52351696416	3	1.2549780363148684	0.0	0	3	0.4183260121049561	0.0
52584053131	1	0.7894330276034333	0.0	0	1	0.7894330276034333	0.0
52584053133	7	2.901203028879838	0.0	0	7	0.48353383814663964	0.0
52937420768	2	0.5040838713889344	1.0	1	1	0.5040838713889344	1.0
52937420769	32	11.245108645386052	10.0	10	22	0.5111413020630023	0.45454545454545453
52937420770	2	0.5042021517600123	1.0	1	1	0.5042021517600123	1.0
52937420771	1	0.504213363648304	0.0	0	1	0.504213363648304	0.0
52937420772	1	0.5042446087904504	0.0	0	1	0.5042446087904504	0.0
52937420773	3	1.512973989732267	0.0	0	3	0.504324663244089	0.0
52937420774	3	1.0087340609792719	1.0	1	2	0.5043670304896359	0.5
52937420775	26	9.157019465285854	8.0	8	18	0.5087233036269919	0.4444444444444444
52937420776	1	0.5044993509730791	0.0	0	1	0.5044993509730791	0.0
52937420777	7	2.5228301486127376	2.0	2	5	0.5045660297225475	0.4
52937420778	3	1.5137061294046517	0.0	0	3	0.5045687098015506	0.0
52937420779	11	5.171572226933872	1.0	1	10	0.5171572226933872	0.1
52937420780	21	6.610865424108866	8.0	8	13	0.5085281095468358	0.6153846153846154
52937420781	7	2.5237145410144173	2.0	2	5	0.5047429082028835	0.4
52937420782	3	1.5142196540900144	0.0	0	3	0.5047398846966714	0.0
52937420783	29	10.223101089112056	9.0	9	20	0.5111550544556028	0.45
52937420784	4	1.4618671053197312	1.0	1	3	0.7309335526598656	0.3333333333333333
52937420785	1	0.5048927098046482	0.0	0	1	0.5048927098046482	0.0
52937420786	1	0.5049043593942847	0.0	0	1	0.5049043593942847	0.0
52937420787	2	0.5049015648395453	1.0	1	1	0.5049015648395453	1.0
52937420788	7	2.7035249133039896	2.0	2	5	0.5407049826607979	0.4
52937420789	3	1.5149759346750271	0.0	0	3	0.5049919782250091	0.0
52937420790	4	1.0100433940480091	2.0	2	2	0.5050216970240046	1.0
52937420791	26	9.168340980929791	8.0	8	18	0.5093522767183217	0.4444444444444444
52937420792	1	0.5051279237734354	0.0	0	1	0.5051279237734354	0.0
52937420793	12	4.655558030999828	5.0	5	7	0.6650797187142611	0.7142857142857143
52937420794	3	1.5156386481802717	0.0	0	3	0.5052128827267572	0.0
52937420795	3	1.010472072011164	1.0	1	2	0.505236036005582	0.5
52937420796	1	0.5052549581714076	0.0	0	1	0.5052549581714076	0.0
52937420797	21	7.631503749568569	6.0	6	15	0.5087669166379046	0.4
52937420798	12	3.538159998494307	5.0	5	7	0.5054514283563296	0.7142857142857143
52937420799	2	0.505379736723988	1.0	1	1	0.505379736723988	1.0
52937420800	9	3.211127970843165	3.0	3	6	0.5351879951405275	0.5
52937420801	4	1.0109177866574286	2.0	2	2	0.5054588933287143	1.0
52937420802	11	8.145952153115203	0.0	0	11	0.9051057947905782	0.0
52937420803	36	23.8196669786355	5.0	5	31	0.7683763541495322	0.16129032258064516
52937420804	27	15.264392150506502	5.0	5	22	0.6938360068412046	0.22727272727272727
52937420805	13	6.162827492775656	1.0	2	11	0.770353436596957	0.18181818181818182
52937420806	3	1.5169035377278526	0.0	0	3	0.5056345125759508	0.0
52937420807	52	34.000921933709314	2.0	4	48	0.8718185111207516	0.08333333333333333
52937420808	6	3.6333386946136503	0.0	0	6	0.9083346736534126	0.0
52937420809	4	2.0233739251948872	0.0	0	4	0.5058434812987218	0.0
52937420810	2	1.011678982965236	0.0	0	2	0.505839491482618	0.0
52937420811	4	1.4204483361406264	0.5	1	3	0.7102241680703132	0.3333333333333333
52937420812	4	2.1774037219496147	0.0	0	4	0.5443509304874037	0.0
52937420813	10	4.869847249301253	0.5	1	9	0.6956924641858933	0.1111111111111111
52937420814	1	0.5061710334165785	0.0	0	1	0.5061710334165785	0.0
52937420815	2	0.5061822453048702	1.0	1	1	0.5061822453048702	1.0
52937420816	1	0.5063525447973017	0.0	0	1	0.5063525447973017	0.0
52937420817	2	1.0127470752543626	0.0	0	2	0.5063735376271813	0.0
52937420818	1	0.5063909278383004	0.0	0	1	0.5063909278383004	0.0
52937420819	2	1.0657947610987342	0.0	0	2	0.5328973805493671	0.0
52937420820	4	2.0258601361715822	0.0	0	4	0.5064650340428956	0.0
52937420821	2	1.0129184521654886	0.0	0	2	0.5064592260827443	0.0
52937420822	2	1.0129986861889098	0.0	0	2	0.5064993430944549	0.0
52937420823	2	1.0130856540791728	0.0	0	2	0.5065428270395864	0.0
52937420824	19	15.51444318479983	0.0	0	19	0.9126143049882254	0.0
52937420825	31	26.65614471914843	0.0	0	31	0.8598756361015623	0.0
52937420826	20	7.201953919004445	6.0	6	14	0.5144252799288889	0.42857142857142855
52937420827	4	1.0136178652450216	2.0	2	2	0.5068089326225108	1.0
52937420828	10	2.7115811432469568	5.0	5	5	0.5423162286493913	1.0
52937420829	2	1.0137142942181976	0.0	0	2	0.5068571471090988	0.0
52937420830	4	1.0137949659429635	2.0	2	2	0.5068974829714817	1.0
52937420831	33	12.70320754615973	8.0	8	25	0.5081283018463892	0.32
52937420832	25	8.148361631679235	9.0	9	16	0.5092726019799522	0.5625
52937420833	10	4.4831296939050125	3.0	3	7	0.6404470991292875	0.42857142857142855
52937420834	2	1.0141401439572788	0.0	0	2	0.5070700719786394	0.0
52937420835	3	1.0145596638615286	1.0	1	2	0.5072798319307643	0.5
52937420836	4	2.0294217120135922	0.0	0	4	0.5073554280033981	0.0
52937420837	1	0.5088483178649117	0.0	0	1	0.5088483178649117	0.0
52937420838	4	1.9391064165434677	1.0	1	3	0.6463688055144893	0.3333333333333333
52937420839	6	3.054154935569184	0.0	0	6	0.509025822594864	0.0
52937420840	1	0.5090045099063093	0.0	0	1	0.5090045099063093	0.0
52937420841	1	0.5090712088573783	0.0	0	1	0.5090712088573783	0.0
52937420842	3	1.527493351400747	0.0	0	3	0.5091644504669156	0.0
52937420843	2	0.5092223841679787	1.0	1	1	0.5092223841679787	1.0
52937420844	1	0.5093546709820876	0.0	0	1	0.5093546709820876	0.0
52937420845	5	2.5468545990138853	0.0	0	5	0.509370919802777	0.0
52937420846	1	0.5094065554261045	0.0	0	1	0.5094065554261045	0.0
52937420847	2	1.0195356547643437	0.0	0	2	0.5097678273821719	0.0
52937420848	20	9.22550514691328	2.0	2	18	0.5125280637174044	0.1111111111111111
52937420849	1	0.5112577964289429	0.0	0	1	0.5112577964289429	0.0
52937420850	2	0.5112690083172347	1.0	1	1	0.5112690083172347	1.0
52937420851	21	8.72657541087446	4.0	4	17	0.5133279653455565	0.23529411764705882
52937420852	5	1.4804195145171564	0.5	1	4	0.7402097572585782	0.25
52937420853	2	0.925343874169348	0.0	0	2	0.925343874169348	0.0
52937420854	1	0.5127328836299933	0.0	0	1	0.5127328836299933	0.0
52937420855	3	0.6087945580389794	0.5	1	2	0.6087945580389794	0.5
52937420856	3	1.5387082025939056	0.0	0	3	0.5129027341979685	0.0
52937420857	4	1.6485893542211598	1.0	1	3	0.5495297847403866	0.3333333333333333
52937420858	2	0.5129359097152763	1.0	1	1	0.5129359097152763	1.0
52937420859	1	0.5129470542648996	0.0	0	1	0.5129470542648996	0.0
52937420860	1	0.5129509935770021	0.0	0	1	0.5129509935770021	0.0
52937420861	5	1.6007758357343216	0.5	1	4	0.8003879178671608	0.25
52937420862	2	0.917765883449492	0.0	0	2	0.917765883449492	0.0
52937420863	12	5.982933990899919	2.0	3	9	0.7478667488624898	0.3333333333333333
52937420864	12	4.360557358118183	3.5	4	8	0.6229367654454547	0.5
52937420865	1	0.5133478876886631	0.0	0	1	0.5133478876886631	0.0
52937420866	1	0.5133481570433368	0.0	0	1	0.5133481570433368	0.0
52937420867	2	0.5135369410002493	1.0	1	1	0.5135369410002493	1.0
52937420868	1	0.513549769016583	0.0	0	1	0.513549769016583	0.0
52937420869	3	1.6826717101533615	0.0	0	3	0.5608905700511205	0.0
52937420870	15	6.694465505548252	2.0	2	13	0.5149588850421732	0.15384615384615385
52937420871	2	0.514877216187125	1.0	1	1	0.514877216187125	1.0
52937420872	1	0.5148861722300248	0.0	0	1	0.5148861722300248	0.0
52937420873	2	1.0304872117639845	0.0	0	2	0.5152436058819923	0.0
52937420874	2	1.4138428841394104	0.0	0	2	0.7069214420697052	0.0
52937420875	2	0.5164905496744394	1.0	1	1	0.5164905496744394	1.0
52937420876	1	0.5165048254721443	0.0	0	1	0.5165048254721443	0.0
52937420877	1	0.5165014922080575	0.0	0	1	0.5165014922080575	0.0
52937420878	1	0.5165305825128145	0.0	0	1	0.5165305825128145	0.0
52937420879	2	1.0331225442218928	0.0	0	2	0.5165612721109464	0.0
52937420880	3	1.5497581077187723	0.0	0	3	0.5165860359062574	0.0
52937420881	6	2.686218538826988	1.0	1	5	0.5372437077653976	0.2
52937420882	2	1.0339530656888374	0.0	0	2	0.5169765328444187	0.0
52937420883	3	1.0340654539264285	1.0	1	2	0.5170327269632142	0.5
52937420884	6	3.5676895533853723	1.0	1	5	0.7135379106770745	0.2
52937420885	1	0.5171626232545944	0.0	0	1	0.5171626232545944	0.0
52937420886	1	0.5171606704332102	0.0	0	1	0.5171606704332102	0.0
52937420887	6	4.600103122436817	0.0	0	6	0.7666838537394695	0.0
52937420888	1	0.5171773704229781	0.0	0	1	0.5171773704229781	0.0
52937420889	1	0.5171776397776517	0.0	0	1	0.5171776397776517	0.0
52937420890	7	2.7552277449320326	2.0	2	5	0.5510455489864066	0.4
52937420891	5	2.7394623485431295	1.0	1	4	0.6848655871357824	0.25
52937420892	7	4.682353097243737	1.0	1	6	0.7803921828739561	0.16666666666666666
52937420893	2	1.0348980965614283	0.0	0	2	0.5174490482807141	0.0
52937420894	1	0.5174484422326984	0.0	0	1	0.5174484422326984	0.0
52937420895	1	0.5174489809420457	0.0	0	1	0.5174489809420457	0.0
52937420896	1	0.517453526302164	0.0	0	1	0.517453526302164	0.0
53250271473	1	0.0	1.0	1	0	0.0	inf
53250271474	2	0.0	2.0	2	0	0.0	inf
53250271475	4	0.14994998252056516	3.0	3	1	0.04998332750685505	3.0
53250271476	1	0.0	1.0	1	0	0.0	inf
53250271477	11	0.1962535323761119	6.0	6	5	0.024531691547013987	1.2
53321142719	25	0.7409067629807151	9.0	9	16	0.046306672686294695	0.5625
53321142720	12	0.40293597267693126	5.0	6	6	0.08058719453538625	1.0
53321142721	2	0.07756350650897252	0.0	0	2	0.03878175325448626	0.0
53321142722	10	1.1695088017868451	3.0	4	6	0.23390176035736904	0.6666666666666666
53321142723	8	1.7826347849945336	3.0	3	5	0.35652695699890674	0.6
53321142724	32	1.1174387050612449	4.0	4	28	0.03990852518075875	0.14285714285714285
53321142725	4	0.597233013711466	1.0	1	3	0.298616506855733	0.3333333333333333
53321142726	1	0.038937002554526055	0.0	0	1	0.038937002554526055	0.0
53321142727	2	0.03893976343993123	1.0	1	1	0.03893976343993123	1.0
53413494512	7	2.7026253697019156	0.5	1	6	0.5405250739403831	0.16666666666666666
53413494513	15	2.766507948302892	7.0	7	8	0.3458134935378615	0.875
53413494514	2	0.06118431815743087	1.0	1	1	0.06118431815743087	1.0
53413494515	3	0.12239149779278996	1.0	1	2	0.06119574889639498	0.5
53413494516	4	0.4194942145477988	0.5	1	3	0.2097471072738994	0.3333333333333333
53413494517	1	0.06119886330980936	0.0	0	1	0.06119886330980936	0.0
53413494518	3	0.6219807487501017	0.0	0	3	0.20732691625003388	0.0
53413494519	8	1.4458843060398374	2.0	3	5	0.36147107650995935	0.6
53413494520	2	0.0612421284042685	1.0	1	1	0.0612421284042685	1.0
53413494521	4	0.7334679276191468	2.0	2	2	0.3667339638095734	1.0
53413494522	11	0.5393081901295181	5.0	5	6	0.08988469835491969	0.8333333333333334
53413494523	3	0.12262543232687725	1.0	1	2	0.06131271616343863	0.5
53413494524	2	0.061323675531723805	1.0	1	1	0.061323675531723805	1.0
53413494525	38	12.284650685876322	11.0	11	27	0.45498706243986375	0.4074074074074074
53413494526	30	1.411993090917943	10.0	10	20	0.07059965454589714	0.5
53413494527	12	5.2404448365500285	2.5	3	9	0.6550556045687536	0.3333333333333333
53413494528	15	3.6255247828689887	7.0	7	8	0.4531905978586236	0.875
53413494529	4	0.32246336835359346	0.5	1	3	0.16123168417679673	0.3333333333333333
53413494530	2	0.6947964414341965	0.0	0	2	0.6947964414341965	0.0
53413494531	3	0.694795229338165	0.5	1	2	0.694795229338165	0.5
53413494532	6	1.4160091017637781	0.5	1	5	0.7080045508818891	0.2
53413494533	1	0.06154818265223244	0.0	0	1	0.06154818265223244	0.0
53413494534	1	0.06155602760710325	0.0	0	1	0.06155602760710325	0.0
53413494535	2	0.06158094291441824	1.0	1	1	0.06158094291441824	1.0
53413494536	11	2.131528715379886	4.0	4	7	0.30450410219712654	0.5714285714285714
53413494537	11	3.641669464307762	1.5	2	9	0.5202384949011088	0.2222222222222222
53413494538	29	1.309170243837022	10.0	10	19	0.06890369704405379	0.5263157894736842
53413494539	12	1.5369325155770333	5.0	5	7	0.21956178793957618	0.7142857142857143
53413494540	4	0.29273920471079773	0.0	0	4	0.07318480117769943	0.0
53413494541	3	0.5048373910885421	0.5	1	2	0.5048373910885421	0.5
53413494542	16	0.9719521314994903	4.0	4	12	0.08099601095829086	0.3333333333333333
53413494543	14	1.601612889052103	7.0	7	7	0.2288018412931576	1.0
53413494544	16	1.858811114934077	5.0	6	10	0.23235138936675961	0.6
53413494545	16	2.8650565407445914	8.0	8	8	0.3581320675930739	1.0
53413494546	10	1.491955537489339	3.5	4	6	0.2983911074978678	0.6666666666666666
53413494547	9	1.646326539276945	2.0	3	6	0.329265307855389	0.5
53413494548	3	0.4274761699394999	0.5	1	2	0.4274761699394999	0.5
53413494549	4	0.30059580917123707	1.0	1	3	0.15029790458561854	0.3333333333333333
53413494550	1	0.061998476327949685	0.0	0	1	0.061998476327949685	0.0
53413494551	2	0.062025209779311995	1.0	1	1	0.062025209779311995	1.0
53413494552	2	0.7803888383867581	0.0	0	2	0.39019441919337905	0.0
53413494553	2	0.06202578215799355	1.0	1	1	0.06202578215799355	1.0
53413494554	1	0.06203362711286436	0.0	0	1	0.06203362711286436	0.0
53413494555	17	0.9240128243800458	5.0	5	12	0.07700106869833716	0.4166666666666667
53413494556	9	0.4815732952618459	4.0	4	5	0.09631465905236918	0.8
53413494557	3	0.18633188664060413	0.0	0	3	0.06211062888020138	0.0
53413494558	27	1.36390974638675	8.0	8	19	0.07178472349403947	0.42105263157894735
53413494559	5	1.4048565725082411	0.5	1	4	0.4682855241694137	0.25
53413494560	15	1.3242899634037906	7.0	7	8	0.16553624542547382	0.875
53413494561	13	3.6668762807183435	5.0	5	8	0.45835953508979294	0.625
53413494562	8	1.025767410825169	2.0	2	6	0.17096123513752817	0.3333333333333333
53413494563	11	1.146532477759637	4.5	5	6	0.22930649555192742	0.8333333333333334
53413494564	9	1.3131782750506498	3.0	3	6	0.21886304584177496	0.5
53413494565	3	0.20767046691319577	1.0	1	2	0.10383523345659788	0.5
53413494566	2	0.290555007661962	0.0	0	2	0.145277503830981	0.0
53413494567	3	0.808704075070225	0.0	0	3	0.2695680250234083	0.0
53413494568	6	1.1983116040989992	1.0	1	5	0.23966232081979982	0.2
53413494569	9	0.48299686838155587	4.0	4	5	0.09659937367631118	0.8
53413494570	5	1.3365996740067723	0.5	1	4	0.6682998370033861	0.25
53413494571	28	1.474990469053219	8.0	8	20	0.07374952345266095	0.4
53413494572	2	0.41024932242990103	0.0	0	2	0.41024932242990103	0.0
53413494573	7	1.0685611346053854	1.0	2	5	0.5342805673026927	0.4
53413494574	2	0.06260415398104356	1.0	1	1	0.06260415398104356	1.0
53413494575	6	1.7891181856592406	0.5	1	5	0.44727954641481016	0.2
53413494576	8	0.42134986623341864	4.0	4	4	0.10533746655835466	1.0
53413494577	3	0.3635765209860792	0.5	1	2	0.3635765209860792	0.5
53413494578	3	0.1254539930938135	1.0	1	2	0.06272699654690675	0.5
53413494579	21	0.8623468327274144	8.0	8	13	0.06633437174826265	0.6153846153846154
53413494580	12	0.7464160761374081	3.0	3	9	0.08293511957082313	0.3333333333333333
53413494581	10	0.4850342671332384	5.0	5	5	0.09700685342664768	1.0
53413494582	3	0.18874584322608517	0.0	0	3	0.06291528107536172	0.0
53413494583	6	1.1003393633202974	1.0	2	4	0.5501696816601487	0.5
53413494584	5	0.12715850313816712	0.6666666666666666	2	3	0.12715850313816712	0.6666666666666666
53413494585	3	0.15504688000252656	0.5	1	2	0.15504688000252656	0.5
53413494586	1	0.06302370755462756	0.0	0	1	0.06302370755462756	0.0
53413494587	5	2.291880704027125	0.5	1	4	0.7639602346757083	0.25
53413494588	1	0.06303461641891143	0.0	0	1	0.06303461641891143	0.0
53413494589	2	0.06303488577358511	1.0	1	1	0.06303488577358511	1.0
53413494590	3	2.0062230020339307	0.0	0	3	0.6687410006779769	0.0
53413494591	2	0.06306273031297632	1.0	1	1	0.06306273031297632	1.0
53413494592	28	1.4246908405976884	9.0	9	19	0.07498372845250992	0.47368421052631576
53413494593	22	3.0063565009440714	10.0	10	12	0.25052970841200595	0.8333333333333334
53413494594	3	0.18943441478000272	0.0	0	3	0.06314480492666757	0.0
53413494595	3	0.6190912464882463	0.5	1	2	0.6190912464882463	0.5
53413494596	30	1.598589382840094	9.0	9	21	0.07612330394476638	0.42857142857142855
53413494597	19	2.995970454081813	9.0	9	10	0.2995970454081813	0.9
53413494598	1	0.06325999894210951	0.0	0	1	0.06325999894210951	0.0
53413494599	5	0.467659139875781	2.0	2	3	0.15588637995859367	0.6666666666666666
53413494600	2	0.2748665120323931	0.0	0	2	0.13743325601619655	0.0
53413494601	9	0.3167479988715386	4.0	4	5	0.06334959977430772	0.8
53413494602	3	0.19004955351600944	0.0	0	3	0.06334985117200315	0.0
53413494603	3	0.6007961046735157	0.5	1	2	0.6007961046735157	0.5
53413494604	24	1.0615090252165469	8.0	8	16	0.06634431407603418	0.5
53413494605	11	1.895890142618923	5.0	5	6	0.31598169043648716	0.8333333333333334
53413494606	12	3.742250842802357	4.0	4	8	0.46778135535029464	0.5
53413494607	19	2.563681252817071	7.5	9	10	0.3204601566021339	0.9
53413494608	11	1.827722299506438	4.5	5	6	0.3655444599012876	0.8333333333333334
53413494609	8	3.8618037463666157	1.0	1	7	0.6436339577277693	0.14285714285714285
53413494610	3	0.09857630230375349	0.5	1	2	0.09857630230375349	0.5
53413494611	3	0.18368739612379095	0.5	1	2	0.18368739612379095	0.5
53413494612	1	0.06351080181263574	0.0	0	1	0.06351080181263574	0.0
53413494613	2	0.06351251894868043	1.0	1	1	0.06351251894868043	1.0
53413494614	1	0.0635113741913173	0.0	0	1	0.0635113741913173	0.0
53413494615	11	0.7807990992241003	5.0	5	6	0.1301331832040167	0.8333333333333334
53413494616	3	0.19077468996687846	0.0	0	3	0.06359156332229282	0.0
53413494617	5	1.3485525906751366	0.5	1	4	0.6742762953375683	0.25
53413494618	21	1.1800523537945358	6.0	6	15	0.07867015691963572	0.4
53413494619	1	0.06371554503396344	0.0	0	1	0.06371554503396344	0.0
53413494620	16	1.3403442426802112	8.0	8	8	0.1675430303350264	1.0
53413494621	9	2.2711884066246837	4.0	4	5	0.45423768132493675	0.8
53413494622	6	1.4362613409681018	1.0	1	5	0.4787537803227006	0.2
53413494623	4	0.9564988498387088	1.0	1	3	0.3188329499462363	0.3333333333333333
53413494624	7	4.137747407739038	0.0	0	7	0.5911067725341483	0.0
53413494625	3	0.12762027805684978	1.0	1	2	0.06381013902842489	0.5
53413494626	1	0.06383860645049899	0.0	0	1	0.06383860645049899	0.0
53413494627	14	0.8169468667940467	4.0	4	10	0.08169468667940467	0.4
53413494628	9	0.4894801343689258	4.0	4	5	0.09789602687378515	0.8
53413494629	2	0.12782734446223792	0.0	0	2	0.06391367223111896	0.0
53413494630	3	0.6404535973107899	0.5	1	2	0.6404535973107899	0.5
53413494631	31	1.5694617387914869	10.0	10	21	0.0747362732757851	0.47619047619047616
53413494632	9	0.8797206468808375	2.5	3	6	0.1759441293761675	0.5
53413494633	14	4.5976264398817035	6.0	6	8	0.5747033049852129	0.75
53413494634	2	0.9556935130337528	0.0	0	2	0.9556935130337528	0.0
53413494635	9	1.0207227008112323	4.0	4	5	0.20414454016224645	0.8
53413494636	4	0.5792346670777917	0.3333333333333333	1	3	0.5792346670777917	0.3333333333333333
53413494637	3	0.12819561963982096	1.0	1	2	0.06409780981991048	0.5
53413494638	2	0.23849915306473263	0.0	0	2	0.11924957653236631	0.0
53413494639	3	1.556805234046148	0.0	0	3	0.5189350780153826	0.0
53413494640	3	0.6705215921945326	0.5	1	2	0.6705215921945326	0.5
53413494641	1	0.06410331475605371	0.0	0	1	0.06410331475605371	0.0
53413494642	9	0.32088878826995415	4.0	4	5	0.06417775765399084	0.8
53413494643	2	0.1283386133022085	0.0	0	2	0.06416930665110425	0.0
53413494644	3	0.5630802552014323	0.5	1	2	0.5630802552014323	0.5
53413494645	26	1.29141435007899	8.0	8	18	0.071745241671055	0.4444444444444444
53413494646	3	0.9757570019504982	0.0	0	3	0.9757570019504982	0.0
53413494647	9	3.3010088308939842	0.6666666666666666	2	7	0.6602017661787969	0.2857142857142857
53413494648	3	0.1385202873058159	0.5	1	2	0.1385202873058159	0.5
53413494649	8	0.7151400592115645	1.1666666666666665	3	5	0.35757002960578227	0.6
53413494650	3	0.9395664406567715	0.0	0	3	0.46978322032838576	0.0
53413494651	3	0.15031819035947974	0.5	1	2	0.15031819035947974	0.5
53413494652	14	0.7556708670395635	4.5	6	8	0.12594514450659391	0.75
53413494653	2	0.1288731139827836	0.0	0	2	0.0644365569913918	0.0
53413494654	7	2.0070083392543663	0.5	1	6	0.6690027797514554	0.16666666666666666
53413494655	12	1.0185320055808942	0.0	0	12	0.08487766713174118	0.0
53413494656	57	3.1176314956689284	13.0	13	44	0.07085526126520292	0.29545454545454547
53413494657	13	1.155386771931371	6.0	6	7	0.165055253133053	0.8571428571428571
53413494658	16	2.2082936189507443	6.5	7	9	0.27603670236884303	0.7777777777777778
53413494659	7	3.077490343045735	1.0	1	6	0.5129150571742892	0.16666666666666666
53413494660	1	0.06456286749867857	0.0	0	1	0.06456286749867857	0.0
53413494661	7	3.521465968198573	0.0	0	7	0.7042931936397145	0.0
53413494662	2	0.5933005701531385	0.0	0	2	0.5933005701531385	0.0
53413494663	3	0.12131492083144266	0.5	1	2	0.12131492083144266	0.5
53413494664	4	0.1817961896212459	1.0	2	2	0.1817961896212459	1.0
53413494665	2	0.9436902943800797	0.0	0	2	0.47184514719003984	0.0
53413494666	3	0.38353482690275426	0.5	1	2	0.38353482690275426	0.5
53413494667	9	0.499364710167469	4.0	4	5	0.0998729420334938	0.8
53413494668	9	1.3496726010776139	3.0	3	6	0.2699345202155228	0.5
53413494669	6	0.9842603943211011	1.0	2	4	0.49213019716055056	0.5
53413494670	2	0.9793339983475764	0.0	0	2	0.9793339983475764	0.0
53413494671	1	0.06482737378822803	0.0	0	1	0.06482737378822803	0.0
53413494672	3	0.7827836034517397	0.5	1	2	0.7827836034517397	0.5
53413494673	2	0.9793597890575808	0.0	0	2	0.9793597890575808	0.0
53413494674	4	1.0442399226925152	1.0	1	3	0.5221199613462576	0.3333333333333333
53413494675	1	0.06486003304241121	0.0	0	1	0.06486003304241121	0.0
53413494676	3	0.12975525053907128	1.0	1	2	0.06487762526953564	0.5
53413494677	1	0.06487878686156587	0.0	0	1	0.06487878686156587	0.0
53413494678	2	0.06490329813687036	1.0	1	1	0.06490329813687036	1.0
53413494679	35	1.8457659987332922	10.0	10	25	0.07383063994933169	0.4
53413494680	4	0.2372907943292895	1.0	2	2	0.2372907943292895	1.0
53413494681	8	0.2599549699590416	4.0	4	4	0.0649887424897604	1.0
53413494682	2	0.12998521209172187	0.0	0	2	0.06499260604586093	0.0
53413494683	5	1.3031972702789305	1.0	2	3	0.6515986351394653	0.6666666666666666
53413494684	1	0.06503504624163195	0.0	0	1	0.06503504624163195	0.0
53413494685	6	3.2284649507449625	1.0	1	5	0.6456929901489925	0.2
53413494686	9	2.5535437193106123	2.5	3	6	0.5107087438621225	0.5
53413494687	9	3.8365948761266475	1.5	2	7	0.6394324793544413	0.2857142857142857
53413494688	1	0.06512948872408947	0.0	0	1	0.06512948872408947	0.0
53413494689	2	0.4906873146776715	0.0	0	2	0.24534365733883576	0.0
53413494690	2	0.06516066652756743	1.0	1	1	0.06516066652756743	1.0
53413494691	1	0.06516406713032258	0.0	0	1	0.06516406713032258	0.0
53413494692	8	0.28618641154828534	4.0	4	4	0.07154660288707133	1.0
53413494693	8	1.516370181804641	2.0	3	5	0.5054567272682137	0.6
53413494694	13	0.8764602095639966	6.0	6	7	0.12520860136628523	0.8571428571428571
53413494695	8	0.7157895069991307	2.0	4	4	0.35789475349956534	1.0
53413494696	48	2.3467587558871252	15.0	15	33	0.07111390169354925	0.45454545454545453
53413494697	6	2.6866669133506553	1.0	1	5	0.5373333826701311	0.2
53413494698	9	1.235229288334313	4.0	4	5	0.2470458576668626	0.8
53413494699	12	4.132236276438298	2.0	3	9	0.5903194680626139	0.3333333333333333
53413494700	2	0.5725226516338028	0.0	0	2	0.5725226516338028	0.0
53413494701	6	1.6142979117235172	0.5	1	5	0.8071489558617586	0.2
53413494702	7	0.7627408548448673	0.6666666666666666	2	5	0.38137042742243366	0.4
53413494703	3	0.3370350184981006	0.5	1	2	0.3370350184981006	0.5
53413494704	7	1.0758446533282457	2.0	2	5	0.21516893066564916	0.4
53413494705	4	0.13097700966952977	2.0	2	2	0.06548850483476489	1.0
53413494706	10	0.5029879345604167	5.0	5	5	0.10059758691208334	1.0
53413494707	2	0.06556217333801517	1.0	1	1	0.06556217333801517	1.0
53413494708	20	3.401701688554147	8.0	10	10	0.4252127110692684	1.0
53413494709	2	0.06565308054038069	1.0	1	1	0.06565308054038069	1.0
53413494710	2	0.3862686084938909	0.0	0	2	0.19313430424694544	0.0
53413494711	1	0.06567419121293003	0.0	0	1	0.06567419121293003	0.0
53413494712	6	0.27165681440220585	2.0	2	4	0.06791420360055146	0.5
53413494713	2	0.06571715328338129	1.0	1	1	0.06571715328338129	1.0
53413494714	11	0.5698036172110499	5.0	5	6	0.09496726953517498	0.8333333333333334
53413494715	2	0.0657845256211344	1.0	1	1	0.0657845256211344	1.0
53413494716	44	2.2239439335553195	13.0	13	31	0.07174012688888128	0.41935483870967744
53413494717	14	3.873534815791874	6.0	6	8	0.48419185197398423	0.75
53413494718	2	0.5553872163665825	0.0	0	2	0.5553872163665825	0.0
53413494719	8	4.501989840817112	0.5	1	7	0.7503316401361854	0.14285714285714285
53413494720	5	0.8799037743896028	0.5	1	4	0.4399518871948014	0.25
53413494721	2	0.6040098089544739	0.0	0	2	0.6040098089544739	0.0
53413494722	2	0.6040240847521787	0.0	0	2	0.6040240847521787	0.0
53413494723	2	0.6040352966404705	0.0	0	2	0.6040352966404705	0.0
53413494724	5	0.41065594697914864	2.0	2	3	0.1368853156597162	0.6666666666666666
53413494725	9	0.3302673813139976	4.0	4	5	0.06605347626279952	0.8
53413494726	3	0.13215243979611602	1.0	1	2	0.06607621989805801	0.5
53413494727	12	5.0772763407575	2.0	3	9	0.6346595425946875	0.3333333333333333
53413494728	14	3.11333198902905	6.0	6	8	0.38916649862863123	0.75
53413494729	4	0.6363352316889578	1.0	1	3	0.3181676158444789	0.3333333333333333
53413494730	8	1.857105123439018	0.6666666666666666	2	6	0.6190350411463393	0.3333333333333333
53413494731	1	0.06622269833653624	0.0	0	1	0.06622269833653624	0.0
53413494732	2	0.5701118262964032	0.0	0	2	0.5701118262964032	0.0
53413494733	6	0.2734762378842164	2.0	2	4	0.0683690594710541	0.5
53413494734	33	1.8431938972850292	9.0	9	24	0.07679974572020955	0.375
53413494735	3	0.13254000750220105	1.0	1	2	0.06627000375110052	0.5
53413494736	9	0.3316032121487577	4.0	4	5	0.06632064242975154	0.8
53413494737	4	1.3916359717375568	1.0	1	3	0.46387865724585226	0.3333333333333333
53413494738	2	0.06642939437924808	1.0	1	1	0.06642939437924808	1.0
53413494739	1	0.06643723933411888	0.0	0	1	0.06643723933411888	0.0
53413494740	2	0.06645791230532348	1.0	1	1	0.06645791230532348	1.0
53413494741	1	0.06646912419361524	0.0	0	1	0.06646912419361524	0.0
53413494742	2	0.06648579051404892	1.0	1	1	0.06648579051404892	1.0
53413494743	1	0.06649363546891972	0.0	0	1	0.06649363546891972	0.0
53413494744	6	0.2743927508307319	2.0	2	4	0.06859818770768297	0.5
53413494745	7	0.4932350731973009	1.6666666666666665	3	4	0.24661753659865046	0.75
53413494746	9	0.5075279412545537	4.0	4	5	0.10150558825091074	0.8
53413494747	4	0.1332389155417209	2.0	2	2	0.06661945777086045	1.0
53413494748	45	2.1225942545233996	15.0	15	30	0.07075314181744666	0.5
53413494749	2	0.7909720865394817	0.0	0	2	0.7909720865394817	0.0
53413494750	13	2.71507339392983	6.0	6	7	0.3878676277042614	0.8571428571428571
53413494751	3	0.5189241691510987	0.5	1	2	0.5189241691510987	0.5
53413494752	2	0.8077950030465697	0.0	0	2	0.40389750152328485	0.0
53413494753	3	0.3387541747028353	0.5	1	2	0.3387541747028353	0.5
53413494754	2	0.9308274302853708	0.0	0	2	0.4654137151426854	0.0
53413494755	2	0.06680561551970453	1.0	1	1	0.06680561551970453	1.0
53413494756	11	0.575565012672969	5.0	5	6	0.0959275021121615	0.8333333333333334
53413494757	2	0.0668760517668707	1.0	1	1	0.0668760517668707	1.0
53413494758	7	2.421006371685814	2.0	2	5	0.48420127433716276	0.4
53413494759	5	0.16967398354047664	1.0	2	3	0.08483699177023832	0.6666666666666666
53413494760	4	0.43477490720142276	1.0	1	3	0.14492496906714092	0.3333333333333333
53413494761	2	0.06698227851630154	1.0	1	1	0.06698227851630154	1.0
53413494762	3	0.412087297715061	1.0	1	2	0.2060436488575305	0.5
53413494763	2	0.3795242031503925	0.0	0	2	0.3795242031503925	0.0
53413494764	4	0.7590606956077715	1.0	1	3	0.3795303478038857	0.3333333333333333
53413494765	1	0.06699992124742729	0.0	0	1	0.06699992124742729	0.0
53413494766	2	0.06704099783516282	1.0	1	1	0.06704099783516282	1.0
53413494767	14	1.770394971929371	5.0	5	9	0.19671055243659677	0.5555555555555556
53413494768	2	0.13416610166718085	0.0	0	2	0.06708305083359042	0.0
53634144642	3	2.174229511797684	0.0	0	3	0.7247431705992281	0.0
53634144643	3	1.372986662196277	0.0	0	3	0.45766222073209234	0.0
53634144644	1	0.2417540686107632	0.0	0	1	0.2417540686107632	0.0
53634144645	1	0.24176682928842858	0.0	0	1	0.24176682928842858	0.0
53634144646	2	0.8152201349891148	0.0	0	2	0.4076100674945574	0.0
53634144647	4	0.9103583605687384	1.0	1	3	0.30345278685624616	0.3333333333333333
53634144648	1	0.24184504315179714	0.0	0	1	0.24184504315179714	0.0
53634144649	12	4.307190621662843	1.0	2	10	0.5383988277078554	0.2
53634144650	2	1.049551462180062	0.0	0	2	0.524775731090031	0.0
53634144651	9	2.350481170138654	3.0	3	6	0.3917468616897757	0.5
53634144652	6	3.8929140428294806	0.0	0	6	0.6488190071382468	0.0
53634144653	1	0.24195157292523586	0.0	0	1	0.24195157292523586	0.0
53634144654	1	0.24197480476584038	0.0	0	1	0.24197480476584038	0.0
53634144655	5	1.6278247014195024	1.0	1	4	0.4069561753548756	0.25
53634144656	1	0.24200527551329995	0.0	0	1	0.24200527551329995	0.0
53634144657	3	1.239164055076701	0.0	0	3	0.41305468502556697	0.0
53634144658	2	1.0570343370307762	0.0	0	2	0.5285171685153881	0.0
53634144659	2	0.48427027627069164	0.0	0	2	0.24213513813534582	0.0
53634144660	2	0.6340671979979405	0.0	0	2	0.31703359899897027	0.0
53634144661	2	0.4841915236979757	0.0	0	2	0.24209576184898784	0.0
53634144662	1	0.2421931840675229	0.0	0	1	0.2421931840675229	0.0
53634144663	3	1.3003666556826075	0.0	0	3	0.4334555518942025	0.0
53634144664	7	3.058726355752138	1.0	1	6	0.6117452711504276	0.16666666666666666
53634144665	2	0.4845849835375474	0.0	0	2	0.2422924917687737	0.0
53634144666	2	0.48472003123706153	0.0	0	2	0.24236001561853077	0.0
53634144667	1	0.242333046481829	0.0	0	1	0.242333046481829	0.0
53634144668	2	0.48473881872555036	0.0	0	2	0.24236940936277518	0.0
53634144669	2	0.8953016363262757	0.0	0	2	0.44765081816313784	0.0
53634144670	1	0.24240937486248182	0.0	0	1	0.24240937486248182	0.0
53634144671	4	1.665658090537311	0.0	0	4	0.5552193635124371	0.0
53634144672	1	0.2424438185913781	0.0	0	1	0.2424438185913781	0.0
53634144673	2	0.6158602698388387	0.0	0	2	0.30793013491941934	0.0
53634144674	2	0.48505036107499044	0.0	0	2	0.24252518053749522	0.0
53634144675	2	0.4850414723707591	0.0	0	2	0.24252073618537956	0.0
53634144676	3	2.008427872053971	0.0	0	3	0.6694759573513237	0.0
53634144677	5	1.2343174890945867	2.0	2	3	0.4114391630315289	0.6666666666666666
53634144678	1	0.24259674470735743	0.0	0	1	0.24259674470735743	0.0
53634144679	4	2.415024307407486	0.0	0	4	0.6037560768518715	0.0
53634144680	1	0.24262166001467242	0.0	0	1	0.24262166001467242	0.0
53634144681	2	0.48526712424863094	0.0	0	2	0.24263356212431547	0.0
53634144682	4	0.7702499244375967	1.0	1	3	0.2567499748125322	0.3333333333333333
53634144683	2	0.4854505211120698	0.0	0	2	0.2427252605560349	0.0
53634144684	1	0.24272687668407697	0.0	0	1	0.24272687668407697	0.0
53634144685	2	0.48548129488353725	0.0	0	2	0.24274064744176863	0.0
53634144686	2	0.4855882286889865	0.0	0	2	0.24279411434449324	0.0
53634144687	6	3.8479190516479846	0.0	0	6	0.6413198419413307	0.0
53634144688	3	1.0077154962807675	0.0	0	3	0.3359051654269225	0.0
53634144689	1	0.24287397800523808	0.0	0	1	0.24287397800523808	0.0
53634144690	1	0.2428876140855929	0.0	0	1	0.2428876140855929	0.0
53634144691	3	0.889208698930396	0.0	0	3	0.29640289964346533	0.0
53634144692	2	0.4858495700611203	0.0	0	2	0.24292478503056014	0.0
53634144693	2	0.4859124643774235	0.0	0	2	0.24295623218871176	0.0
53634144694	2	0.24305239180721397	1.0	1	1	0.24305239180721397	1.0
53634144695	2	0.24311636354221194	1.0	1	1	0.24311636354221194	1.0
53634144696	2	0.243167810284884	1.0	1	1	0.243167810284884	1.0
53634144697	6	1.745198222649718	2.0	2	4	0.5817327408832393	0.5
53634144698	2	0.24332507974497633	1.0	1	1	0.24332507974497633	1.0
53634144699	2	0.24343612120919914	1.0	1	1	0.24343612120919914	1.0
53634144700	2	0.24348295525308447	1.0	1	1	0.24348295525308447	1.0
53634144701	2	0.24354443545735094	1.0	1	1	0.24354443545735094	1.0
53634144702	2	0.24359147151724153	1.0	1	1	0.24359147151724153	1.0
53634144703	2	0.24364907974807393	1.0	1	1	0.24364907974807393	1.0
53634144704	3	0.8888658104308069	1.0	1	2	0.44443290521540346	0.5
53634144705	2	0.2437555421828442	1.0	1	1	0.2437555421828442	1.0
53634144706	2	0.24380702259485046	1.0	1	1	0.24380702259485046	1.0
53634144707	2	0.24386079252158296	1.0	1	1	0.24386079252158296	1.0
53634144708	3	0.9096220122295775	1.0	1	2	0.45481100611478875	0.5
53634144709	4	2.168183273768353	1.0	1	3	0.7227277579227843	0.3333333333333333
53634144710	2	0.2440237184298225	1.0	1	1	0.2440237184298225	1.0
53634144711	2	0.24408513129542056	1.0	1	1	0.24408513129542056	1.0
53634144712	2	0.24413031554192965	1.0	1	1	0.24413031554192965	1.0
53634144713	2	0.24419017961815406	1.0	1	1	0.24419017961815406	1.0
53634144714	3	1.0159057301738883	1.0	1	2	0.5079528650869441	0.5
53634144715	2	0.24434364444348075	1.0	1	1	0.24434364444348075	1.0
53634144716	2	0.24440559601842615	1.0	1	1	0.24440559601842615	1.0
53634144717	24	4.094974020236685	8.0	8	16	0.2559358762647928	0.5
53634144718	10	4.436524567822951	2.0	2	8	0.5545655709778688	0.25
53634144719	2	0.24451323687989376	1.0	1	1	0.24451323687989376	1.0
53634144720	13	5.366513059307826	5.0	5	8	0.6708141324134782	0.625
53634144721	2	0.2445292634829775	1.0	1	1	0.2445292634829775	1.0
53634144722	4	1.9822685838479384	0.0	0	4	0.4955671459619846	0.0
53634144723	2	0.244583841473731	1.0	1	1	0.244583841473731	1.0
53634144724	12	2.685289467218812	6.0	6	6	0.4475482445364687	1.0
53634144725	2	0.48926458329131683	0.0	0	2	0.24463229164565842	0.0
53634144726	4	0.48935171952825085	2.0	2	2	0.24467585976412543	1.0
53634144727	37	8.40345858808253	12.0	12	25	0.33613834352330124	0.48
53634144728	2	0.7469187929664896	0.0	0	2	0.7469187929664896	0.0
53634144729	2	0.7469300048547813	0.0	0	2	0.7469300048547813	0.0
53634144730	9	1.6499442755684166	1.0	2	7	0.3299888551136833	0.2857142857142857
53634144731	4	1.1167861933642658	1.0	1	3	0.37226206445475524	0.3333333333333333
53634144732	17	7.344015883575753	3.0	3	14	0.5245725631125537	0.21428571428571427
53634144733	37	16.071717432671516	2.5	4	33	0.573989908309697	0.12121212121212122
53634144734	4	1.2402151106827175	0.0	0	4	0.6201075553413588	0.0
53634144735	21	3.551734160943525	7.0	7	14	0.2536952972102518	0.5
53634144736	4	0.4902506234129749	2.0	2	2	0.24512531170648744	1.0
53634144737	3	0.4901509621837149	1.0	1	2	0.24507548109185745	0.5
53634144738	2	0.24508659197214658	1.0	1	1	0.24508659197214658	1.0
53634144739	9	1.2256620123413597	4.0	4	5	0.24513240246827195	0.8
53634144740	1	0.24511962158900605	0.0	0	1	0.24511962158900605	0.0
53634144741	2	0.24515026068313664	1.0	1	1	0.24515026068313664	1.0
53634144742	6	0.9127077393712056	1.0	2	4	0.4563538696856028	0.5
53634144743	11	2.1808812928027725	1.5	3	8	0.43617625856055453	0.375
53634144744	2	1.1552740133311035	0.0	0	2	0.5776370066655517	0.0
53634144745	9	1.5048031157063169	2.0	3	6	0.3762007789265792	0.5
53634144746	6	1.0130005380022915	2.0	2	4	0.2532501345005729	0.5
53634144747	24	4.061292464058911	8.0	8	16	0.25383077900368195	0.5
53634144748	2	0.24575391817617795	1.0	1	1	0.24575391817617795	1.0
53634144749	4	0.49155069741480456	2.0	2	2	0.24577534870740228	1.0
53634144750	2	0.2457882945664058	1.0	1	1	0.2457882945664058	1.0
53634144751	11	1.2548609007011537	4.0	5	6	0.25097218014023076	0.8333333333333334
53634144752	6	0.7580261716448515	3.0	3	3	0.25267539054828386	1.0
53634144753	3	0.4917105930829652	1.0	1	2	0.2458552965414826	0.5
53634144754	22	3.5083447256331413	8.0	8	14	0.25059605183093864	0.5714285714285714
53634144755	2	0.24595485676273998	1.0	1	1	0.24595485676273998	1.0
53634144756	10	1.9806562604406501	3.0	3	7	0.28295089434866433	0.42857142857142855
53634144757	13	5.280549121252262	4.0	4	9	0.5867276801391402	0.4444444444444444
53634144758	3	0.49211556783483656	1.0	1	2	0.24605778391741828	0.5
53634144759	17	3.4006580402016566	7.5	8	9	0.4250822550252071	0.8888888888888888
53634144760	6	1.9277800861847414	2.0	2	4	0.48194502154618535	0.5
53634144761	14	4.660302006520605	4.5	5	9	0.5825377508150756	0.5555555555555556
53634144762	1	0.2461532364799021	0.0	0	1	0.2461532364799021	0.0
53634144763	2	0.6642055954595152	0.0	0	2	0.6642055954595152	0.0
53634144764	3	0.317666733994112	0.5	1	2	0.317666733994112	0.5
53634144765	10	2.159096997883916	4.0	4	6	0.3598494996473193	0.6666666666666666
53634144766	2	0.24626990072293783	1.0	1	1	0.24626990072293783	1.0
53634144767	31	5.49578835348774	10.0	10	21	0.26170420730894	0.47619047619047616
53634144768	4	0.7396404929904318	1.0	1	3	0.2465468309968106	0.3333333333333333
53634144769	9	1.3937430323417188	4.0	4	5	0.27874860646834376	0.8
53634144770	4	0.9929197767170965	1.0	1	3	0.33097325890569884	0.3333333333333333
54546665540	5	1.095793363484671	2.0	2	3	0.36526445449489037	0.6666666666666666
54546665541	10	2.0230868267820834	5.0	5	5	0.4046173653564167	1.0
54546665542	2	0.7304140179983467	0.0	0	2	0.36520700899917335	0.0
54546665543	3	0.7304823330774576	1.0	1	2	0.3652411665387288	0.5
54546665544	14	4.240730958552141	3.0	3	11	0.3855209962320128	0.2727272727272727
54573051074	6	1.8278109845327457	2.0	2	4	0.4569527461331864	0.5
54573051075	8	2.4622360202146645	3.0	3	5	0.4924472040429329	0.6
54573051076	2	0.4546899816929729	1.0	1	1	0.4546899816929729	1.0
54573051077	3	1.7050520196263936	0.0	0	3	0.5683506732087978	0.0
54573051078	6	1.8287863851447934	2.0	2	4	0.45719659628619835	0.5
54573051079	6	3.9878959416903696	1.0	1	5	0.797579188338074	0.2
54573051080	6	2.274778736078109	1.0	1	5	0.4549557472156218	0.2
54573051081	3	0.9099608604090615	1.0	1	2	0.4549804302045308	0.5
54573051082	48	15.653094412146386	14.0	14	34	0.46038512976901136	0.4117647058823529
54633935217	9	7.579136184275229	0.0	0	9	0.8421262426972477	0.0
54633935218	22	18.528663865804536	0.0	0	22	0.8422119939002062	0.0
54633935219	1	0.8445104019219534	0.0	0	1	0.8445104019219534	0.0
54633935220	1	0.844521613810245	0.0	0	1	0.844521613810245	0.0
54633935221	2	0.844660499813859	1.0	1	1	0.844660499813859	1.0
54748776616	2	0.5962918211429749	0.0	0	2	0.5962918211429749	0.0
54748776617	5	2.7580136803218602	0.0	0	5	0.551602736064372	0.0
54748776618	2	0.4685724205662125	0.0	0	2	0.23428621028310626	0.0
54748776619	4	0.3624765438374563	2.0	2	2	0.18123827191872816	1.0
54748776620	10	1.060760118215726	5.0	5	5	0.2121520236431452	1.0
54748776621	3	0.3625759020427084	1.0	1	2	0.1812879510213542	0.5
54748776622	32	5.107472885159256	4.0	4	28	0.18240974589854483	0.14285714285714285
54748776623	2	0.8092536596125259	0.0	0	2	0.8092536596125259	0.0
54748776624	5	1.3784237546310907	0.5	1	4	0.6892118773155453	0.25
54748776625	2	0.6070202851341439	0.0	0	2	0.3035101425670719	0.0
54748776626	2	0.18147484949555087	1.0	1	1	0.18147484949555087	1.0
54748776627	9	0.909036637185012	4.0	4	5	0.1818073274370024	0.8
54748776628	30	4.959851945163293	5.0	5	25	0.19839407780653173	0.2
54748776629	5	1.1341694349312677	1.0	1	4	0.2835423587328169	0.25
54748776630	2	0.986984411805317	0.0	0	2	0.4934922059026585	0.0
54748776631	3	0.7361657840306819	0.0	0	3	0.24538859467689397	0.0
54748776632	5	0.9567678004803738	2.0	2	3	0.3189226001601246	0.6666666666666666
54748776633	14	4.055435212002498	5.0	5	9	0.45060391244472203	0.5555555555555556
54748776634	1	0.1816088197763703	0.0	0	1	0.1816088197763703	0.0
54748776635	2	1.039066393805893	0.0	0	2	0.5195331969029465	0.0
54748776636	3	1.3334033094329318	0.0	0	3	0.4444677698109773	0.0
54748776637	1	0.18164046895052718	0.0	0	1	0.18164046895052718	0.0
54748776638	2	0.36506931825692374	0.0	0	2	0.18253465912846187	0.0
54748776639	7	1.6027733026556317	1.0	2	5	0.4006933256639079	0.4
54748776640	3	0.3647358571709133	1.0	1	2	0.18236792858545664	0.5
54748776641	13	1.8436840217831167	3.0	3	10	0.18436840217831169	0.3
54748776642	2	0.4877815837967272	0.0	0	2	0.2438907918983636	0.0
54748776643	1	0.1830624932808635	0.0	0	1	0.1830624932808635	0.0
54748776644	14	2.154559415381842	2.0	4	10	0.3590932358969737	0.4
54748776645	3	0.3727636365264735	1.0	1	2	0.18638181826323674	0.5
54748776646	2	0.36631326547862625	0.0	0	2	0.18315663273931312	0.0
54748776647	2	0.3662956900861689	0.0	0	2	0.18314784504308446	0.0
54748776648	3	0.6529187592298167	0.0	0	3	0.21763958640993888	0.0
55080463108	1	0.8446731594835218	0.0	0	1	0.8446731594835218	0.0
55080463109	1	0.8446837989931321	0.0	0	1	0.8446837989931321	0.0
55080463110	1	0.8447150104659442	0.0	0	1	0.8447150104659442	0.0
55080463111	1	0.8447621812031716	0.0	0	1	0.8447621812031716	0.0
55080463112	1	0.8449929171505091	0.0	0	1	0.8449929171505091	0.0
55253627439	17	15.278241223069543	0.0	0	17	0.8987200719452673	0.0
55253627440	2	1.7783587795499334	0.0	0	2	0.8891793897749667	0.0
55253627441	1	0.8891702148813946	0.0	0	1	0.8891702148813946	0.0
55253627442	1	0.8891811237456784	0.0	0	1	0.8891811237456784	0.0
55253627443	1	0.8891828408817231	0.0	0	1	0.8891828408817231	0.0
55253627444	1	0.8892174192879562	0.0	0	1	0.8892174192879562	0.0
55253627445	6	5.496905737682151	0.0	0	6	0.9161509562803585	0.0
55253627446	4	3.557165327575518	0.0	0	4	0.8892913318938795	0.0
55253627447	2	1.7785720074434817	0.0	0	2	0.8892860037217408	0.0
55253627448	2	1.7786342957117691	0.0	0	2	0.8893171478558846	0.0
55253627449	16	14.27175836111418	0.0	0	16	0.8919848975696363	0.0
55253627450	2	1.779042098687714	0.0	0	2	0.889521049343857	0.0
55253627451	21	18.924636919158953	0.0	0	21	0.9011731866266168	0.0
55253627452	1	0.8896773087239231	0.0	0	1	0.8896773087239231	0.0
55253627453	2	1.7936952286210082	0.0	0	2	0.8968476143105041	0.0
55253627454	2	1.7797422861619339	0.0	0	2	0.8898711430809669	0.0
55253627455	4	3.559146565877739	0.0	0	4	0.8897866414694348	0.0
55253627456	2	1.817667390546129	0.0	0	2	0.9088336952730645	0.0
55253627457	19	17.030288596361487	0.0	0	19	0.8963309787558678	0.0
55253627458	2	1.780004469267423	0.0	0	2	0.8900022346337115	0.0
55253627459	5	4.450149907660167	0.0	0	5	0.8900299815320334	0.0
55253627460	12	10.88212046234595	0.0	0	12	0.9068433718621626	0.0
55253627461	1	0.8901864900651727	0.0	0	1	0.8901864900651727	0.0
55253627462	2	1.7804303863451727	0.0	0	2	0.8902151931725863	0.0
55253627463	1	0.890218038231327	0.0	0	1	0.890218038231327	0.0
55253627464	2	1.7805769826263207	0.0	0	2	0.8902884913131603	0.0
55253627465	11	9.87225645851061	0.0	0	11	0.8974778598646008	0.0
55253627466	2	1.7811180824964006	0.0	0	2	0.8905590412482003	0.0
55253627467	1	0.890574259787263	0.0	0	1	0.890574259787263	0.0
55253627468	1	0.8905933166304255	0.0	0	1	0.8905933166304255	0.0
55253627469	1	0.8906478609518449	0.0	0	1	0.8906478609518449	0.0
55253627470	1	0.8906894425795936	0.0	0	1	0.8906894425795936	0.0
55253627471	18	16.63077406775758	0.0	0	18	0.923931892653199	0.0
55614027306	6	4.786653960757786	1.0	1	5	0.7977756601262976	0.2
55614027307	13	0.21905558392945168	8.0	8	5	0.016850429533034745	1.6
55614027308	15	0.7849371950757791	8.0	8	7	0.09811714938447239	1.1428571428571428
55614027309	10	1.3728622540063729	5.0	5	5	0.2288103756677288	1.0
55614027310	6	0.16394612273543005	5.0	5	1	0.03278922454708601	5.0
55614027312	3	0.2991200822528367	2.0	2	1	0.14956004112641835	2.0
55614027313	15	0.21965705291576937	10.0	10	5	0.014643803527717958	2.0
55614027314	1	0.5548459481498313	0.0	0	1	0.5548459481498313	0.0
55614027315	11	0.7639905931920539	5.0	5	6	0.10914151331315056	0.8333333333333334
55614027316	14	2.541399628162607	7.0	7	7	0.3176749535203259	1.0
55614027317	4	1.7536724573768956	0.5	1	3	0.8768362286884478	0.3333333333333333
55614027318	12	1.8172323490788087	5.0	6	6	0.36344646981576173	1.0
55614027319	2	0.6391171267586798	1.0	1	1	0.6391171267586798	1.0
55614027320	4	2.0381077941916157	1.0	1	3	0.5095269485479039	0.3333333333333333
55614027321	1	0.9963456988115769	0.0	0	1	0.9963456988115769	0.0
55614027322	3	1.5665860072873234	1.0	1	2	0.7832930036436617	0.5
55614027323	2	1.4524863911076324	0.0	0	2	0.7262431955538162	0.0
55614027324	8	0.39397225316901663	6.0	6	2	0.06566204219483611	3.0
55614027326	5	0.8583972851473085	2.0	2	3	0.21459932128682713	0.6666666666666666
55614027327	16	9.090062236754205	0.0	0	16	0.6492901597681575	0.0
55614027328	11	0.04395965915455561	10.0	10	1	0.003996332650414146	10.0
55614027329	8	2.5873049708024585	3.0	3	5	0.4312174951337431	0.6
55614027330	11	1.1396891519122312	5.0	5	6	0.1628127359874616	0.8333333333333334
55614027331	1	0.5560678419576267	0.0	0	1	0.5560678419576267	0.0
55614027332	13	1.160753663804358	7.0	7	6	0.16582195197205116	1.1666666666666667
55614027333	4	0.4294301024116772	1.0	2	2	0.4294301024116772	1.0
55614027334	2	0.04937022015401229	1.0	1	1	0.04937022015401229	1.0
55614027335	4	1.2587317293778777	1.0	1	3	0.41957724312595923	0.3333333333333333
55614027336	1	0.23409086080602298	0.0	0	1	0.23409086080602298	0.0
55614027337	1	0.0	1.0	1	0	0.0	inf
55614027339	4	0.0	4.0	4	0	0.0	inf
55614027341	1	0.0	1.0	1	0	0.0	inf
55614027342	10	0.26506523416668415	4.0	4	6	0.026506523416668416	0.6666666666666666
55614027343	9	0.17682386867585953	5.0	5	4	0.01964709651953995	1.25
55614027344	11	0.8639911083328673	7.0	7	4	0.1439985180554779	1.75
55614027346	4	0.05978869058511478	3.0	3	1	0.02989434529255739	3.0
55614027347	13	0.2213846264540565	8.0	8	5	0.017029586650312036	1.6
55614027348	9	0.900779973695496	5.0	5	4	0.1801559947390992	1.25
55614027349	11	1.4715634022013753	3.5	4	7	0.24526056703356255	0.5714285714285714
55614027350	12	2.238093336579506	6.0	6	6	0.3730155560965844	1.0
55614027351	8	1.8453915620675487	4.0	4	4	0.36907831241350975	1.0
55614027352	2	1.2173985139769994	0.0	0	2	0.6086992569884997	0.0
55614027353	8	3.662525462013129	2.0	2	6	0.6104209103355215	0.3333333333333333
55614027354	8	3.8805551749985527	2.0	2	6	0.6467591958330922	0.3333333333333333
55614027355	3	1.728588264681505	0.0	0	3	0.8642941323407525	0.0
55614027356	10	5.70937782201629	2.0	2	8	0.7136722277520362	0.25
55614027357	5	1.0884423714160552	2.0	2	3	0.5442211857080276	0.6666666666666666
55614027358	3	0.6378364462933548	0.5	1	2	0.6378364462933548	0.5
55614027359	1	0.6146450088898826	0.0	0	1	0.6146450088898826	0.0
55614027360	6	0.16733514323961687	5.0	5	1	0.03346702864792338	5.0
55614027362	2	0.0	2.0	2	0	0.0	inf
55614027363	4	0.555476507440906	0.0	0	4	0.1388691268602265	0.0
55614027364	10	0.09669361414276344	8.0	8	2	0.009669361414276344	4.0
55614027365	8	3.6577327332964162	1.0	2	6	0.7315465466592832	0.3333333333333333
55614027366	2	0.7144908807786721	0.0	0	2	0.7144908807786721	0.0
55614027367	5	1.08652156956874	2.0	2	3	0.271630392392185	0.6666666666666666
55614027368	1	0.7177360995564503	0.0	0	1	0.7177360995564503	0.0
55614027369	3	0.4395939316681536	0.5	1	2	0.4395939316681536	0.5
55614027370	1	0.582640320233078	0.0	0	1	0.582640320233078	0.0
55614027371	9	2.8893421978405365	3.0	3	6	0.36116777473006706	0.5
55614027372	15	2.750492456099481	9.0	9	6	0.2750492456099481	1.5
55614027373	5	0.5301666965369777	1.0	2	3	0.26508334826848884	0.6666666666666666
55614027374	2	0.0	2.0	2	0	0.0	inf
55614027377	2	0.28275799792307343	1.0	1	1	0.14137899896153672	1.0
55614027378	1	0.0	1.0	1	0	0.0	inf
55614027380	15	0.09716848643245357	13.0	13	2	0.006477899095496905	6.5
55614027381	1	0.0	1.0	1	0	0.0	inf
55614027382	4	0.0	4.0	4	0	0.0	inf
55614027384	3	0.08898953176629294	2.0	2	1	0.08898953176629294	2.0
55614027385	5	1.863703437541382	2.0	2	3	0.6212344791804606	0.6666666666666666
55614027386	6	0.16839626597656204	5.0	5	1	0.03367925319531241	5.0
55614027388	11	3.5575155896592987	3.5	4	7	0.5082165128084712	0.5714285714285714
55614027389	19	0.19563532973069211	15.0	15	4	0.010296596301615375	3.75
55614027390	2	0.0	2.0	2	0	0.0	inf
55614027391	3	0.020983537143352948	2.0	2	1	0.020983537143352948	2.0
55614027392	4	0.0	4.0	4	0	0.0	inf
55614027393	2	0.49581916092854234	1.0	1	1	0.24790958046427117	1.0
55614027394	16	3.2892128469923705	8.0	8	8	0.3654680941102634	1.0
55614027395	7	0.9481191922713256	3.0	3	4	0.15801986537855425	0.75
55614027396	4	3.2185981186855477	0.0	0	4	0.8046495296713869	0.0
55614027397	14	3.024564573860536	7.0	7	7	0.378070571732567	1.0
55614027399	6	1.496534263917817	3.0	3	3	0.2993068527835634	1.0
55614027401	1	0.0	1.0	1	0	0.0	inf
55614027402	2	0.8521728353320067	0.0	0	2	0.42608641766600336	0.0
55614027403	1	0.5957897103619093	0.0	0	1	0.5957897103619093	0.0
55614027404	2	0.0	2.0	2	0	0.0	inf
55614027405	20	0.34704191498782666	13.0	13	7	0.01735209574939133	1.8571428571428572
55614027406	1	0.0	1.0	1	0	0.0	inf
55614027407	6	1.2867927625880635	4.0	4	2	0.21446546043134393	2.0
55614027408	10	4.504108652018913	3.0	3	7	0.5630135815023641	0.42857142857142855
55614027409	15	1.554722752055959	8.0	8	7	0.19434034400699488	1.1428571428571428
55614027410	14	0.8104082820905707	7.0	7	7	0.10130103526132134	1.0
55614027411	8	1.1057596884266747	4.0	4	4	0.22115193768533495	1.0
55614027412	9	0.8454586650506284	5.0	5	4	0.16909173301012567	1.25
55614027413	9	1.2105103405764264	3.5	4	5	0.3026275851441066	0.8
55614027414	8	2.705380362973604	3.0	3	5	0.5410760725947208	0.6
55614027415	1	0.0	1.0	1	0	0.0	inf
55614027416	9	4.515077717072343	2.0	2	7	0.6450111024389061	0.2857142857142857
55614027417	7	4.548139420807319	1.0	1	6	0.7580232368012197	0.16666666666666666
55614027418	1	0.0	1.0	1	0	0.0	inf
55614027419	3	0.5787795250179483	1.0	1	2	0.28938976250897414	0.5
55614027420	10	1.838603487597581	6.0	6	4	0.2626576410853687	1.5
55614027421	2	0.03796190496648605	1.0	1	1	0.03796190496648605	1.0
55614027422	2	0.9690232697859442	0.0	0	2	0.9690232697859442	0.0
55614027423	2	1.948001450609595	0.0	0	2	0.9740007253047975	0.0
55614027424	6	1.60256020943942	1.0	2	4	0.5341867364798066	0.5
55614027425	2	0.4722257790132777	1.0	1	1	0.23611288950663886	1.0
55614027426	2	0.6873485490217257	0.0	0	2	0.34367427451086285	0.0
55614027427	5	1.447971232382142	0.5	1	4	0.723985616191071	0.25
55614027428	2	0.8889227452749551	0.0	0	2	0.8889227452749551	0.0
55614027429	15	0.199116940903955	11.0	11	4	0.013274462726930333	2.75
55614027430	1	0.0	1.0	1	0	0.0	inf
55614027431	5	0.16886181186067617	4.0	4	1	0.04221545296516904	4.0
55614027433	1	0.0	1.0	1	0	0.0	inf
55614027434	1	0.0	1.0	1	0	0.0	inf
55614027435	1	0.0	1.0	1	0	0.0	inf
55614027436	5	0.46264799818805113	4.0	4	1	0.09252959963761023	4.0
55614027437	1	0.0	1.0	1	0	0.0	inf
55614027438	18	0.20044324331713378	14.0	14	4	0.011135735739840766	3.5
55614027439	13	4.3367081229322615	2.0	3	10	0.5420885153665327	0.3
55614027440	3	1.1228065060062558	1.0	1	2	0.5614032530031279	0.5
55614027441	1	0.0	1.0	1	0	0.0	inf
55614027443	1	0.0	1.0	1	0	0.0	inf
55614027445	1	0.0	1.0	1	0	0.0	inf
55614027446	1	0.585393124998043	0.0	0	1	0.585393124998043	0.0
55614027447	2	0.0	2.0	2	0	0.0	inf
55614027448	1	0.0	1.0	1	0	0.0	inf
55614027449	6	0.17001464986400788	5.0	5	1	0.03400292997280158	5.0
55614027450	11	0.4067042782309876	6.0	6	5	0.06778404637183126	1.2
55614027451	8	0.3165069264385989	4.0	4	4	0.07912673160964973	1.0
55614027452	5	0.2539749258407662	3.0	3	2	0.06349373146019155	1.5
55614027453	8	1.9123601371648273	3.0	3	5	0.3824720274329655	0.6
55614027454	4	1.684452514909034	0.5	1	3	0.842226257454517	0.3333333333333333
55614027455	8	1.5599079978708859	4.0	4	4	0.38997699946772146	1.0
55614027456	3	0.6724332696522769	0.5	1	2	0.6724332696522769	0.5
55614027457	14	3.6420978055775746	6.0	6	8	0.4552622256971968	0.75
55614027458	2	0.3777455532321096	1.0	1	1	0.1888727766160548	1.0
55614027460	4	1.8503557013647227	0.0	0	4	0.4625889253411807	0.0
55614027461	2	0.0	2.0	2	0	0.0	inf
55614027462	20	0.3029971734257238	14.0	14	6	0.01514985867128619	2.3333333333333335
55614027463	1	0.0	1.0	1	0	0.0	inf
55614027464	6	0.17022639630685113	5.0	5	1	0.03404527926137023	5.0
55614027465	2	0.4849463228322832	1.0	1	1	0.2424731614161416	1.0
55614027466	9	0.884073620423441	5.0	5	4	0.17681472408468818	1.25
55614027467	10	1.243721603493961	5.0	5	5	0.2487443206987922	1.0
55614027468	12	1.478720324227608	7.0	7	5	0.21124576060394398	1.4
55614027469	16	3.0085250417524994	8.0	9	7	0.3760656302190624	1.2857142857142858
55614027470	13	4.681170428210297	5.0	5	8	0.5851463035262872	0.625
55614027471	8	1.7619820490597888	4.0	4	4	0.4404955122649472	1.0
55614027472	8	2.8728243928400548	2.0	2	6	0.4788040654733425	0.3333333333333333
55614027473	6	0.9462529347454297	4.0	4	2	0.23656323368635743	2.0
55614027474	14	3.961144982274274	6.0	6	8	0.49514312278428424	0.75
55614027475	7	2.1584999395803797	3.0	3	4	0.43169998791607594	0.75
55614027476	8	2.352322882719911	3.0	3	5	0.4704645765439822	0.6
55614027477	1	0.0	1.0	1	0	0.0	inf
55614027478	4	1.0107439855542395	2.0	2	2	0.33691466185141317	1.0
55614027479	5	0.17043948952306276	4.0	4	1	0.04260987238076569	4.0
55614027480	1	0.0	1.0	1	0	0.0	inf
55614027481	12	0.42558583883964435	5.0	5	7	0.053198229854955544	0.7142857142857143
55614027482	7	0.8965095910297083	4.0	4	3	0.22412739775742707	1.3333333333333333
55614027483	9	0.6641145199104787	3.0	3	6	0.11068575331841311	0.5
55614027484	9	0.8001249940363191	5.0	5	4	0.1600249988072638	1.25
55614027485	6	0.431090606636219	3.0	3	3	0.0862181213272438	1.0
55614027486	7	0.6108945480829573	4.0	4	3	0.15272363702073932	1.3333333333333333
55614027487	5	1.1119507382624407	1.0	2	3	0.5559753691312204	0.6666666666666666
55614027489	4	3.054601020578125	0.0	0	4	0.7636502551445312	0.0
55614027490	2	1.24481131149565	0.0	0	2	0.622405655747825	0.0
55614027491	1	0.4885757760520598	0.0	0	1	0.4885757760520598	0.0
55614027492	5	0.10160758613196487	3.0	3	2	0.020321517226392975	1.5
55614027493	2	0.0	2.0	2	0	0.0	inf
55614027494	6	0.17064534383241936	5.0	5	1	0.034129068766483875	5.0
55614027496	2	0.0	2.0	2	0	0.0	inf
55614027497	15	3.9671619953215114	7.0	7	8	0.4958952494151889	0.875
55614027498	7	3.9663127873740804	1.0	1	6	0.6610521312290134	0.16666666666666666
55614027499	2	0.19319453868584616	1.0	1	1	0.19319453868584616	1.0
55614027500	2	0.3871425634019657	1.0	1	1	0.19357128170098284	1.0
55614027502	2	0.7800447041218033	0.0	0	2	0.39002235206090163	0.0
55614027503	1	0.9268183216530484	0.0	0	1	0.9268183216530484	0.0
55614027504	1	0.03252491353967495	0.0	0	1	0.03252491353967495	0.0
55614027505	11	0.20409124834005973	7.0	7	4	0.01855374984909634	1.75
55614027506	1	0.0	1.0	1	0	0.0	inf
55614027507	5	0.1708583360406284	4.0	4	1	0.0427145840101571	4.0
55614027508	3	0.9956759484154823	1.0	1	2	0.3318919828051608	0.5
55614027509	16	0.34438533718003234	9.0	9	7	0.02152408357375202	1.2857142857142858
55614027510	1	0.7334949304251828	0.0	0	1	0.7334949304251828	0.0
55614027511	4	1.0511492067656372	2.0	2	2	0.5255746033828186	1.0
55614027512	5	0.17104631193351977	4.0	4	1	0.04276157798337994	4.0
55614027514	1	0.0	1.0	1	0	0.0	inf
55614027515	11	0.04864639680717744	10.0	10	1	0.004422399709743403	10.0
55614027516	10	0.32262898780856974	5.0	5	5	0.05377149796809496	1.0
55614027517	10	0.1733234700141078	5.0	5	5	0.028887245002351302	1.0
55614027518	9	0.4406195332575078	5.0	5	4	0.08812390665150156	1.25
55614027519	7	0.1317563200791418	4.0	4	3	0.03293908001978545	1.3333333333333333
55614027520	6	0.5176813666867595	3.0	3	3	0.1035362733373519	1.0
55614027521	5	0.9003244949423105	2.0	2	3	0.22508112373557762	0.6666666666666666
55614027522	13	3.1718914458915113	6.0	6	7	0.45312734941307303	0.8571428571428571
55614027523	1	0.0	1.0	1	0	0.0	inf
55614027525	7	3.8847705419722427	1.0	1	6	0.6474617569953738	0.16666666666666666
55614027526	1	0.0	1.0	1	0	0.0	inf
55614027528	1	0.36263088406547245	0.0	0	1	0.36263088406547245	0.0
55614027529	4	0.0	4.0	4	0	0.0	inf
55614027531	3	0.9251814533011217	1.0	1	2	0.46259072665056084	0.5
55614027532	10	0.09771941774812287	8.0	8	2	0.009771941774812287	4.0
55614027533	2	0.7465890691765764	0.0	0	2	0.3732945345882882	0.0
55614027534	7	1.8149805440068805	3.0	3	4	0.4537451360017201	0.75
55614027535	4	0.0	4.0	4	0	0.0	inf
55614027537	6	1.817554497268525	2.0	2	4	0.30292574954475415	0.5
55614027538	12	0.19873263912328823	8.0	8	4	0.01656105326027402	2.0
55614027539	2	0.08512786114847379	1.0	1	1	0.08512786114847379	1.0
55614027540	2	0.8446725871048403	1.0	1	1	0.42233629355242014	1.0
55614027541	1	0.12261371539857235	0.0	0	1	0.12261371539857235	0.0
55614027543	5	0.17163714141022726	4.0	4	1	0.042909285352556815	4.0
55614027545	1	0.0	1.0	1	0	0.0	inf
55614027546	13	0.36649996193681766	8.0	8	5	0.02819230476437059	1.6
55614027547	3	0.5903675671114846	0.5	1	2	0.5903675671114846	0.5
55614027548	2	0.6720958019154956	1.0	1	1	0.6720958019154956	1.0
55614027549	2	0.7925661948369626	0.0	0	2	0.3962830974184813	0.0
55614027550	1	0.8626623817276254	0.0	0	1	0.8626623817276254	0.0
55614027551	1	0.8626657823303805	0.0	0	1	0.8626657823303805	0.0
55614027552	3	0.9122607116209067	0.0	0	3	0.3040869038736356	0.0
55614027553	4	0.0	4.0	4	0	0.0	inf
55614027555	2	0.0	2.0	2	0	0.0	inf
55614027556	12	0.20035944034428646	8.0	8	4	0.01669662002869054	2.0
55614027557	2	0.05538679549990493	1.0	1	1	0.027693397749952466	1.0
55614027558	5	3.1151399986067627	1.0	1	4	0.7787849996516907	0.25
55614027559	3	0.8991577515039503	1.0	1	2	0.44957887575197514	0.5
55614027560	1	0.0	1.0	1	0	0.0	inf
55614027562	1	0.29853763644034736	0.0	0	1	0.29853763644034736	0.0
55614027563	4	0.0990193570726157	2.0	2	2	0.024754839268153923	1.0
55614027564	5	0.17203312644986465	4.0	4	1	0.043008281612466163	4.0
55614027566	2	0.0	2.0	2	0	0.0	inf
55614027567	15	0.2508157322118931	10.0	10	5	0.01672104881412621	2.0
55614027568	7	0.5188067978520445	5.0	5	2	0.10376135957040891	2.5
55614027569	11	3.3367921279211137	5.0	5	6	0.47668458970301625	0.8333333333333334
55614027570	12	2.4507617468014216	5.0	5	7	0.3063452183501777	0.7142857142857143
55614027571	8	1.357774924339114	4.0	4	4	0.3394437310847785	1.0
55614027572	5	3.5691099279183325	0.0	0	5	0.7138219855836665	0.0
55614027575	2	0.0	2.0	2	0	0.0	inf
55614027576	10	1.0722513609734101	5.0	6	4	0.17870856016223502	1.5
55614027578	5	0.5843399818933055	3.0	3	2	0.19477999396443516	1.5
55614027579	16	0.3538333563912157	9.0	9	7	0.022114584774450982	1.2857142857142858
55614027580	2	0.0	2.0	2	0	0.0	inf
55614027581	1	0.0	1.0	1	0	0.0	inf
55614027582	11	0.05024191921669506	10.0	10	1	0.004567447201517733	10.0
55614027583	2	0.0	2.0	2	0	0.0	inf
55614027584	5	0.17446600520117142	4.0	4	1	0.043616501300292855	4.0
55614027585	2	0.0	2.0	2	0	0.0	inf
55614027586	9	0.2554739519384395	4.0	4	5	0.028385994659826615	0.8
55614027587	9	0.9953796246051051	3.0	3	6	0.16589660410085086	0.5
55614027588	2	0.09276450384852274	1.0	1	1	0.09276450384852274	1.0
55614027589	1	0.4291255632837527	0.0	0	1	0.4291255632837527	0.0
55614027591	2	0.42917074753026174	1.0	1	1	0.42917074753026174	1.0
55614027592	3	0.010248406624010538	2.0	2	1	0.010248406624010538	2.0
55614027593	8	1.1134543433895665	3.0	3	5	0.2226908686779133	0.6
55614027594	1	0.42915647173255694	0.0	0	1	0.42915647173255694	0.0
55614027595	5	0.5132187657919699	3.0	3	2	0.12830469144799247	1.5
55614027596	9	0.15332173065630253	6.0	6	3	0.01703574785070028	2.0
55614027597	9	0.3535365948794936	6.0	6	3	0.07070731897589873	2.0
55614027598	1	0.0	1.0	1	0	0.0	inf
55614027599	15	0.30779660233994466	9.0	9	6	0.020519773489329644	1.5
55614027600	3	1.5550926770309181	1.0	1	2	0.7775463385154591	0.5
55614027601	2	0.7211341434422053	1.0	1	1	0.7211341434422053	1.0
55614027602	1	0.9791373694357932	0.0	0	1	0.9791373694357932	0.0
55614027603	4	2.325277653322825	0.0	0	4	0.5813194133307062	0.0
55614027604	2	0.6236345864464701	1.0	1	1	0.6236345864464701	1.0
55614027605	1	0.9791514095481585	0.0	0	1	0.9791514095481585	0.0
55614027606	5	0.1747390635016101	4.0	4	1	0.04368476587540252	4.0
55614027608	1	0.0	1.0	1	0	0.0	inf
55614027609	11	0.15446345777934511	8.0	8	3	0.014042132525395011	2.6666666666666665
55614027611	1	0.0	1.0	1	0	0.0	inf
55614027612	1	0.0	1.0	1	0	0.0	inf
55614027614	1	0.0	1.0	1	0	0.0	inf
55614027616	5	0.8153808050519624	4.0	4	1	0.1630761610103925	4.0
55614027618	2	0.050993082062907986	1.0	1	1	0.025496541031453993	1.0
55614027619	12	0.2131079970493542	8.0	8	4	0.01775899975411285	2.0
55614027620	8	5.682807599586231	1.0	1	7	0.8118296570837472	0.14285714285714285
55614027621	2	0.3025032779622053	1.0	1	1	0.3025032779622053	1.0
55614027622	1	0.0	1.0	1	0	0.0	inf
55614027626	6	0.1817038346375094	5.0	5	1	0.03634076692750188	5.0
55614027628	15	3.533561137803972	3.0	5	10	0.5047944482577102	0.5
55614027629	7	0.15958971492073717	4.0	4	3	0.022798530702962453	1.3333333333333333
55614027631	8	1.6476735483306626	4.0	4	4	0.3295347096661325	1.0
55614027633	4	0.16609220609794065	3.0	3	1	0.05536406869931355	3.0
55614027634	2	0.3785531122131234	1.0	1	1	0.1892765561065617	1.0
55614027635	1	0.0	1.0	1	0	0.0	inf
55614027637	1	0.5204612079270946	0.0	0	1	0.5204612079270946	0.0
55614027638	9	0.26772750209195995	4.0	4	5	0.029747500232439994	0.8
55614027639	16	1.39444443191197	10.0	10	6	0.139444443191197	1.6666666666666667
55614027641	13	0.21347236658416893	9.0	9	4	0.016420951275705302	2.25
55614027642	6	0.18194120344368603	5.0	5	1	0.03638824068873721	5.0
55614027644	2	0.05036750583329633	1.0	1	1	0.025183752916648164	1.0
55614027645	22	10.155204351478622	0.0	0	22	0.4616001977944828	0.0
55614027646	15	0.2680608958393019	10.0	10	5	0.017870726389286794	2.0
55614027647	5	2.4284420757993006	1.0	1	4	0.6071105189498252	0.25
55614027648	3	0.5095381015148608	0.5	1	2	0.5095381015148608	0.5
55614027649	2	0.8019864705167573	0.0	0	2	0.8019864705167573	0.0
55614027651	1	0.0	1.0	1	0	0.0	inf
55614027652	2	0.0	2.0	2	0	0.0	inf
55614027653	5	0.18204318785700646	4.0	4	1	0.045510796964251615	4.0
55614027654	2	0.05016673559340535	1.0	1	1	0.025083367796702675	1.0
55614027655	4	0.44226842156174734	1.5	2	2	0.22113421078087367	1.0
55614027656	8	0.10721309257649428	6.0	6	2	0.013401636572061785	3.0
55614027657	3	0.13689799777560177	2.0	2	1	0.06844899888780089	2.0
55614027658	7	0.5501264165656895	3.0	3	4	0.1100252833131379	0.75
55614027659	6	2.095827133826883	0.5	1	5	0.5239567834567207	0.2
55614027660	11	2.110047781162257	5.0	5	6	0.3516746301937095	0.8333333333333334
55614027661	1	0.0	1.0	1	0	0.0	inf
55614027662	3	0.4862438716340472	1.0	1	2	0.2431219358170236	0.5
55614027664	3	1.1071517133802304	1.0	1	2	0.5535758566901152	0.5
55614027665	1	0.0	1.0	1	0	0.0	inf
55614027666	2	0.90179429605789	0.0	0	2	0.450897148028945	0.0
55614027667	2	0.3952787916830145	0.0	0	2	0.19763939584150725	0.0
55614027668	11	0.3807520900996771	4.0	4	7	0.034613826372697915	0.5714285714285714
55614027669	15	3.0464726035826124	6.0	6	9	0.2538727169652177	0.6666666666666666
55614027671	6	0.9189863968145847	4.0	4	2	0.22974659920364618	2.0
55614027672	7	0.19859937589848722	3.0	3	4	0.039719875179697446	0.75
55614027673	9	1.3353489929182278	3.0	3	6	0.19076414184546112	0.5
55614027674	8	0.33105261752643056	3.0	3	5	0.055175436254405096	0.6
55614027675	9	0.30406428930415824	5.0	5	4	0.06081285786083165	1.25
55614027676	12	1.816746332239495	5.0	5	7	0.22709329152993687	0.7142857142857143
55614027677	8	1.5716389662881414	4.0	4	4	0.3143277932576283	1.0
55614027678	8	1.8287927823182932	4.0	4	4	0.4571981955795733	1.0
55614027679	3	0.40838144877596316	0.5	1	2	0.40838144877596316	0.5
55614027681	2	0.04555945756951783	1.0	1	1	0.04555945756951783	1.0
55614027682	1	0.7877562610904683	0.0	0	1	0.7877562610904683	0.0
55614027684	1	0.0	1.0	1	0	0.0	inf
55614027685	8	0.10885996072068133	6.0	6	2	0.013607495090085166	3.0
55614027686	4	0.0	4.0	4	0	0.0	inf
55614027687	3	0.34143139181250004	1.0	1	2	0.11381046393750001	0.5
55614027688	12	0.21898915433305643	8.0	8	4	0.01824909619442137	2.0
55614027689	9	0.8151489243472618	5.0	5	4	0.16302978486945235	1.25
55614027690	7	4.63973910036953	1.0	1	6	0.7732898500615883	0.16666666666666666
55614027691	15	2.462593992575979	8.0	8	7	0.3078242490719974	1.1428571428571428
55614027692	8	2.063341916432241	4.0	4	4	0.4126683832864482	1.0
55614027693	7	3.1331494224513916	2.0	2	5	0.6266298844902783	0.4
55614027694	1	0.47797559222422886	0.0	0	1	0.47797559222422886	0.0
55614027695	2	0.09813304551888602	1.0	1	1	0.09813304551888602	1.0
55614027696	5	1.332804702340022	1.0	1	4	0.666402351170011	0.25
55614027697	1	0.0	1.0	1	0	0.0	inf
55614027699	5	0.1823548985531176	4.0	4	1	0.0455887246382794	4.0
55614027700	8	1.3891480099554834	4.0	4	4	0.2778296019910967	1.0
55614027701	14	0.21948651773799852	10.0	10	4	0.015677608409857036	2.5
55614027702	14	3.7920786292082753	7.0	7	7	0.3447344208371159	1.0
55614027704	2	0.049243253094708436	1.0	1	1	0.024621626547354218	1.0
55614027705	11	0.3292563922156903	5.0	5	6	0.029932399292335484	0.8333333333333334
55614027706	8	0.8775379986213754	4.0	4	4	0.17550759972427507	1.0
55614027707	2	0.10729033002917078	1.0	1	1	0.10729033002917078	1.0
55614027708	16	4.661791335850026	8.0	8	8	0.5827239169812533	1.0
55614027709	2	0.5231874139180341	1.0	1	1	0.5231874139180341	1.0
55614027711	1	0.8104250830883413	0.0	0	1	0.8104250830883413	0.0
55614027712	1	0.0	1.0	1	0	0.0	inf
55614027713	1	0.38055155554512554	0.0	0	1	0.38055155554512554	0.0
55614027714	2	0.4324228348522187	1.0	1	1	0.4324228348522187	1.0
55614027715	1	0.772767447895106	0.0	0	1	0.772767447895106	0.0
55614027716	5	0.05477249849725344	4.0	4	1	0.010954499699450688	4.0
55614027717	5	0.18254348049402475	4.0	4	1	0.045635870123506186	4.0
55614027719	2	0.04899814034166361	1.0	1	1	0.024499070170831805	1.0
55614027720	15	0.2752792307311326	10.0	10	5	0.01835194871540884	2.0
55614027721	3	0.8921136554166534	1.0	1	2	0.4460568277083267	0.5
55614027722	1	0.6955890849001555	0.0	0	1	0.6955890849001555	0.0
55614027723	2	0.333417618899971	1.0	1	1	0.333417618899971	1.0
55614027724	1	0.6956282086665069	0.0	0	1	0.6956282086665069	0.0
55614027725	1	0.6956045727938918	0.0	0	1	0.6956045727938918	0.0
55614027727	2	0.04877427293850495	1.0	1	1	0.024387136469252474	1.0
55614027728	16	0.3309145395868376	10.0	10	6	0.02068215872417735	1.6666666666666667
55614027729	2	0.16180855771447442	1.0	1	1	0.16180855771447442	1.0
55614027730	1	0.6656583598919847	0.0	0	1	0.6656583598919847	0.0
55614027731	4	0.1437232768598713	1.0	2	2	0.1437232768598713	1.0
55614027732	2	0.6656817264099261	1.0	1	1	0.6656817264099261	1.0
55614027733	3	0.3763899248288344	2.0	2	1	0.3763899248288344	2.0
55614027734	2	0.6920362967543738	1.0	1	1	0.6920362967543738	1.0
55614027735	1	0.45435298532687046	0.0	0	1	0.45435298532687046	0.0
55614027738	2	0.048556533354172406	1.0	1	1	0.024278266677086203	1.0
55614027739	11	0.11024629555675561	9.0	9	2	0.0100223905051596	4.5
55614027740	6	0.1828282557227683	5.0	5	1	0.036565651144553665	5.0
55614027742	1	0.0	1.0	1	0	0.0	inf
55614027743	24	1.0190126689960686	5.0	5	19	0.04430489865200298	0.2631578947368421
55614027744	2	0.15070276149482012	1.0	1	1	0.07535138074741006	1.0
55614027745	4	0.0	4.0	4	0	0.0	inf
55614027746	23	1.0035657845087866	3.0	3	20	0.050178289225439335	0.15
55614027747	2	0.32995338110316025	0.0	0	2	0.16497669055158012	0.0
55614027748	1	0.0	1.0	1	0	0.0	inf
55614027749	1	0.7644407185211001	0.0	0	1	0.7644407185211001	0.0
55614027751	4	1.7342897287285313	1.0	1	3	0.5780965762428437	0.3333333333333333
55614027753	1	0.09152654976830953	0.0	0	1	0.09152654976830953	0.0
55614027756	1	0.4620540374632621	0.0	0	1	0.4620540374632621	0.0
55614027757	4	0.0	4.0	4	0	0.0	inf
55614027758	1	0.0	1.0	1	0	0.0	inf
55614027759	1	0.5311497737572253	0.0	0	1	0.5311497737572253	0.0
55614027760	5	0.7434220642621667	4.0	4	1	0.14868441285243333	4.0
55614027761	5	0.23477370857312493	4.0	4	1	0.046954741714624985	4.0
55614027762	13	0.4093149310669203	8.0	8	5	0.045479436785213365	1.6
55614027763	14	1.6648960188268145	9.0	9	5	0.16648960188268144	1.8
55614027764	4	0.0	4.0	4	0	0.0	inf
55614027765	15	0.21922921668596987	10.0	10	5	0.021922921668596988	2.0
55614027766	9	3.7692093736638537	5.0	5	4	0.41880104151820596	1.25
55614027767	5	0.0	5.0	5	0	0.0	inf
55614027768	4	0.0	4.0	4	0	0.0	inf
55614027769	5	0.20581771079031794	4.0	4	1	0.04116354215806359	4.0
55614027770	4	0.0	4.0	4	0	0.0	inf
55614027772	2	0.4847292566346349	0.0	0	2	0.24236462831731745	0.0
55614027773	7	0.5587733413080274	3.0	3	4	0.11175466826160547	0.75
55614027774	5	3.933947870510569	0.0	0	5	0.7867895741021138	0.0
55614027777	1	0.22506838830991288	0.0	0	1	0.22506838830991288	0.0
55614027778	3	1.9946788310828694	0.0	0	3	0.6648929436942898	0.0
55614027779	2	1.1278614178284578	0.0	0	2	0.5639307089142289	0.0
55614027780	5	3.2626850142540813	0.0	0	5	0.6525370028508163	0.0
55614027783	1	0.36957488122216453	0.0	0	1	0.36957488122216453	0.0
55614027784	2	1.8093139950594292	0.0	0	2	0.9046569975297146	0.0
55614027786	1	0.9098693134893461	0.0	0	1	0.9098693134893461	0.0
55614027788	2	0.1460737667503675	0.0	0	2	0.07303688337518376	0.0
55614027790	4	2.0067949093448125	0.0	0	4	0.5016987273362031	0.0
55614027792	2	0.6787024996820773	0.0	0	2	0.6787024996820773	0.0
55614027795	3	0.7414742596088155	0.0	0	3	0.37073712980440776	0.0
55614027799	3	1.0734524471326639	1.0	1	2	0.5367262235663319	0.5
55614027803	4	0.592355438272545	2.0	2	2	0.2961777191362725	1.0
55614027804	2	1.010034539013112	0.0	0	2	0.505017269506556	0.0
55614027806	7	1.3587196858570312	1.0	2	5	0.3396799214642578	0.4
55614027808	2	1.9648160844604676	0.0	0	2	0.9824080422302338	0.0
55614027812	1	0.7889611182151536	0.0	0	1	0.7889611182151536	0.0
55614027813	2	0.9956097881737609	0.0	0	2	0.49780489408688045	0.0
55614027817	1	0.18400866891081757	0.0	0	1	0.18400866891081757	0.0
56238806952	3	1.050732515085461	1.0	1	2	0.5253662575427305	0.5
56238806953	2	1.050740393709666	0.0	0	2	0.525370196854833	0.0
56238806954	8	3.801771963188509	1.0	1	7	0.5431102804555012	0.14285714285714285
56238806955	7	2.6273042408512928	2.0	2	5	0.5254608481702585	0.4
56238806956	3	1.576376645643422	0.0	0	3	0.5254588818811406	0.0
57126274055	3	0.12872160197884105	0.5	1	2	0.12872160197884105	0.5
57126274056	2	0.8525852173374041	0.0	0	2	0.8525852173374041	0.0
57126274057	4	0.5264395012399911	0.3333333333333333	1	3	0.5264395012399911	0.3333333333333333
57126274058	3	1.2128720760245486	0.0	0	3	0.6064360380122743	0.0
57126274059	11	0.4107122084366126	5.0	5	6	0.06845203473943544	0.8333333333333334
57126274060	2	0.07646692996310481	0.0	0	2	0.038233464981552404	0.0
57126274061	5	0.23092122968354495	2.0	2	3	0.07697374322784832	0.6666666666666666
57126274062	22	0.598667361018123	8.0	8	14	0.04276195435843736	0.5714285714285714
57126274063	12	1.1606251142863464	3.0	5	7	0.23212502285726927	0.7142857142857143
57126274064	16	1.3367811517181616	8.0	8	8	0.1670976439647702	1.0
57126274065	15	4.927532448231632	5.5	6	9	0.615941556028954	0.6666666666666666
57126274066	11	2.7767193523286067	2.5	3	8	0.4627865587214344	0.375
57126274067	12	3.0791746851588973	2.5	4	8	0.5131957808598162	0.5
57126274068	11	7.054604858882225	0.0	0	11	0.8818256073602782	0.0
57126274069	2	0.49296087013949913	0.0	0	2	0.49296087013949913	0.0
57126274070	7	2.157242457286325	0.5	1	6	0.5393106143215812	0.16666666666666666
57126274071	1	0.03844088491494975	0.0	0	1	0.03844088491494975	0.0
57609898725	1	0.690420000365649	0.0	0	1	0.690420000365649	0.0
57609898726	34	19.45335920125835	6.0	6	28	0.6947628286163697	0.21428571428571427
57609898727	1	0.6907896896552688	0.0	0	1	0.6907896896552688	0.0
57609898728	1	0.6908009015435606	0.0	0	1	0.6908009015435606	0.0
57609898729	1	0.6908241670534992	0.0	0	1	0.6908241670534992	0.0
57609898730	2	0.6908870613698025	1.0	1	1	0.6908870613698025	1.0
57609898731	5	3.636593879514355	0.0	0	5	0.727318775902871	0.0
57609898732	2	0.69113099569615	1.0	1	1	0.69113099569615	1.0
57609898733	5	3.455908676914018	0.0	0	5	0.6911817353828036	0.0
57609898734	2	1.3823455923491421	0.0	0	2	0.6911727961745711	0.0
57609898735	2	1.382407779609427	0.0	0	2	0.6912038898047135	0.0
57609898736	46	26.565184251896177	8.0	8	38	0.699083796102531	0.21052631578947367
57609898737	4	2.8115711535554966	0.0	0	4	0.7028927883888741	0.0
57609898738	5	3.4571686844081384	0.0	0	5	0.6914337368816277	0.0
57609898739	1	0.6914623692834395	0.0	0	1	0.6914623692834395	0.0
57609898740	5	2.7822874184734947	1.0	1	4	0.6955718546183737	0.25
57609898741	29	17.452571675531185	4.0	4	25	0.6981028670212475	0.16
57609898742	3	1.3832586373542342	1.0	1	2	0.6916293186771171	0.5
57609898743	10	4.350389724226941	1.0	2	8	0.7250649540378236	0.25
57609898744	3	1.3834025737579796	1.0	1	2	0.6917012868789898	0.5
57609898745	6	2.7830935970118063	2.0	2	4	0.6957733992529516	0.5
57609898746	2	0.6918765020942158	1.0	1	1	0.6918765020942158	1.0
57609898747	3	1.6176181794472484	1.0	1	2	0.8088090897236242	0.5
57609898748	1	0.692075386851391	0.0	0	1	0.692075386851391	0.0
57609898749	37	21.61593366898742	6.0	6	31	0.6972881828705619	0.1935483870967742
57609898750	2	0.6921148473110845	1.0	1	1	0.6921148473110845	1.0
57609898751	2	1.3843839675115166	0.0	0	2	0.6921919837557583	0.0
57609898752	3	1.3845863202101154	1.0	1	2	0.6922931601050577	0.5
57609898753	1	0.6923086816681283	0.0	0	1	0.6923086816681283	0.0
57609898754	4	2.957451523650165	0.0	0	4	0.7393628809125412	0.0
57609898755	2	1.3846730860843732	0.0	0	2	0.6923365430421866	0.0
57609898756	37	22.343430508531192	5.0	5	32	0.6982322033915997	0.15625
57609898757	3	1.3850011264075759	1.0	1	2	0.6925005632037879	0.5
57609898758	5	2.0926924514733143	2.0	2	3	0.6975641504911048	0.6666666666666666
57609898759	1	0.6925623801013966	0.0	0	1	0.6925623801013966	0.0
57609898760	1	0.6927586723198377	0.0	0	1	0.6927586723198377	0.0
57609898761	1	0.6927698842081295	0.0	0	1	0.6927698842081295	0.0
57609898762	1	0.6927868872219052	0.0	0	1	0.6927868872219052	0.0
57609898763	2	0.692798099110197	1.0	1	1	0.692798099110197	1.0
57609898764	1	0.6928147317612964	0.0	0	1	0.6928147317612964	0.0
57609898765	1	0.6928259436495882	0.0	0	1	0.6928259436495882	0.0
57609898766	4	2.786584197897303	0.0	0	4	0.6966460494743257	0.0
57609898767	35	22.42345191010678	3.0	3	32	0.7007328721908369	0.09375
57609898768	2	1.3857367340213842	0.0	0	2	0.6928683670106921	0.0
57609898769	4	2.959294515666122	0.0	0	4	0.7398236289165305	0.0
57609898770	1	0.6929393082978714	0.0	0	1	0.6929393082978714	0.0
57609898771	2	1.385910164761897	0.0	0	2	0.6929550823809485	0.0
57609898772	1	0.6930955676779375	0.0	0	1	0.6930955676779375	0.0
57609898773	1	0.6931067795662292	0.0	0	1	0.6931067795662292	0.0
57609898774	3	2.267133878060513	0.0	0	3	0.7557112926868377	0.0
57609898775	2	1.3864081005455207	0.0	0	2	0.6932040502727603	0.0
57609898776	2	1.4228010145378462	0.0	0	2	0.7114005072689231	0.0
57609898777	1	0.6933553265913635	0.0	0	1	0.6933553265913635	0.0
57609898778	4	2.09461621622204	1.0	1	3	0.6982054054073467	0.3333333333333333
57609898779	27	14.623782125468974	6.0	6	21	0.6963705774032845	0.2857142857142857
57609898780	3	1.4227523960192476	1.0	1	2	0.7113761980096238	0.5
57609898781	5	3.6546030340043103	0.0	0	5	0.730920606800862	0.0
57609898782	2	1.3869584594825084	0.0	0	2	0.6934792297412542	0.0
57609898783	1	0.6935568712259412	0.0	0	1	0.6935568712259412	0.0
57609898784	3	2.360823312189104	0.0	0	3	0.7869411040630346	0.0
57609898785	1	0.693588991770777	0.0	0	1	0.693588991770777	0.0
57609898786	1	0.6935892611254507	0.0	0	1	0.6935892611254507	0.0
57609898787	3	1.3872822574696007	1.0	1	2	0.6936411287348003	0.5
57609898788	5	3.655644089818067	0.0	0	5	0.7311288179636134	0.0
57609898789	24	14.007941013481304	4.0	4	20	0.7003970506740652	0.2
57609898790	2	1.3876798923066143	0.0	0	2	0.6938399461533071	0.0
57609898791	1	0.6938514442309397	0.0	0	1	0.6938514442309397	0.0
57609898792	2	1.38773416727336	0.0	0	2	0.69386708363668	0.0
57609898793	2	1.4222854360230968	0.0	0	2	0.7111427180115484	0.0
57609898794	5	3.656788342141175	0.0	0	5	0.731357668428235	0.0
57609898795	2	1.3878847702052788	0.0	0	2	0.6939423851026394	0.0
57609898796	2	1.4221528125156457	0.0	0	2	0.7110764062578229	0.0
57609898797	24	14.735217520902006	3.0	3	21	0.7016770248048575	0.14285714285714285
57609898798	5	3.4711060379654732	0.0	0	5	0.6942212075930947	0.0
57609898799	3	2.0826634005616786	0.0	0	3	0.6942211335205596	0.0
57609898800	3	1.4222370868591718	1.0	1	2	0.7111185434295859	0.5
57609898801	21	11.866188975131392	4.0	4	17	0.6980111161841995	0.23529411764705882
57609898802	5	3.659094354841181	0.0	0	5	0.7318188709682362	0.0
57609898803	2	1.388922762109622	0.0	0	2	0.694461381054811	0.0
57609898804	3	1.422199915914205	1.0	1	2	0.7110999579571025	0.5
57609898805	16	9.98206367227994	2.0	2	14	0.7130045480199957	0.14285714285714285
57609898806	15	8.396345570868109	3.0	3	12	0.6996954642390091	0.25
57609898807	2	1.3892877040231184	0.0	0	2	0.6946438520115592	0.0
57609898808	3	1.3893623152677266	1.0	1	2	0.6946811576338633	0.5
57609898809	28	14.748691651759291	7.0	7	21	0.7023186500837758	0.3333333333333333
57609898810	5	3.6609645180098447	0.0	0	5	0.732192903601969	0.0
57609898811	2	1.3897748992891292	0.0	0	2	0.6948874496445646	0.0
57609898812	4	1.3898532141605004	2.0	2	2	0.6949266070802502	1.0
57609898813	25	14.753740031730654	4.0	4	21	0.7025590491300312	0.19047619047619047
57609898814	3	2.0857171081664734	0.0	0	3	0.6952390360554911	0.0
57609898815	5	3.4757884996126513	0.0	0	5	0.6951576999225303	0.0
57609898816	2	1.3902998042094548	0.0	0	2	0.6951499021047274	0.0
57609898817	2	1.3903930682652148	0.0	0	2	0.6951965341326074	0.0
57609898818	20	11.25694823107547	4.0	4	16	0.7035592644422168	0.25
57609898819	4	2.086565609057886	1.0	1	3	0.6955218696859621	0.3333333333333333
57609898820	7	4.263416177515774	1.0	1	6	0.7105693629192956	0.16666666666666666
57609898821	5	3.477257560002878	0.0	0	5	0.6954515120005756	0.0
57609898822	22	13.312851648839484	3.0	3	19	0.7006764025704991	0.15789473684210525
57609898823	3	1.391379748104223	1.0	1	2	0.6956898740521115	0.5
57609898824	5	3.673639675566336	0.0	0	5	0.7347279351132672	0.0
57609898825	3	1.4222415312112877	1.0	1	2	0.7111207656056439	0.5
57609898826	25	14.769298126028831	4.0	4	21	0.7032999107632777	0.19047619047619047
57609898827	1	0.6958395510773395	0.0	0	1	0.6958395510773395	0.0
57609898828	1	0.6958429180107605	0.0	0	1	0.6958429180107605	0.0
57609898829	2	0.6958530188110233	1.0	1	1	0.6958530188110233	1.0
57609898830	1	0.695853288165697	0.0	0	1	0.695853288165697	0.0
57609898831	1	0.695854735947068	0.0	0	1	0.695854735947068	0.0
57609898832	1	0.6958583722351627	0.0	0	1	0.6958583722351627	0.0
57609898833	4	1.3918731048583939	2.0	2	2	0.6959365524291969	1.0
57609898834	5	3.4797988203410055	0.0	0	5	0.6959597640682011	0.0
57609898835	20	11.95522079558145	3.0	3	17	0.7032482820930265	0.17647058823529413
57609898836	3	2.2010752840589136	0.0	0	3	0.7336917613529712	0.0
57609898837	2	0.6961271208608225	1.0	1	1	0.6961271208608225	1.0
57609898838	4	2.784780262309029	0.0	0	4	0.6961950655772573	0.0
57609898839	11	6.395252664279668	2.0	2	9	0.7105836293644076	0.2222222222222222
57609898840	6	4.372097690765145	0.0	0	6	0.7286829484608575	0.0
57609898841	22	11.26669001522763	6.0	6	16	0.7041681259517268	0.375
57609898842	5	3.676762876676939	0.0	0	5	0.7353525753353878	0.0
57609898843	3	2.0892350148820142	0.0	0	3	0.6964116716273381	0.0
57609898844	26	14.784163608452982	5.0	5	21	0.7040077908787135	0.23809523809523808
57609898845	1	0.6965646201895401	0.0	0	1	0.6965646201895401	0.0
57609898846	1	0.6965758320778319	0.0	0	1	0.6965758320778319	0.0
57609898847	2	1.3932084643224751	0.0	0	2	0.6966042321612376	0.0
57609898848	1	0.6966070772199783	0.0	0	1	0.6966070772199783	0.0
57609898849	1	0.696627110473833	0.0	0	1	0.696627110473833	0.0
57609898850	1	0.6966383223621246	0.0	0	1	0.6966383223621246	0.0
57609898851	5	3.67814806675565	0.0	0	5	0.73562961335113	0.0
57609898852	3	2.0901871836534576	0.0	0	3	0.6967290612178192	0.0
57609898853	21	13.338756868249572	2.0	2	19	0.7020398351710301	0.10526315789473684
57977358328	1	0.810477135879029	0.0	0	1	0.810477135879029	0.0
57977358329	8	6.639937177062685	0.0	0	8	0.8299921471328356	0.0
57977358330	5	4.052835838393525	0.0	0	5	0.8105671676787051	0.0
58297939028	4	2.528088423213565	0.0	0	4	0.6320221058033912	0.0
58297939029	1	0.5641423206797354	0.0	0	1	0.5641423206797354	0.0
58297939030	2	1.5266896307238331	0.0	0	2	0.7633448153619166	0.0
58297939031	4	2.2572419960164467	0.0	0	4	0.5643104990041117	0.0
58297939032	1	0.5643033947745935	0.0	0	1	0.5643033947745935	0.0
58297939033	2	0.5643378048341555	1.0	1	1	0.5643378048341555	1.0
58297939034	2	1.128703285861031	0.0	0	2	0.5643516429305155	0.0
58297939035	31	15.294679837795965	4.0	4	27	0.5664696236220728	0.14814814814814814
58297939036	14	6.785614925104083	2.0	2	12	0.5654679104253403	0.16666666666666666
58691864694	5	0.08477594926731656	1.5	3	2	0.08477594926731656	1.5
58691864695	6	0.09815156365270122	4.0	4	2	0.024537890913175306	2.0
58775304614	2	0.2729095156508028	1.0	1	1	0.2729095156508028	1.0
58775304615	6	1.1563299173212462	2.0	2	4	0.28908247933031156	0.5
58775304616	6	0.8519596074384583	3.0	3	3	0.28398653581281946	1.0
60416575598	1	0.8521095706530272	0.0	0	1	0.8521095706530272	0.0
60416575599	2	1.7043123380231462	0.0	0	2	0.8521561690115731	0.0
60416575600	1	0.8521893333057694	0.0	0	1	0.8521893333057694	0.0
60416575601	21	18.197091023395238	0.0	0	21	0.8665281439712018	0.0
60416575602	1	0.8523182195171232	0.0	0	1	0.8523182195171232	0.0
60416575603	1	0.852329431405415	0.0	0	1	0.852329431405415	0.0
60416575604	5	4.262135227695775	0.0	0	5	0.8524270455391549	0.0
60416575605	3	2.5572228011290132	0.0	0	3	0.8524076003763378	0.0
60416575606	14	11.995959040177514	0.0	0	14	0.8568542171555367	0.0
60416575607	6	5.35409574151271	0.0	0	6	0.8923492902521183	0.0
60416575608	4	3.410715541700699	0.0	0	4	0.8526788854251748	0.0
60416575609	3	2.5580869919301676	0.0	0	3	0.8526956639767226	0.0
60416575610	2	1.7054515736154572	0.0	0	2	0.8527257868077286	0.0
60416575611	22	19.18023396618326	0.0	0	22	0.8718288166446936	0.0
60416575612	4	3.411430173319295	0.0	0	4	0.8528575433298238	0.0
60416575613	3	2.5585634466785656	0.0	0	3	0.8528544822261885	0.0
60416575614	2	1.765853685800534	0.0	0	2	0.882926842900267	0.0
60416575615	23	20.035228392730023	0.0	0	23	0.8710968866404357	0.0
60416575616	1	0.8530221442874403	0.0	0	1	0.8530221442874403	0.0
60416575617	5	4.2655888596523095	0.0	0	5	0.8531177719304619	0.0
60416575618	3	2.559373160496969	0.0	0	3	0.853124386832323	0.0
60416575619	2	1.76582829912254	0.0	0	2	0.88291414956127	0.0
60416575620	17	14.564134206370188	0.0	0	17	0.8567137768453051	0.0
60416575621	4	3.4131039432615156	0.0	0	4	0.8532759858153789	0.0
60416575622	2	1.706632087811509	0.0	0	2	0.8533160439057546	0.0
60416575623	21	17.370618967276002	1.0	1	20	0.8685309483638001	0.05
60416575624	1	0.8534923028703411	0.0	0	1	0.8534923028703411	0.0
60416575625	2	1.7071362524219613	0.0	0	2	0.8535681262109807	0.0
60416575626	4	3.4142515288487103	0.0	0	4	0.8535628822121776	0.0
60416575627	2	1.707217328178738	0.0	0	2	0.853608664089369	0.0
60416575628	21	18.28709713336932	0.0	0	21	0.8708141492080628	0.0
60416575629	2	1.7075569844222427	0.0	0	2	0.8537784922111213	0.0
60416575630	4	3.415187805694407	0.0	0	4	0.8537969514236018	0.0
60416575631	2	1.7658547295498945	0.0	0	2	0.8829273647749473	0.0
60416575632	17	14.758899150142236	0.0	0	17	0.868170538243661	0.0
60416575633	1	0.8539600035918445	0.0	0	1	0.8539600035918445	0.0
60416575634	2	1.7080416208188538	0.0	0	2	0.8540208104094269	0.0
60416575635	4	3.5330455592892225	0.0	0	4	0.8832613898223056	0.0
60416575636	1	0.8539975448994881	0.0	0	1	0.8539975448994881	0.0
60416575637	3	2.562148119683844	0.0	0	3	0.8540493732279479	0.0
60416575638	20	17.379695916754862	0.0	0	20	0.8689847958377431	0.0
60416575639	4	3.4167813752825404	0.0	0	4	0.8541953438206351	0.0
60416575640	3	2.5626459544594646	0.0	0	3	0.8542153181531549	0.0
60416575641	22	19.213320080185547	0.0	0	22	0.8733327309175248	0.0
60416575642	3	2.563297961116431	0.0	0	3	0.8544326537054769	0.0
60416575643	2	1.7089295485006255	0.0	0	2	0.8544647742503128	0.0
60416575644	16	13.790695829652293	0.0	0	16	0.8619184893532683	0.0
60416575645	10	8.965730711924268	0.0	0	10	0.8965730711924268	0.0
60416575646	4	3.4183742378146555	0.0	0	4	0.8545935594536639	0.0
60416575647	3	2.563829700911601	0.0	0	3	0.854609900303867	0.0
60416575648	2	1.7092812583657775	0.0	0	2	0.8546406291828887	0.0
60416575649	1	0.8547011329764631	0.0	0	1	0.8547011329764631	0.0
60416575650	2	1.7094335447644067	0.0	0	2	0.8547167723822033	0.0
60416575651	16	13.793781758809928	0.0	0	16	0.8621113599256205	0.0
60416575652	5	4.273988954505558	0.0	0	5	0.8547977909011116	0.0
60416575653	3	2.564376625576499	0.0	0	3	0.8547922085254996	0.0
60416575654	2	1.7657576271900344	0.0	0	2	0.8828788135950172	0.0
60416575655	1	0.8549043610777514	0.0	0	1	0.8549043610777514	0.0
60416575656	2	1.7528166502399598	0.0	0	2	0.8764083251199799	0.0
60416575657	1	0.8549356398892319	0.0	0	1	0.8549356398892319	0.0
60416575658	2	1.7099025585899446	0.0	0	2	0.8549512792949723	0.0
60416575659	1	0.8549641578153073	0.0	0	1	0.8549641578153073	0.0
60416575660	1	0.8549675247487283	0.0	0	1	0.8549675247487283	0.0
60416575661	1	0.8549680971274098	0.0	0	1	0.8549680971274098	0.0
60416575662	1	0.8549759420822807	0.0	0	1	0.8549759420822807	0.0
60416575663	1	0.8550424390173443	0.0	0	1	0.8550424390173443	0.0
60416575664	1	0.8550536509056361	0.0	0	1	0.8550536509056361	0.0
60416575665	2	1.7101263923237688	0.0	0	2	0.8550631961618844	0.0
60416575666	1	0.8550727077487986	0.0	0	1	0.8550727077487986	0.0
60416575667	1	0.8551150301018999	0.0	0	1	0.8551150301018999	0.0
60416575668	2	1.710331068206428	0.0	0	2	0.855165534103214	0.0
60416575669	2	1.710370259311448	0.0	0	2	0.855185129655724	0.0
60416575670	2	1.7118744368172552	0.0	0	2	0.8559372184086276	0.0
60416575671	2	1.7104906945199152	0.0	0	2	0.8552453472599576	0.0
60416575672	2	1.7131936013315818	0.0	0	2	0.8565968006657909	0.0
60416575673	2	1.7131983823770396	0.0	0	2	0.8565991911885198	0.0
60416575674	1	0.8566308235280096	0.0	0	1	0.8566308235280096	0.0
60416575675	1	0.8567189361756357	0.0	0	1	0.8567189361756357	0.0
60416575676	1	0.8567770494464811	0.0	0	1	0.8567770494464811	0.0
60416575677	1	0.8568002812870857	0.0	0	1	0.8568002812870857	0.0
60416575678	1	0.8568145234154563	0.0	0	1	0.8568145234154563	0.0
60416575679	1	0.8568279238104717	0.0	0	1	0.8568279238104717	0.0
60416575680	2	1.7137115366997258	0.0	0	2	0.8568557683498629	0.0
60416575681	1	0.8568873838546855	0.0	0	1	0.8568873838546855	0.0
60416575682	1	0.856937113461313	0.0	0	1	0.856937113461313	0.0
60416575683	1	0.8569487293816151	0.0	0	1	0.8569487293816151	0.0
60416575684	1	0.8569599412699069	0.0	0	1	0.8569599412699069	0.0
60416575685	2	1.8233612116542899	0.0	0	2	0.9116806058271449	0.0
60416575686	2	1.7140931112643214	0.0	0	2	0.8570465556321607	0.0
60416575687	1	0.8570337444504941	0.0	0	1	0.8570337444504941	0.0
60416575688	2	1.7141101816167659	0.0	0	2	0.8570550908083829	0.0
60416575689	1	0.857083709742461	0.0	0	1	0.857083709742461	0.0
60416575690	1	0.8570919587293422	0.0	0	1	0.8570919587293422	0.0
60416575691	1	0.8571147865379363	0.0	0	1	0.8571147865379363	0.0
60416575692	2	1.7142578553166083	0.0	0	2	0.8571289276583042	0.0
60416575693	2	1.7143764387116942	0.0	0	2	0.8571882193558471	0.0
60416575694	1	0.857261517496421	0.0	0	1	0.857261517496421	0.0
60416575695	1	0.85727646668081	0.0	0	1	0.85727646668081	0.0
60416575696	1	0.8572880826011123	0.0	0	1	0.8572880826011123	0.0
60416575697	1	0.8573010452947829	0.0	0	1	0.8573010452947829	0.0
60416575698	1	0.857327745076811	0.0	0	1	0.857327745076811	0.0
60416575699	1	0.8573359940636923	0.0	0	1	0.8573359940636923	0.0
60416575700	2	1.7147534005775031	0.0	0	2	0.8573767002887516	0.0
60416575701	1	0.8574109420016426	0.0	0	1	0.8574109420016426	0.0
60416575702	1	0.8574225579219449	0.0	0	1	0.8574225579219449	0.0
60416575703	1	0.8574337698102366	0.0	0	1	0.8574337698102366	0.0
60416575704	2	1.7149216125712137	0.0	0	2	0.8574608062856068	0.0
60416575705	4	3.6386919167369487	0.0	0	4	0.9096729791842372	0.0
60416575706	1	0.8575157546390366	0.0	0	1	0.8575157546390366	0.0
60416575707	1	0.8575346094661939	0.0	0	1	0.8575346094661939	0.0
60416575708	2	1.7151460186837197	0.0	0	2	0.8575730093418599	0.0
60416575709	1	0.8575666290030272	0.0	0	1	0.8575666290030272	0.0
60416575710	1	0.8576012747479287	0.0	0	1	0.8576012747479287	0.0
60416575711	1	0.8576095237348099	0.0	0	1	0.8576095237348099	0.0
60416575712	2	1.7152515047077979	0.0	0	2	0.8576257523538989	0.0
60416575713	1	0.8576601287441268	0.0	0	1	0.8576601287441268	0.0
60416575714	1	0.857671744664429	0.0	0	1	0.857671744664429	0.0
60416575715	1	0.8576860204621338	0.0	0	1	0.8576860204621338	0.0
60416575716	2	1.715491836415385	0.0	0	2	0.8577459182076925	0.0
60416575717	1	0.8577134273001803	0.0	0	1	0.8577134273001803	0.0
60416575718	1	0.8577246391884721	0.0	0	1	0.8577246391884721	0.0
60416575719	1	0.8577802609285861	0.0	0	1	0.8577802609285861	0.0
60416575720	1	0.8578174655428875	0.0	0	1	0.8578174655428875	0.0
60416575721	1	0.8591964941334383	0.0	0	1	0.8591964941334383	0.0
60416575722	1	0.8592519138575472	0.0	0	1	0.8592519138575472	0.0
60416575723	14	12.202319702651296	0.0	0	14	0.8715942644750926	0.0
60416575724	1	0.8593511710547966	0.0	0	1	0.8593511710547966	0.0
60416575725	5	4.2969514067670715	0.0	0	5	0.8593902813534143	0.0
60416575726	2	1.7187643946925413	0.0	0	2	0.8593821973462706	0.0
60416575727	2	1.7188203531259973	0.0	0	2	0.8594101765629987	0.0
60416575728	2	1.7188442920226203	0.0	0	2	0.8594221460113102	0.0
60416575729	31	26.80977169598868	0.0	0	31	0.8648313450318929	0.0
60416575730	2	1.7327300978292808	0.0	0	2	0.8663650489146404	0.0
60416575731	4	3.438489173474073	0.0	0	4	0.8596222933685183	0.0
60416575732	1	0.8596744303325415	0.0	0	1	0.8596744303325415	0.0
60416575733	1	0.8597297153793135	0.0	0	1	0.8597297153793135	0.0
60416575734	2	1.7195559944091396	0.0	0	2	0.8597779972045698	0.0
60416575735	4	3.439304981441968	0.0	0	4	0.859826245360492	0.0
60416575736	2	1.7196399320593239	0.0	0	2	0.8598199660296619	0.0
60416575737	1	0.8598446961556387	0.0	0	1	0.8598446961556387	0.0
60416575738	34	29.523235965097967	0.0	0	34	0.8683304695617049	0.0
60416575739	5	4.300098445766295	0.0	0	5	0.860019689153259	0.0
60416575740	2	1.7199956149059126	0.0	0	2	0.8599978074529563	0.0
60416575741	1	0.8600297091471197	0.0	0	1	0.8600297091471197	0.0
60416575742	3	2.5891210273510477	0.0	0	3	0.8630403424503492	0.0
60416575743	2	1.7205396776774031	0.0	0	2	0.8602698388387016	0.0
60416575744	4	3.4502916555571894	0.0	0	4	0.8625729138892974	0.0
60416575745	1	0.8603845502603532	0.0	0	1	0.8603845502603532	0.0
60416575746	2	1.7209000068921128	0.0	0	2	0.8604500034460564	0.0
60416575747	28	24.301132666705207	0.0	0	28	0.8678975952394717	0.0
60416575748	2	1.7212172393590341	0.0	0	2	0.8606086196795171	0.0
60416575749	1	0.8606693254890967	0.0	0	1	0.8606693254890967	0.0
60416575750	5	4.3039587359414115	0.0	0	5	0.8607917471882823	0.0
60416575751	1	0.8607695254277041	0.0	0	1	0.8607695254277041	0.0
60416575752	2	1.7216170290334372	0.0	0	2	0.8608085145167186	0.0
60416575753	1	0.8608364263947783	0.0	0	1	0.8608364263947783	0.0
60416575754	1	0.8608660890782168	0.0	0	1	0.8608660890782168	0.0
60416575755	1	0.8608678062142615	0.0	0	1	0.8608678062142615	0.0
60416575756	32	27.769915823634236	0.0	0	32	0.8678098694885699	0.0
60416575757	2	1.7220279295881293	0.0	0	2	0.8610139647940647	0.0
60416575758	4	3.444267773965773	0.0	0	4	0.8610669434914433	0.0
60416575759	2	1.722154357938086	0.0	0	2	0.861077178969043	0.0
60416575760	4	3.453230449724327	0.0	0	4	0.8633076124310818	0.0
60416575761	25	21.85149177203962	0.0	0	25	0.8740596708815848	0.0
60416575762	1	0.8612314350237236	0.0	0	1	0.8612314350237236	0.0
60416575763	4	3.445059239005035	0.0	0	4	0.8612648097512587	0.0
60416575764	1	0.8612988073614767	0.0	0	1	0.8612988073614767	0.0
60416575765	4	3.453870806791657	0.0	0	4	0.8634677016979142	0.0
60416575766	1	0.8614502183574166	0.0	0	1	0.8614502183574166	0.0
60416575767	4	3.445920466904779	0.0	0	4	0.8614801167261947	0.0
60416575768	30	25.997557592827118	0.0	0	30	0.8665852530942373	0.0
60416575769	5	4.308238849044786	0.0	0	5	0.8616477698089572	0.0
60416575770	1	0.8616686986671017	0.0	0	1	0.8616686986671017	0.0
60416575771	1	0.8618193689376891	0.0	0	1	0.8618193689376891	0.0
60416575772	4	3.447400267812618	0.0	0	4	0.8618500669531545	0.0
60416575773	2	1.723700756788992	0.0	0	2	0.861850378394496	0.0
60416575774	2	1.7237638531213004	0.0	0	2	0.8618819265606502	0.0
60416575775	3	2.5865062668563414	0.0	0	3	0.8621687556187805	0.0
60416575776	2	1.7244670708355991	0.0	0	2	0.8622335354177996	0.0
60416575777	22	19.30543725741455	0.0	0	22	0.877519875337025	0.0
60416575778	1	0.862408817971694	0.0	0	1	0.862408817971694	0.0
60416575779	1	0.8624166629265648	0.0	0	1	0.8624166629265648	0.0
60416575780	2	1.7248542345096736	0.0	0	2	0.8624271172548368	0.0
60416575781	4	3.4499762412343147	0.0	0	4	0.8624940603085787	0.0
60416575782	3	2.587487963633887	0.0	0	3	0.8624959878779622	0.0
60416575783	21	18.39142358557737	0.0	0	21	0.8757820755036844	0.0
60416575784	1	0.862685781914901	0.0	0	1	0.862685781914901	0.0
60416575785	2	1.7255588326666749	0.0	0	2	0.8627794163333374	0.0
60416575786	19	16.56114130558298	0.0	0	19	0.8716390160833146	0.0
60416575787	1	0.8628840606240604	0.0	0	1	0.8628840606240604	0.0
60416575788	2	1.725936737273842	0.0	0	2	0.862968368636921	0.0
60416575789	2	1.7817304603470023	0.0	0	2	0.8908652301735012	0.0
60416575790	12	10.51988616936813	0.0	0	12	0.8766571807806774	0.0
60416575791	1	0.8630687369221993	0.0	0	1	0.8630687369221993	0.0
60416575792	1	0.863079948810491	0.0	0	1	0.863079948810491	0.0
60416575793	10	8.796579613144065	0.0	0	10	0.8796579613144064	0.0
60416575794	4	3.45266305410423	0.0	0	4	0.8631657635260575	0.0
60416575795	2	1.72632097171584	0.0	0	2	0.86316048585792	0.0
60416575796	2	1.72639295675238	0.0	0	2	0.86319647837619	0.0
60416575797	20	17.541226601454103	0.0	0	20	0.8770613300727051	0.0
60416575798	2	1.8060882034874899	0.0	0	2	0.9030441017437449	0.0
60416575799	2	1.7697604059875256	0.0	0	2	0.8848802029937628	0.0
60416575800	3	2.590523590806211	0.0	0	3	0.8635078636020704	0.0
60416575801	5	4.317093614587199	0.0	0	5	0.8634187229174397	0.0
60416575802	1	0.8634041508295939	0.0	0	1	0.8634041508295939	0.0
60416575803	2	1.7269017677309533	0.0	0	2	0.8634508838654766	0.0
60416575804	17	14.737072431862277	0.0	0	17	0.8668866136389575	0.0
60416575805	1	0.863564282183094	0.0	0	1	0.863564282183094	0.0
60416575806	3	2.5907500844174383	0.0	0	3	0.8635833614724794	0.0
60416575807	1	0.8635754940713858	0.0	0	1	0.8635754940713858	0.0
60416575808	2	1.727171459097971	0.0	0	2	0.8635857295489855	0.0
60416575809	1	0.8636017561520691	0.0	0	1	0.8636017561520691	0.0
60416575810	1	0.8636129680403609	0.0	0	1	0.8636129680403609	0.0
60416575811	1	0.8636323952461997	0.0	0	1	0.8636323952461997	0.0
60416575812	2	1.739312890368574	0.0	0	2	0.869656445184287	0.0
60416575813	2	1.7274276153926365	0.0	0	2	0.8637138076963182	0.0
60416575814	2	1.781872847961374	0.0	0	2	0.890936423980687	0.0
60416575815	14	12.477400418987928	0.0	0	14	0.8912428870705663	0.0
60416575816	9	7.829296307211395	0.0	0	9	0.8699218119123773	0.0
60416575817	2	1.7277965302875695	0.0	0	2	0.8638982651437848	0.0
60416575818	3	2.5917481781607434	0.0	0	3	0.8639160593869145	0.0
60416575819	22	19.338018971121038	0.0	0	22	0.8790008623236836	0.0
60416575820	1	0.8640696252202438	0.0	0	1	0.8640696252202438	0.0
60416575821	2	1.7282583388755863	0.0	0	2	0.8641291694377932	0.0
60416575822	4	3.4565794710594733	0.0	0	4	0.8641448677648683	0.0
60416575823	2	1.7817009323409005	0.0	0	2	0.8908504661704503	0.0
60416575824	22	19.344748730304154	0.0	0	22	0.8793067604683706	0.0
60416575825	1	0.8642899236739762	0.0	0	1	0.8642899236739762	0.0
60416575826	3	2.5931345129968175	0.0	0	3	0.8643781709989392	0.0
60416575827	2	1.781723221440147	0.0	0	2	0.8908616107200735	0.0
60416575828	18	15.780627621304973	0.0	0	18	0.8767015345169429	0.0
60416575829	10	8.86371996918448	0.0	0	10	0.886371996918448	0.0
60416575830	5	4.322833023973879	0.0	0	5	0.8645666047947758	0.0
60416575831	3	2.593702649342268	0.0	0	3	0.864567549780756	0.0
60416575832	1	0.8647445606938065	0.0	0	1	0.8647445606938065	0.0
60416575833	16	14.11142946963021	0.0	0	16	0.8819643418518881	0.0
60416575834	5	4.324174982627465	0.0	0	5	0.864834996525493	0.0
60416575835	3	2.5944987607496506	0.0	0	3	0.8648329202498836	0.0
60416575836	2	1.7297211704389845	0.0	0	2	0.8648605852194923	0.0
60416575837	20	17.57283025467114	0.0	0	20	0.878641512733557	0.0
60416575838	1	0.864950886373842	0.0	0	1	0.864950886373842	0.0
60416575839	2	1.7898099894692425	0.0	0	2	0.8949049947346213	0.0
60416575840	4	3.4601161315941686	0.0	0	4	0.8650290328985422	0.0
60416575841	3	2.5950983442532523	0.0	0	3	0.8650327814177508	0.0
60416575842	1	0.8651515556057303	0.0	0	1	0.8651515556057303	0.0
60416575843	2	1.7305019622993016	0.0	0	2	0.8652509811496508	0.0
60416575844	2	1.7332365519544595	0.0	0	2	0.8666182759772297	0.0
60416575845	2	1.7322415557899016	0.0	0	2	0.8661207778949508	0.0
60416575846	2	1.7321839475590692	0.0	0	2	0.8660919737795346	0.0
60416575847	4	3.469375097493766	0.0	0	4	0.8673437743734415	0.0
60416575848	1	0.8667484247886164	0.0	0	1	0.8667484247886164	0.0
60416575849	1	0.8667898717390282	0.0	0	1	0.8667898717390282	0.0
60416575850	2	1.7336641861682538	0.0	0	2	0.8668320930841269	0.0
60416575851	1	0.8668581868181392	0.0	0	1	0.8668581868181392	0.0
60416575852	2	1.7338104457560595	0.0	0	2	0.8669052228780297	0.0
60416575853	1	0.8669823929920378	0.0	0	1	0.8669823929920378	0.0
60416575854	2	1.7340678141467567	0.0	0	2	0.8670339070733784	0.0
60416575855	1	0.8670363649347756	0.0	0	1	0.8670363649347756	0.0
60416575856	2	1.776972276367188	0.0	0	2	0.888486138183594	0.0
60416575857	1	0.8670622566527827	0.0	0	1	0.8670622566527827	0.0
60416575858	2	1.734289897075202	0.0	0	2	0.867144948537601	0.0
60416575859	1	0.8671171713368783	0.0	0	1	0.8671171713368783	0.0
60416575860	2	1.7343352159990482	0.0	0	2	0.8671676079995241	0.0
60416575861	1	0.86719716967496	0.0	0	1	0.86719716967496	0.0
60416575862	2	1.7344641695490703	0.0	0	2	0.8672320847745352	0.0
60416575863	2	1.7344671997891492	0.0	0	2	0.8672335998945746	0.0
60416575864	1	0.867258750887229	0.0	0	1	0.867258750887229	0.0
60416575865	1	0.8672819827278335	0.0	0	1	0.8672819827278335	0.0
60416575866	1	0.8673446076894632	0.0	0	1	0.8673446076894632	0.0
60416575867	6	5.215608147130411	0.0	0	6	0.8692680245217352	0.0
60416575868	2	1.7348683025675864	0.0	0	2	0.8674341512837932	0.0
60416575869	2	1.7502439427436811	0.0	0	2	0.8751219713718406	0.0
60416575870	1	0.867438780817247	0.0	0	1	0.867438780817247	0.0
60416575871	1	0.8675116749258105	0.0	0	1	0.8675116749258105	0.0
60416575872	2	1.7353660363352048	0.0	0	2	0.8676830181676024	0.0
60416575873	1	0.8675735928314217	0.0	0	1	0.8675735928314217	0.0
60416575874	2	1.7352001475255547	0.0	0	2	0.8676000737627774	0.0
60416575875	2	1.7352601126097817	0.0	0	2	0.8676300563048909	0.0
60416575876	2	1.735490646541114	0.0	0	2	0.867745323270557	0.0
60416575877	2	1.8501241236840298	0.0	0	2	0.9250620618420149	0.0
60416575878	1	0.8678068203094905	0.0	0	1	0.8678068203094905	0.0
60416575879	1	0.8678788726846988	0.0	0	1	0.8678788726846988	0.0
60416575880	1	0.8679503863505597	0.0	0	1	0.8679503863505597	0.0
60416575881	1	0.8679747629485273	0.0	0	1	0.8679747629485273	0.0
60416575882	2	1.83534560915014	0.0	0	2	0.91767280457507	0.0
60416575883	1	0.8680704511963505	0.0	0	1	0.8680704511963505	0.0
60416575884	2	1.7362428194673531	0.0	0	2	0.8681214097336766	0.0
60416575885	1	0.8694439580160911	0.0	0	1	0.8694439580160911	0.0
60416575886	1	0.869682976619644	0.0	0	1	0.869682976619644	0.0
60416575887	20	17.406356440339266	0.0	0	20	0.8703178220169633	0.0
60416575888	1	0.8697340866689739	0.0	0	1	0.8697340866689739	0.0
60416575889	7	6.091289248300801	0.0	0	7	0.8701841783286859	0.0
60416575890	4	3.479623436779108	0.0	0	4	0.869905859194777	0.0
60416575891	1	0.8699370790849227	0.0	0	1	0.8699370790849227	0.0
60416575892	1	0.8699820276460923	0.0	0	1	0.8699820276460923	0.0
60416575893	10	8.70950970479839	0.0	0	10	0.8709509704798389	0.0
60416575894	2	1.7400221012243617	0.0	0	2	0.8700110506121809	0.0
60416575895	4	3.480068579046691	0.0	0	4	0.8700171447616728	0.0
60416575896	1	0.8701241122364562	0.0	0	1	0.8701241122364562	0.0
60416575897	7	6.091745602456676	0.0	0	7	0.8702493717795251	0.0
60416575898	2	1.7404509138648534	0.0	0	2	0.8702254569324267	0.0
60416575899	3	2.7308265010117467	0.0	0	3	0.9102755003372489	0.0
60416575900	3	2.7310843407731227	0.0	0	3	0.9103614469243743	0.0
60416575901	2	1.7409704990303736	0.0	0	2	0.8704852495151868	0.0
60416575902	14	11.323602334591229	1.0	1	13	0.8710463334300945	0.07692307692307693
60416575903	1	0.8708979682139263	0.0	0	1	0.8708979682139263	0.0
60416575904	2	1.7420648870695177	0.0	0	2	0.8710324435347588	0.0
60416575905	3	2.613697284470555	0.0	0	3	0.8712324281568516	0.0
60416575906	1	0.8719818514207971	0.0	0	1	0.8719818514207971	0.0
60416575907	1	0.872637999405871	0.0	0	1	0.872637999405871	0.0
60416575908	1	0.8728102517196865	0.0	0	1	0.8728102517196865	0.0
60416575909	1	0.8728214636079783	0.0	0	1	0.8728214636079783	0.0
60416575910	4	3.491598305853377	0.0	0	4	0.8728995764633443	0.0
60416575911	3	2.6188174137931206	0.0	0	3	0.8729391379310402	0.0
60416575912	11	9.608389751633778	0.0	0	11	0.8734899774212526	0.0
60416575913	1	0.8730046247860777	0.0	0	1	0.8730046247860777	0.0
60416575914	24	20.959865884267664	0.0	0	24	0.8733277451778193	0.0
60416575915	1	0.873113174719569	0.0	0	1	0.873113174719569	0.0
60416575916	1	0.87317765149458	0.0	0	1	0.87317765149458	0.0
60416575917	1	0.8733347526080014	0.0	0	1	0.8733347526080014	0.0
60416575918	1	0.8735655558940072	0.0	0	1	0.8735655558940072	0.0
60416575919	1	0.8744157065827959	0.0	0	1	0.8744157065827959	0.0
60416575920	1	0.874431632177877	0.0	0	1	0.874431632177877	0.0
60416575921	3	2.6324024851066223	0.0	0	3	0.8774674950355408	0.0
60416575922	30	26.524626744286152	0.0	0	30	0.8841542248095384	0.0
60416575923	2	1.7489733630786188	0.0	0	2	0.8744866815393094	0.0
60416575924	4	3.4981064534787274	0.0	0	4	0.8745266133696818	0.0
60416575925	1	0.8745687673761121	0.0	0	1	0.8745687673761121	0.0
60416575926	1	0.8746878894805451	0.0	0	1	0.8746878894805451	0.0
60416575927	1	0.8746991013688369	0.0	0	1	0.8746991013688369	0.0
60416575928	4	3.508005439752312	0.0	0	4	0.877001359938078	0.0
60416575929	1	0.8747682245119689	0.0	0	1	0.8747682245119689	0.0
60416575930	5	4.3740586601281715	0.0	0	5	0.8748117320256343	0.0
60416575931	1	0.8749100397476591	0.0	0	1	0.8749100397476591	0.0
60416575932	1	0.8749212516359509	0.0	0	1	0.8749212516359509	0.0
60416575933	3	2.625412899671411	0.0	0	3	0.8751376332238037	0.0
60416575934	27	23.80438692569922	0.0	0	27	0.8816439602110822	0.0
60416575935	2	1.7499338145062777	0.0	0	2	0.8749669072531389	0.0
60416575936	4	3.500009242232241	0.0	0	4	0.8750023105580602	0.0
60416575937	1	0.8750393636603576	0.0	0	1	0.8750393636603576	0.0
60416575938	2	1.8436629111105671	0.0	0	2	0.9218314555552836	0.0
60416575939	1	0.8751604385861749	0.0	0	1	0.8751604385861749	0.0
60416575940	1	0.8752016835205814	0.0	0	1	0.8752016835205814	0.0
60416575941	4	3.5009283813868244	0.0	0	4	0.8752320953467061	0.0
60416575942	32	28.197703300237833	0.0	0	32	0.8811782281324323	0.0
60416575943	2	1.7508106313077603	0.0	0	2	0.8754053156538801	0.0
60416575944	1	0.8754048779525354	0.0	0	1	0.8754048779525354	0.0
60416575945	4	3.5018962063986754	0.0	0	4	0.8754740515996688	0.0
60416575946	2	1.7509712003626052	0.0	0	2	0.8754856001813026	0.0
60416575947	1	0.8756648052126325	0.0	0	1	0.8756648052126325	0.0
60416575948	1	0.8756682058153876	0.0	0	1	0.8756682058153876	0.0
60416575949	3	2.635362120591636	0.0	0	3	0.878454040197212	0.0
60416575950	2	1.7514362412067062	0.0	0	2	0.8757181206033531	0.0
60416575951	1	0.8757964859787256	0.0	0	1	0.8757964859787256	0.0
60416575952	36	31.828762580925513	0.0	0	36	0.8841322939145976	0.0
60416575953	1	0.8759100863123483	0.0	0	1	0.8759100863123483	0.0
60416575954	1	0.8759106250216957	0.0	0	1	0.8759106250216957	0.0
60416575955	4	3.512127778355581	0.0	0	4	0.8780319445888952	0.0
60416575956	1	0.8759687382925412	0.0	0	1	0.8759687382925412	0.0
60416575957	5	4.38004368730791	0.0	0	5	0.8760087374615819	0.0
60416575958	23	20.319524473178447	0.0	0	23	0.8834575857903673	0.0
60416575959	1	0.8761679597430585	0.0	0	1	0.8761679597430585	0.0
60416575960	1	0.8761682290977322	0.0	0	1	0.8761682290977322	0.0
60416575961	4	3.5048053378823747	0.0	0	4	0.8762013344705937	0.0
60416575962	1	0.8762348943794669	0.0	0	1	0.8762348943794669	0.0
60416575963	1	0.8762999772024938	0.0	0	1	0.8762999772024938	0.0
60416575964	4	3.513559095422159	0.0	0	4	0.8783897738555397	0.0
60416575965	1	0.876362534825455	0.0	0	1	0.876362534825455	0.0
60416575966	5	4.382066540907214	0.0	0	5	0.8764133081814428	0.0
60416575967	2	1.7528772550415366	0.0	0	2	0.8764386275207683	0.0
60416575968	30	26.424416166169213	0.0	0	30	0.8808138722056404	0.0
60416575969	4	3.514242279882603	0.0	0	4	0.8785605699706508	0.0
60416575970	1	0.8765840117058847	0.0	0	1	0.8765840117058847	0.0
60416575971	4	3.5065262112231546	0.0	0	4	0.8766315528057886	0.0
60416575972	2	1.753311656791507	0.0	0	2	0.8766558283957535	0.0
60416575973	1	0.8767662974812948	0.0	0	1	0.8767662974812948	0.0
60416575974	5	4.384085623541087	0.0	0	5	0.8768171247082174	0.0
60416575975	1	0.8768352859470899	0.0	0	1	0.8768352859470899	0.0
60416575976	5	4.385175567228115	0.0	0	5	0.8770351134456231	0.0
60416575977	2	1.7540497896053808	0.0	0	2	0.8770248948026904	0.0
60416575978	20	17.770346117725435	0.0	0	20	0.8885173058862718	0.0
60416575979	1	0.8771907331083392	0.0	0	1	0.8771907331083392	0.0
60416575980	1	0.8772019449966308	0.0	0	1	0.8772019449966308	0.0
60416575981	1	0.8772240320798723	0.0	0	1	0.8772240320798723	0.0
60416575982	4	3.509191879751185	0.0	0	4	0.8772979699377963	0.0
60416575983	3	2.631894616869407	0.0	0	3	0.8772982056231357	0.0
60416575984	2	1.8011462522815604	0.0	0	2	0.9005731261407802	0.0
60416575985	9	8.029081651738077	0.0	0	9	0.892120183526453	0.0
60416575986	1	0.8774636230621068	0.0	0	1	0.8774636230621068	0.0
60416575987	1	0.8774869559107139	0.0	0	1	0.8774869559107139	0.0
60416575988	15	13.432637544196472	0.0	0	15	0.8955091696130981	0.0
60416575989	2	1.755118454273189	0.0	0	2	0.8775592271365945	0.0
60416575990	3	2.6327622419426504	0.0	0	3	0.8775874139808835	0.0
60416575991	3	2.632701738149076	0.0	0	3	0.877567246049692	0.0
60416575992	2	1.7551902036243894	0.0	0	2	0.8775951018121947	0.0
60416575993	18	15.887344798257896	0.0	0	18	0.8826302665698831	0.0
60416575994	1	0.8776878271586075	0.0	0	1	0.8776878271586075	0.0
60416575995	3	2.6333073147941675	0.0	0	3	0.8777691049313892	0.0
60416575996	2	1.7555909360401503	0.0	0	2	0.8777954680200751	0.0
60416575997	20	17.78428044104269	0.0	0	20	0.8892140220521345	0.0
60416575998	1	0.8779306503969261	0.0	0	1	0.8779306503969261	0.0
60416575999	5	4.390046812832205	0.0	0	5	0.878009362566441	0.0
60416576000	3	2.6340355488237837	0.0	0	3	0.8780118496079279	0.0
60416576001	2	1.7560793434021926	0.0	0	2	0.8780396717010963	0.0
60416576002	16	14.186012903368306	0.0	0	16	0.8866258064605191	0.0
60416576003	7	6.326009860333878	0.0	0	7	0.9037156943334111	0.0
60416576004	3	2.6348495723169654	0.0	0	3	0.8782831907723218	0.0
60416576005	20	17.745262733094066	0.0	0	20	0.8872631366547032	0.0
60416576006	3	2.635464643714304	0.0	0	3	0.8784882145714347	0.0
60416576007	20	17.752736214200535	0.0	0	20	0.8876368107100268	0.0
60416576008	4	3.5146147637269625	0.0	0	4	0.8786536909317406	0.0
60416576009	3	2.6359629498606036	0.0	0	3	0.8786543166202012	0.0
60416576010	2	1.7573627510835885	0.0	0	2	0.8786813755417943	0.0
60416576011	16	14.105677333235196	0.0	0	16	0.8816048333271997	0.0
60416576012	1	0.8787945045047381	0.0	0	1	0.8787945045047381	0.0
60416576013	1	0.8788057163930298	0.0	0	1	0.8788057163930298	0.0
60416576014	4	3.515513903297026	0.0	0	4	0.8788784758242565	0.0
60416576015	3	2.636642127670277	0.0	0	3	0.8788807092234258	0.0
60416576016	2	1.7578260411223106	0.0	0	2	0.8789130205611553	0.0
60416576017	14	12.528638815819885	0.0	0	14	0.8949027725585632	0.0
60416576018	1	0.8790377654444014	0.0	0	1	0.8790377654444014	0.0
60416576019	1	0.8790489773326932	0.0	0	1	0.8790489773326932	0.0
60416576020	11	9.848512877695438	0.0	0	11	0.8953193525177671	0.0
60416576021	4	3.516630816120756	0.0	0	4	0.879157704030189	0.0
60416576022	2	1.75829818619593	0.0	0	2	0.879149093097965	0.0
60416576023	2	1.801070630956926	0.0	0	2	0.900535315478463	0.0
60416576024	21	18.688342636114257	0.0	0	21	0.8899210779102027	0.0
60416576025	4	3.51753163915753	0.0	0	4	0.8793829097893825	0.0
60416576026	2	1.7587629576853572	0.0	0	2	0.8793814788426786	0.0
60416576027	2	1.7588224850682395	0.0	0	2	0.8794112425341197	0.0
60416576028	21	18.69506781626792	0.0	0	21	0.8902413245841866	0.0
60416576029	2	1.7592230828066637	0.0	0	2	0.8796115414033319	0.0
60416576030	13	11.525984089825473	0.0	0	13	0.8866141607558056	0.0
60416576031	1	0.879764922055323	0.0	0	1	0.879764922055323	0.0
60416576032	1	0.8797794672077014	0.0	0	1	0.8797794672077014	0.0
60416576033	1	0.8797797365623751	0.0	0	1	0.8797797365623751	0.0
60416576034	1	0.8797997361468956	0.0	0	1	0.8797997361468956	0.0
60416576035	1	0.8798109480351873	0.0	0	1	0.8798109480351873	0.0
60416576036	9	8.096484056206645	0.0	0	9	0.8996093395785161	0.0
60416576037	5	4.399492912891338	0.0	0	5	0.8798985825782676	0.0
60416576038	3	2.6396869802401746	0.0	0	3	0.8798956600800582	0.0
60416576039	2	1.8009455157110037	0.0	0	2	0.9004727578555018	0.0
60416576040	1	0.8800614142123714	0.0	0	1	0.8800614142123714	0.0
60416576041	1	0.880072929124671	0.0	0	1	0.880072929124671	0.0
60416576042	2	1.7604075699841522	0.0	0	2	0.8802037849920761	0.0
60416576043	2	1.760506389480057	0.0	0	2	0.8802531947400285	0.0
60416576044	2	1.760589317050215	0.0	0	2	0.8802946585251075	0.0
60416576045	4	3.52352276048676	0.0	0	4	0.88088069012169	0.0
60416576046	5	4.565843127097326	0.0	0	5	0.9131686254194651	0.0
60416576047	3	2.7920286302469743	0.0	0	3	0.9306762100823248	0.0
60416576048	2	1.7635271348066608	0.0	0	2	0.8817635674033304	0.0
60416576049	2	1.7635688847810804	0.0	0	2	0.8817844423905402	0.0
60416576050	1	0.8818077752391474	0.0	0	1	0.8818077752391474	0.0
60416576051	1	0.8818160242260287	0.0	0	1	0.8818160242260287	0.0
60416576052	1	0.8818366298585649	0.0	0	1	0.8818366298585649	0.0
60416576053	1	0.8818506026322618	0.0	0	1	0.8818506026322618	0.0
60416576054	1	0.8818744068515479	0.0	0	1	0.8818744068515479	0.0
60416576055	1	0.8818873695452185	0.0	0	1	0.8818873695452185	0.0
60416576056	1	0.8819524523682454	0.0	0	1	0.8819524523682454	0.0
60416576057	1	0.8819658527632608	0.0	0	1	0.8819658527632608	0.0
60416576058	1	0.8819774686835631	0.0	0	1	0.8819774686835631	0.0
60416576059	1	0.8819890846038653	0.0	0	1	0.8819890846038653	0.0
60416576060	1	0.882090631315841	0.0	0	1	0.882090631315841	0.0
60416576061	3	2.7261768669654236	0.0	0	3	0.9087256223218079	0.0
60416576062	1	0.8822608298002698	0.0	0	1	0.8822608298002698	0.0
60416576063	1	0.8822912332090609	0.0	0	1	0.8822912332090609	0.0
60416576064	1	0.8823028491293632	0.0	0	1	0.8823028491293632	0.0
60416576065	1	0.8823252729059468	0.0	0	1	0.8823252729059468	0.0
60416576066	2	1.7647016895305576	0.0	0	2	0.8823508447652788	0.0
60416576067	1	0.8823507269226091	0.0	0	1	0.8823507269226091	0.0
60416576068	1	0.8824301192126749	0.0	0	1	0.8824301192126749	0.0
60416576069	2	1.765034510899218	0.0	0	2	0.882517255449609	0.0
60416576070	2	1.8489614879044431	0.0	0	2	0.9244807439522216	0.0
60416576071	1	0.8826896087714272	0.0	0	1	0.8826896087714272	0.0
60416576072	2	1.7654678352304938	0.0	0	2	0.8827339176152469	0.0
60416576073	2	1.7654512362487285	0.0	0	2	0.8827256181243642	0.0
60416576074	1	0.8827588329225619	0.0	0	1	0.8827588329225619	0.0
60416576075	1	0.88286559838134	0.0	0	1	0.88286559838134	0.0
60416576076	1	0.8828772143016422	0.0	0	1	0.8828772143016422	0.0
60416576077	1	0.8829294017696669	0.0	0	1	0.8829294017696669	0.0
60416576078	1	0.8843186658378175	0.0	0	1	0.8843186658378175	0.0
60416576079	1	0.8843786982607129	0.0	0	1	0.8843786982607129	0.0
60416576080	1	0.8844974500024696	0.0	0	1	0.8844974500024696	0.0
60416576081	20	18.00380705895773	0.0	0	20	0.9001903529478865	0.0
60416576082	1	0.8850201327467372	0.0	0	1	0.8850201327467372	0.0
60416576083	4	3.5402338611349387	0.0	0	4	0.8850584652837347	0.0
60416576084	2	1.7701217789515955	0.0	0	2	0.8850608894757978	0.0
60416576085	2	1.7702015079350035	0.0	0	2	0.8851007539675018	0.0
60416576086	3	2.6642118916250124	0.0	0	3	0.8880706305416708	0.0
60416576087	1	0.8852089503729839	0.0	0	1	0.8852089503729839	0.0
60416576088	5	4.426292894858042	0.0	0	5	0.8852585789716084	0.0
60416576089	1	0.8852765247267422	0.0	0	1	0.8852765247267422	0.0
60416576090	4	3.5503848623750813	0.0	0	4	0.8875962155937703	0.0
60416576091	25	22.261072118468118	0.0	0	25	0.8904428847387247	0.0
60416576092	2	1.7707652335976725	0.0	0	2	0.8853826167988362	0.0
60416576093	4	3.5417262207044384	0.0	0	4	0.8854315551761096	0.0
60416576094	1	0.8854535244166813	0.0	0	1	0.8854535244166813	0.0
60416576095	3	2.6572558408466733	0.0	0	3	0.8857519469488911	0.0
60416576096	1	0.8856869202414213	0.0	0	1	0.8856869202414213	0.0
60416576097	29	24.962549195526815	1.0	1	28	0.8915196141259577	0.03571428571428571
60416576098	2	1.771581108904236	0.0	0	2	0.885790554452118	0.0
60416576099	5	4.429158087860599	0.0	0	5	0.8858316175721198	0.0
60416576100	1	0.8858561086458238	0.0	0	1	0.8858561086458238	0.0
60416576101	2	1.7720193826276405	0.0	0	2	0.8860096913138202	0.0
60416576102	1	0.8860356335358286	0.0	0	1	0.8860356335358286	0.0
60416576103	34	30.348848779808176	0.0	0	34	0.8926131994061228	0.0
60416576104	3	2.6666724128997052	0.0	0	3	0.8888908042999017	0.0
60416576105	2	1.7722995451575971	0.0	0	2	0.8861497725787986	0.0
60416576106	5	4.43098239339607	0.0	0	5	0.8861964786792139	0.0
60416576107	2	1.7726395717637784	0.0	0	2	0.8863197858818892	0.0
60416576108	2	1.7727058330135028	0.0	0	2	0.8863529165067514	0.0
60416576109	4	3.5537509540626715	0.0	0	4	0.8884377385156679	0.0
60416576110	28	25.0349855694917	0.0	0	28	0.8941066274818464	0.0
60433194308	3	2.559266563384862	0.0	0	3	0.8530888544616206	0.0
60433194309	2	1.7007740276910746	0.0	0	2	0.8503870138455373	0.0
60630399392	5	4.591701647140866	0.0	0	5	0.9183403294281731	0.0
60630399393	1	0.8501480289113186	0.0	0	1	0.8501480289113186	0.0
60630399394	4	3.4007332574942803	0.0	0	4	0.8501833143735701	0.0
60630399395	2	1.7003799618034872	0.0	0	2	0.8501899809017436	0.0
60630399396	33	28.401665089987866	0.0	0	33	0.8606565178784201	0.0
60788856052	1	0.7404262342428779	0.0	0	1	0.7404262342428779	0.0
60788856053	2	1.6179168264416863	0.0	0	2	0.8089584132208432	0.0
60788856054	1	0.7404373787925012	0.0	0	1	0.7404373787925012	0.0
60788856055	1	0.7404390959285458	0.0	0	1	0.7404390959285458	0.0
60788856056	5	2.2217566389277366	2.0	2	3	0.7405855463092456	0.6666666666666666
60788856057	10	4.690845513411388	1.0	2	8	0.7818075855685646	0.25
60788856058	3	1.5169463651209671	1.0	1	2	0.7584731825604836	0.5
60788856059	26	16.51425268370687	4.0	4	22	0.7506478492594032	0.18181818181818182
60788856060	2	0.7406497312833602	1.0	1	1	0.7406497312833602	1.0
60788856061	2	1.4814469005812236	0.0	0	2	0.7407234502906118	0.0
60788856062	7	3.890161002379176	0.5	1	6	0.7780322004758352	0.16666666666666666
60788856063	21	14.96449184877203	1.0	1	20	0.7482245924386015	0.05
60788856064	2	1.4818404277594637	0.0	0	2	0.7409202138797318	0.0
60788856065	5	3.885831024991838	0.0	0	5	0.7771662049983676	0.0
60788856066	2	1.4819284730684215	0.0	0	2	0.7409642365342107	0.0
60788856067	18	13.524080391999934	0.0	0	18	0.7513377995555519	0.0
60788856068	1	0.7410641671181444	0.0	0	1	0.7410641671181444	0.0
60788856069	3	1.4822436180366219	1.0	1	2	0.7411218090183109	0.5
60788856070	3	2.2594403678549844	0.0	0	3	0.7531467892849948	0.0
60788856071	6	4.628127287726043	0.0	0	6	0.7713545479543406	0.0
60788856072	22	15.752436287771397	1.0	1	21	0.7501160137033999	0.047619047619047616
60788856073	1	0.7412873274652847	0.0	0	1	0.7412873274652847	0.0
60788856074	1	0.7412909637533792	0.0	0	1	0.7412909637533792	0.0
60788856075	1	0.7413038254390473	0.0	0	1	0.7413038254390473	0.0
60788856076	1	0.7413110306765681	0.0	0	1	0.7413110306765681	0.0
60788856077	2	1.5106629939707985	0.0	0	2	0.7553314969853993	0.0
60788856078	5	3.7070306653898806	0.0	0	5	0.7414061330779761	0.0
60788856079	3	2.224210695690261	0.0	0	3	0.7414035652300871	0.0
60788856080	3	1.4828795307518359	1.0	1	2	0.7414397653759179	0.5
60788856081	21	14.236770266422411	2.0	2	19	0.7493036982327584	0.10526315789473684
60788856082	1	0.7415857051050488	0.0	0	1	0.7415857051050488	0.0
60788856083	5	3.889411320983668	0.0	0	5	0.7778822641967336	0.0
60788856084	3	2.224967144621945	0.0	0	3	0.7416557148739816	0.0
60788856085	2	1.483783586044694	0.0	0	2	0.741891793022347	0.0
60788856086	2	1.4866245371266193	0.0	0	2	0.7433122685633097	0.0
60788856087	2	1.486169260389439	0.0	0	2	0.7430846301947195	0.0
60788856088	1	0.7419348897701351	0.0	0	1	0.7419348897701351	0.0
60788856089	2	1.4861886539259437	0.0	0	2	0.7430943269629718	0.0
60788856090	2	1.4857468785917813	0.0	0	2	0.7428734392958907	0.0
60788856091	1	0.7419821278460309	0.0	0	1	0.7419821278460309	0.0
60788856092	2	1.4856772504086364	0.0	0	2	0.7428386252043182	0.0
60788856093	2	1.4840360387125964	0.0	0	2	0.7420180193562982	0.0
60788856094	2	1.4856898090702964	0.0	0	2	0.7428449045351482	0.0
60788856095	2	1.485422373548671	0.0	0	2	0.7427111867743355	0.0
60788856096	17	12.92612150111225	0.0	0	17	0.7603600883007207	0.0
60788856097	1	0.7425377055298211	0.0	0	1	0.7425377055298211	0.0
60788856098	4	3.222693555490783	0.0	0	4	0.8056733888726958	0.0
60788856099	2	1.486827529542568	0.0	0	2	0.743413764771284	0.0
60788856100	1	0.7434082261658066	0.0	0	1	0.7434082261658066	0.0
60788856101	1	0.743462635809889	0.0	0	1	0.743462635809889	0.0
60788856102	1	0.743509234168435	0.0	0	1	0.743509234168435	0.0
60788856103	2	1.4870725412876102	0.0	0	2	0.7435362706438051	0.0
60788856104	2	1.6462994017935721	0.0	0	2	0.8231497008967861	0.0
60788856105	3	2.564209356324146	0.0	0	3	0.8547364521080487	0.0
60788856106	2	1.7055992473152999	0.0	0	2	0.8527996236576499	0.0
60788856107	2	1.4872744226155303	0.0	0	2	0.7436372113077652	0.0
60788856108	1	0.7436385917504676	0.0	0	1	0.7436385917504676	0.0
60788856109	1	0.7436737088660481	0.0	0	1	0.7436737088660481	0.0
60788856110	2	1.487459570284348	0.0	0	2	0.743729785142174	0.0
60788856111	1	0.7437029001788077	0.0	0	1	0.7437029001788077	0.0
60788856112	2	1.4874874148237391	0.0	0	2	0.7437437074118696	0.0
60788856113	1	0.7437518890600825	0.0	0	1	0.7437518890600825	0.0
60788856114	2	1.6110960253788669	0.0	0	2	0.8055480126894334	0.0
60788856115	2	1.4879608730013927	0.0	0	2	0.7439804365006963	0.0
60788856116	1	0.7439003708239462	0.0	0	1	0.7439003708239462	0.0
61159441369	4	1.0921353586694849	1.0	1	3	0.5460676793347424	0.3333333333333333
61159441370	6	0.7621524832295572	2.0	2	4	0.1905381208073893	0.5
61159441371	39	5.387711911843448	11.0	11	28	0.19241828256583743	0.39285714285714285
61159441372	4	0.8656074720602606	0.5	1	3	0.4328037360301303	0.3333333333333333
61159441373	11	2.0844840698090548	5.0	5	6	0.3474140116348425	0.8333333333333334
61159441374	4	0.9642063328179344	0.5	1	3	0.4821031664089672	0.3333333333333333
61159441375	9	5.144626625096711	1.0	1	8	0.6430783281370889	0.125
61159441376	1	0.18786717461122104	0.0	0	1	0.18786717461122104	0.0
61159441377	1	0.1878677469899026	0.0	0	1	0.1878677469899026	0.0
61706707298	5	0.0	5.0	5	0	0.0	inf
61706707299	10	0.1598705845067124	6.0	6	4	0.022838654929530345	1.5
61706707300	2	0.0	2.0	2	0	0.0	inf
61706707301	1	0.0	1.0	1	0	0.0	inf
61706707302	1	0.0	1.0	1	0	0.0	inf
61706707303	9	3.974080572130875	4.0	4	5	0.44156450801454167	0.8
61706707304	13	2.5844482624721232	6.0	6	7	0.3230560328090154	0.8571428571428571
61706707305	18	0.08892966769006852	14.0	14	4	0.004940537093892696	3.5
61706707306	4	0.0	4.0	4	0	0.0	inf
61838257166	3	1.6153600445404888	0.0	0	3	0.5384533481801629	0.0
61838257167	2	1.076962542562668	0.0	0	2	0.538481271281334	0.0
61838257168	28	10.95186571376615	8.0	8	20	0.5475932856883075	0.4
61838257169	9	4.655996473069903	2.0	2	7	0.6651423532957005	0.2857142857142857
61838257170	2	1.077252368191543	0.0	0	2	0.5386261840957715	0.0
61838257171	28	10.957040488418137	8.0	8	20	0.5478520244209069	0.4
61838257172	9	6.940605577318478	1.0	1	8	0.8675756971648098	0.125
61838257173	8	3.572055893653657	1.5	2	6	0.7144111787307315	0.3333333333333333
61838257174	1	0.5387802886384482	0.0	0	1	0.5387802886384482	0.0
61838257175	1	0.538788133593319	0.0	0	1	0.538788133593319	0.0
61838257176	3	1.0814173658412551	1.0	1	2	0.5407086829206276	0.5
61838257177	1	0.5388055406391052	0.0	0	1	0.5388055406391052	0.0
61838257178	5	1.6168881272735849	2.0	2	3	0.5389627090911949	0.6666666666666666
61838257179	5	2.8808887370925658	0.0	0	5	0.5761777474185131	0.0
61838257180	2	1.0777707075916976	0.0	0	2	0.5388853537958488	0.0
61838257181	2	0.5389160433939807	1.0	1	1	0.5389160433939807	1.0
61838257182	22	8.157155354718727	7.0	7	15	0.5438103569812485	0.4666666666666667
61838257183	1	0.5390732455154046	0.0	0	1	0.5390732455154046	0.0
61838257184	2	0.5390766124488255	1.0	1	1	0.5390766124488255	1.0
61838257185	2	0.5390783295848702	1.0	1	1	0.5390783295848702	1.0
61838257186	1	0.5390771848275071	0.0	0	1	0.5390771848275071	0.0
61838257187	10	4.497210007455401	2.0	2	8	0.5621512509319251	0.25
61838257188	2	0.5391742871873672	1.0	1	1	0.5391742871873672	1.0
61838257189	2	0.7404078171170653	0.0	0	2	0.7404078171170653	0.0
61838257190	8	4.675365127936568	0.5	1	7	0.7792275213227614	0.14285714285714285
61838257191	1	0.5392875508276478	0.0	0	1	0.5392875508276478	0.0
61838257192	2	0.9583524813642761	0.0	0	2	0.9583524813642761	0.0
61838257193	1	0.5393154290363732	0.0	0	1	0.5393154290363732	0.0
61838257194	3	0.7403212532588128	0.5	1	2	0.7403212532588128	0.5
61838257195	1	0.5393578523974771	0.0	0	1	0.5393578523974771	0.0
61838257196	2	1.0787746934684892	0.0	0	2	0.5393873467342446	0.0
61838257197	1	0.5393890975396235	0.0	0	1	0.5393890975396235	0.0
61838257198	30	10.968863003755105	10.0	10	20	0.5484431501877552	0.5
61838257199	6	2.241266637659413	2.0	2	4	0.5603166594148532	0.5
61838257200	9	5.220666190200695	1.0	1	8	0.6525832737750868	0.125
61838257201	3	1.079028290893755	1.0	1	2	0.5395141454468775	0.5
61838257202	27	10.939068740558486	7.0	7	20	0.5469534370279243	0.35
61838257203	2	1.0792715518334182	0.0	0	2	0.5396357759167091	0.0
61838257204	1	0.5396386209754498	0.0	0	1	0.5396386209754498	0.0
61838257205	2	0.5396528967731545	1.0	1	1	0.5396528967731545	1.0
61838257206	2	1.29914506489882	0.0	0	2	0.64957253244941	0.0
61838257207	1	0.5396641086614463	0.0	0	1	0.5396641086614463	0.0
61838257208	6	2.884919764461459	1.0	1	5	0.5769839528922918	0.2
61838257209	3	1.619243734902881	0.0	0	3	0.5397479116342937	0.0
61838257210	21	8.169999296647608	6.0	6	15	0.5446666197765072	0.4
61838257211	1	0.5398993562995678	0.0	0	1	0.5398993562995678	0.0
61838257212	3	0.5841078991725996	0.5	1	2	0.5841078991725996	0.5
61838257213	3	1.0798303281039583	1.0	1	2	0.5399151640519791	0.5
61838257214	1	0.5399120496385648	0.0	0	1	0.5399120496385648	0.0
61838257215	15	5.471577273967069	5.0	5	10	0.547157727396707	0.5
61838257216	8	4.492144523462256	1.0	1	7	0.6417349319231794	0.14285714285714285
61838257217	3	1.6199871201328917	0.0	0	3	0.5399957067109639	0.0
61838257218	2	1.0802772548462545	0.0	0	2	0.5401386274231272	0.0
61838257219	1	0.5401363547430681	0.0	0	1	0.5401363547430681	0.0
61838257220	2	1.496308443693274	0.0	0	2	0.748154221846637	0.0
61838257221	23	9.3163327213034	7.0	7	16	0.5822707950814625	0.4375
61838257222	6	2.887190491699213	1.0	1	5	0.5774380983398426	0.2
61838257223	2	0.5402527496314302	1.0	1	1	0.5402527496314302	1.0
61838257224	29	12.140660141841497	7.0	7	22	0.5518481882655226	0.3181818181818182
61838257225	3	0.7137154086731599	0.5	1	2	0.7137154086731599	0.5
61838257226	2	0.9784222327771844	0.0	0	2	0.9784222327771844	0.0
61838257227	4	1.729227577999474	0.5	1	3	0.864613788999737	0.3333333333333333
61838257228	3	0.7365109957143314	0.5	1	2	0.7365109957143314	0.5
61838257229	2	1.4663478876549938	0.0	0	2	0.7331739438274969	0.0
61838257230	2	0.9784501109859098	0.0	0	2	0.9784501109859098	0.0
61838257231	1	0.5404177630383907	0.0	0	1	0.5404177630383907	0.0
61838257232	12	2.924649578828615	3.5	5	7	0.584929915765723	0.7142857142857143
61838257233	2	1.0809764995791165	0.0	0	2	0.5404882497895582	0.0
61838257234	3	1.2243956413430737	1.0	1	2	0.6121978206715368	0.5
61838257235	28	10.958733820243532	8.0	8	20	0.5479366910121766	0.4
61838257236	6	5.155742825140637	0.0	0	6	0.8592904708567728	0.0
61838257237	6	3.704313146087167	1.0	1	5	0.7408626292174334	0.2
61838257238	1	0.5406008232084876	0.0	0	1	0.5406008232084876	0.0
61838257239	1	0.5406086681633584	0.0	0	1	0.5406086681633584	0.0
61838257240	2	0.5406229102917289	1.0	1	1	0.5406229102917289	1.0
61838257241	1	0.5406541554338753	0.0	0	1	0.5406541554338753	0.0
61838257242	9	3.4690705583658414	1.5	2	7	0.5781784263943069	0.2857142857142857
61838257243	3	1.8966795874981317	0.0	0	3	0.6322265291660439	0.0
61838257244	28	10.998904938574169	8.0	8	20	0.5499452469287085	0.4
61838257245	3	0.722000691096754	0.5	1	2	0.722000691096754	0.5
61838257246	1	0.5408745548956104	0.0	0	1	0.5408745548956104	0.0
61838257247	1	0.5408784605383787	0.0	0	1	0.5408784605383787	0.0
61838257248	2	0.5408857667839022	1.0	1	1	0.5408857667839022	1.0
61838257249	2	0.5409090996325093	1.0	1	1	0.5409090996325093	1.0
61838257250	1	0.540910816768554	0.0	0	1	0.540910816768554	0.0
61838257251	3	1.816578187584453	0.0	0	3	0.605526062528151	0.0
61838257252	1	0.5409241834942351	0.0	0	1	0.5409241834942351	0.0
61838257253	5	2.8908946235022657	0.0	0	5	0.5781789247004532	0.0
61838257254	2	1.0819850644853606	0.0	0	2	0.5409925322426803	0.0
61838257255	2	0.5410257975448793	1.0	1	1	0.5410257975448793	1.0
61838257256	19	7.611882877719341	5.0	5	14	0.5437059198370958	0.35714285714285715
61838257257	2	0.8948396593915877	0.0	0	2	0.8948396593915877	0.0
61838257258	3	0.5736082856460524	0.5	1	2	0.5736082856460524	0.5
61838257259	3	1.4359669026404402	0.0	0	3	0.7179834513202201	0.0
61838257260	3	1.7896914397434909	0.0	0	3	0.8948457198717454	0.0
61838257261	3	0.6045702013530561	0.5	1	2	0.6045702013530561	0.5
61838257262	5	1.6238513159507764	2.0	2	3	0.5412837719835921	0.6666666666666666
61838257263	8	3.391526041361363	2.0	2	6	0.5652543402268938	0.3333333333333333
61838257264	5	2.8918922458748924	0.0	0	5	0.5783784491749785	0.0
61838257265	1	0.5411952216346213	0.0	0	1	0.5411952216346213	0.0
61838257266	1	0.5412297663715202	0.0	0	1	0.5412297663715202	0.0
61838257267	26	11.585458611853078	5.0	5	21	0.5516885053263371	0.23809523809523808
61838257268	2	0.5413686187058	1.0	1	1	0.5413686187058	1.0
61838257269	1	0.5413798305940917	0.0	0	1	0.5413798305940917	0.0
61838257270	1	0.541411075736238	0.0	0	1	0.541411075736238	0.0
61838257271	5	2.893219322682758	0.0	0	5	0.5786438645365516	0.0
61838257272	2	0.5415112083361769	1.0	1	1	0.5415112083361769	1.0
61838257273	19	7.042205924543588	6.0	6	13	0.5417081480418144	0.46153846153846156
61838257274	2	1.0832260151363187	0.0	0	2	0.5416130075681593	0.0
61838257275	2	1.083237496379284	0.0	0	2	0.541618748189642	0.0
61838257276	2	0.5416328219713415	1.0	1	1	0.5416328219713415	1.0
61838257277	4	1.6798389070503146	1.0	1	3	0.5599463023501049	0.3333333333333333
61838257278	12	3.881714443844719	5.0	5	7	0.5545306348349598	0.7142857142857143
61838257279	2	0.5417065578132603	1.0	1	1	0.5417065578132603	1.0
61838257280	2	1.0834930466259336	0.0	0	2	0.5417465233129668	0.0
61838257281	3	1.5374912918475734	1.0	1	2	0.7687456459237867	0.5
61838257282	45	28.256231141595478	8.0	8	37	0.7636819227458237	0.21621621621621623
61838257283	3	1.0838691667583875	1.0	1	2	0.5419345833791938	0.5
61838257284	2	0.5419374284379345	1.0	1	1	0.5419374284379345	1.0
61838257285	7	3.157710158007829	0.5	1	6	0.6315420316015657	0.16666666666666666
61838257286	3	1.6260623137896428	0.0	0	3	0.5420207712632142	0.0
61838257287	21	19.208123925506328	0.0	0	21	0.9146725678812537	0.0
61838257288	22	19.73809348809151	0.0	0	22	0.8971860676405232	0.0
61838257289	33	22.88172212045292	1.5	3	30	0.953405088352205	0.1
61838257290	1	0.5422474556673351	0.0	0	1	0.5422474556673351	0.0
61838257291	5	2.1692612311724027	1.0	1	4	0.5423153077931007	0.25
61838257292	2	1.0846578372429099	0.0	0	2	0.5423289186214549	0.0
61838257293	7	2.3811842360042554	0.5	1	6	0.7937280786680851	0.16666666666666666
61838257294	1	0.5426093336714184	0.0	0	1	0.5426093336714184	0.0
61927902814	29	10.598474839765112	2.0	4	25	0.7065649893176741	0.16
61927902815	3	1.7726267774167788	0.0	0	3	0.8863133887083894	0.0
61927902816	1	0.5427875791267232	0.0	0	1	0.5427875791267232	0.0
61927902817	4	1.4291398054121234	1.0	1	3	0.7145699027060617	0.3333333333333333
61927902818	1	0.5428111476606698	0.0	0	1	0.5428111476606698	0.0
61927902819	1	0.5428117200393514	0.0	0	1	0.5428117200393514	0.0
61927902820	2	0.5428223595489615	1.0	1	1	0.5428223595489615	1.0
61927902821	3	0.7113512153636404	0.5	1	2	0.7113512153636404	0.5
61927902822	2	1.0858834346774682	0.0	0	2	0.5429417173387341	0.0
61927902823	55	29.115384101279787	4.0	8	47	0.8318681171794224	0.1702127659574468
61927902824	5	1.6779980698717472	0.5	1	4	0.559332689957249	0.25
61927902825	11	4.0356442090075095	1.5	3	8	0.8071288418015019	0.375
61927902826	27	21.90609700128452	0.0	0	27	0.9524390000558488	0.0
61927902827	32	30.23897816668253	0.0	0	32	0.944968067708829	0.0
61927902828	23	21.65023642438135	0.0	0	23	0.9841016556536978	0.0
61927902829	31	26.951443533984488	0.0	0	31	0.8694014043220802	0.0
61927902830	21	7.065430728257261	8.0	8	13	0.5434946714044047	0.6153846153846154
61927902831	4	1.0870846218447245	2.0	2	2	0.5435423109223623	1.0
61927902832	4	1.08698260376207	2.0	2	2	0.543491301881035	1.0
61927902833	2	0.5435026821159978	1.0	1	1	0.5435026821159978	1.0
61927902834	7	2.9021130773141848	2.0	2	5	0.5804226154628369	0.4
61927902835	1	0.5435310316954022	0.0	0	1	0.5435310316954022	0.0
61927902836	3	1.0871582230093064	1.0	1	2	0.5435791115046532	0.5
61927902837	12	6.719347884254391	0.0	0	12	0.5599456570211993	0.0
61927902838	17	5.98093756772797	6.0	6	11	0.5437215970661792	0.5454545454545454
61927902839	6	2.17548460356901	2.0	2	4	0.5438711508922525	0.5
61927902840	30	12.170500161663313	8.0	8	22	0.5532045528028778	0.36363636363636365
61927902841	6	2.5615543273057257	2.0	2	4	0.6403885818264314	0.5
61927902842	4	2.1232205714783636	1.0	1	3	0.7077401904927879	0.3333333333333333
61927902843	8	4.025003925002636	1.0	1	7	0.5750005607146623	0.14285714285714285
61927902844	2	1.0874984179621587	0.0	0	2	0.5437492089810794	0.0
61927902845	2	0.5437980295156831	1.0	1	1	0.5437980295156831	1.0
61927902846	3	1.4864483791700356	1.0	1	2	0.7432241895850178	0.5
61927902847	3	1.1666595680487042	1.0	1	2	0.5833297840243521	0.5
61927902848	7	2.904355623319206	2.0	2	5	0.5808711246638412	0.4
61927902849	37	13.184631383247018	13.0	13	24	0.5493596409686258	0.5416666666666666
61927902850	1	0.54414250047398	0.0	0	1	0.54414250047398	0.0
61927902851	7	2.905259914297403	2.0	2	5	0.5810519828594807	0.4
61927902852	2	1.0883506561496685	0.0	0	2	0.5441753280748343	0.0
61927902853	2	1.0884125403859455	0.0	0	2	0.5442062701929727	0.0
61927902854	5	1.6333077861648464	2.0	2	3	0.5444359287216155	0.6666666666666666
61927902855	4	1.088658057171001	2.0	2	2	0.5443290285855005	1.0
61927902856	2	0.5443404088204632	1.0	1	1	0.5443404088204632	1.0
61927902857	40	15.453682763560096	12.0	12	28	0.5519172415557178	0.42857142857142855
61927902858	6	2.178649891347375	2.0	2	4	0.5446624728368438	0.5
61927902859	1	0.5445348155561887	0.0	0	1	0.5445348155561887	0.0
61927902860	4	2.178284040361855	0.0	0	4	0.5445710100904637	0.0
61927902861	1	0.5445986526138498	0.0	0	1	0.5445986526138498	0.0
61927902862	1	0.544611716315523	0.0	0	1	0.544611716315523	0.0
61927902863	40	14.878187985118293	13.0	13	27	0.5510439994488256	0.48148148148148145
61927902864	2	0.5447107041580989	1.0	1	1	0.5447107041580989	1.0
61927902865	2	0.5447219497157247	1.0	1	1	0.5447219497157247	1.0
61927902866	5	2.723841023235309	0.0	0	5	0.5447682046470618	0.0
61927902867	3	1.0895880715205344	1.0	1	2	0.5447940357602672	0.5
61927902868	3	1.4122101571155912	1.0	1	2	0.7061050785577956	0.5
61927902869	7	2.909303803351964	2.0	2	5	0.5818607606703928	0.4
61927902870	2	1.0898769544080515	0.0	0	2	0.5449384772040258	0.0
61927902871	4	1.08994196989241	2.0	2	2	0.544970984946205	1.0
61927902872	31	12.243954090246678	9.0	9	22	0.5565433677384853	0.4090909090909091
61927902873	2	0.5450644341833033	1.0	1	1	0.5450644341833033	1.0
61927902874	7	2.9115495816130688	2.0	2	5	0.5823099163226138	0.4
61927902875	2	1.0902161392808776	0.0	0	2	0.5451080696404388	0.0
61927902876	4	1.0902825352079386	2.0	2	2	0.5451412676039693	1.0
61927902877	5	1.636061331655164	2.0	2	3	0.545353777218388	0.6666666666666666
61927902878	2	0.5452547669295894	1.0	1	1	0.5452547669295894	1.0
61927902879	6	2.726531371385315	1.0	1	5	0.545306274277063	0.2
61927902880	2	0.5453306912782317	1.0	1	1	0.5453306912782317	1.0
61927902881	40	14.854107071243671	13.0	13	27	0.5501521137497656	0.48148148148148145
61927902882	6	2.1822284365338267	2.0	2	4	0.5455571091334567	0.5
61927902883	3	1.0908661594471254	1.0	1	2	0.5454330797235627	0.5
61927902884	5	1.9779086407531534	2.0	2	3	0.6593028802510511	0.6666666666666666
61927902885	8	2.7274313863580684	3.0	3	5	0.5454862772716137	0.6
61927902886	2	0.5455973187358364	1.0	1	1	0.5455973187358364	1.0
61927902887	6	2.182557958307735	2.0	2	4	0.5456394895769338	0.5
61927902888	3	1.0913319746859131	1.0	1	2	0.5456659873429566	0.5
61927902889	1	0.5456813910633573	0.0	0	1	0.5456813910633573	0.0
61927902890	24	9.95340952007832	6.0	6	18	0.5529671955599067	0.3333333333333333
61927902891	4	1.0915881646499128	2.0	2	2	0.5457940823249564	1.0
61927902892	2	0.5458054625599192	1.0	1	1	0.5458054625599192	1.0
61927902893	7	2.925375523343505	2.0	2	5	0.5850751046687009	0.4
61927902894	2	1.0916625065398473	0.0	0	2	0.5458312532699237	0.0
61927902895	3	1.0917350302857345	1.0	1	2	0.5458675151428672	0.5
61927902896	17	6.5521343546499375	5.0	5	12	0.5460111962208282	0.4166666666666667
61927902897	16	10.475275008596622	3.0	3	13	0.8057903852766632	0.23076923076923078
61927902898	3	2.0608032486328485	0.0	0	3	0.6869344162109495	0.0
61927902899	17	14.793245776678644	0.0	0	17	0.8701909280399203	0.0
61927902900	47	33.935010441028886	1.5	3	44	0.9426391789174691	0.06818181818181818
61927902901	3	1.9293301213237422	0.0	0	3	0.9646650606618711	0.0
61927902902	28	11.11984798160927	8.0	8	20	0.5559923990804635	0.4
61927902903	3	1.6389031581397786	0.0	0	3	0.5463010527132596	0.0
61927902904	4	1.0926634285072259	2.0	2	2	0.5463317142536129	1.0
61927902905	27	9.952249308490796	9.0	9	18	0.5529027393605997	0.5
61927902906	6	3.4751068639415807	0.0	0	6	0.5791844773235968	0.0
61927902907	2	1.0931208937511299	0.0	0	2	0.5465604468755649	0.0
61927902908	2	0.5465948064311257	1.0	1	1	0.5465948064311257	1.0
61927902909	20	8.440218531487073	5.0	5	15	0.5626812354324715	0.3333333333333333
61927902910	14	4.997544933157449	5.0	5	9	0.5552827703508276	0.5555555555555556
61927902911	7	3.521572531641346	1.0	1	6	0.5869287552735577	0.16666666666666666
61927902912	2	1.0936441825434131	0.0	0	2	0.5468220912717066	0.0
61927902913	5	2.763662216175509	1.0	1	4	0.6909155540438773	0.25
61927902914	29	11.685847502764002	8.0	8	21	0.5564689287030478	0.38095238095238093
61927902915	2	1.0942589509167435	0.0	0	2	0.5471294754583718	0.0
61927902916	3	1.0943224512810628	1.0	1	2	0.5471612256405314	0.5
61927902917	27	11.140239106817209	7.0	7	20	0.5570119553408605	0.35
61927902918	4	1.642197567814837	1.0	1	3	0.5473991892716124	0.3333333333333333
61927902919	6	2.73665223857134	1.0	1	5	0.547330447714268	0.2
61927902920	1	0.5473180910686132	0.0	0	1	0.5473180910686132	0.0
61927902921	3	1.094716988539329	1.0	1	2	0.5473584942696645	0.5
61927902922	22	7.704065238779384	8.0	8	14	0.5502903741985274	0.5714285714285714
61927902923	3	1.7422836367338768	0.0	0	3	0.5807612122446256	0.0
61927902924	1	0.5474547885655036	0.0	0	1	0.5474547885655036	0.0
61927902925	2	0.9405628846027003	0.0	0	2	0.9405628846027003	0.0
61927902926	1	0.5474626335203744	0.0	0	1	0.5474626335203744	0.0
61927902927	2	0.5474826331048948	1.0	1	1	0.5474826331048948	1.0
61927902928	3	0.6959939586440241	0.5	1	2	0.6959939586440241	0.5
61927902929	4	1.0951239497819185	2.0	2	2	0.5475619748909593	1.0
61927902930	14	6.259440603540324	3.0	3	11	0.5690400548673021	0.2727272727272727
61927902931	5	2.933011189632862	0.0	0	5	0.5866022379265724	0.0
61927902932	4	1.0952165067816604	2.0	2	2	0.5476082533908302	1.0
61927902933	4	1.095452091113124	2.0	2	2	0.547726045556562	1.0
61927902934	21	7.706661582148277	7.0	7	14	0.5504758272963055	0.5
61927902935	9	2.9711623835962735	2.0	3	6	0.5942324767192547	0.5
61927902936	2	0.5478550496105855	1.0	1	1	0.5478550496105855	1.0
61927902937	1	0.5478628945654563	0.0	0	1	0.5478628945654563	0.0
61927902938	3	1.0957944409033658	1.0	1	2	0.5478972204516829	0.5
61927902939	2	0.5479144759854652	1.0	1	1	0.5479144759854652	1.0
61927902940	4	1.096006389362214	2.0	2	2	0.548003194681107	1.0
61927902941	28	11.19582838969305	8.0	8	20	0.5597914194846525	0.4
61927902942	11	2.751773978298161	4.0	5	6	0.5503547956596322	0.8333333333333334
62751053438	2	0.06769455328150253	1.0	1	1	0.06769455328150253	1.0
62751053439	2	0.8205504956344847	0.0	0	2	0.41027524781724234	0.0
62751053440	12	1.2343204519959974	6.0	6	6	0.20572007533266623	1.0
62751053441	2	0.13555927137809964	0.0	0	2	0.06777963568904982	0.0
62751053442	4	0.13563267052667627	2.0	2	2	0.06781633526333813	1.0
63485147069	3	0.5987618371699147	0.5	1	2	0.5987618371699147	0.5
63485147070	3	1.3011767735330213	0.0	0	3	0.4337255911776738	0.0
63485147071	9	1.9466993564477129	4.0	4	5	0.38933987128954256	0.8
63485147072	4	0.7120237939838086	2.0	2	2	0.3560118969919043	1.0
63485147073	30	7.3695791235582755	10.0	10	20	0.36847895617791376	0.5
63485147074	3	0.7122616678299982	1.0	1	2	0.3561308339149991	0.5
63485147075	10	1.9480066020177291	5.0	5	5	0.38960132040354584	1.0
63485147076	3	1.0686260490817412	0.0	0	3	0.35620868302724706	0.0
63485147077	3	1.2195303552111392	1.0	1	2	0.6097651776055696	0.5
63485147078	55	14.94248853483414	14.0	14	41	0.36445093987400345	0.34146341463414637
63485147079	3	0.7126818611209322	1.0	1	2	0.3563409305604661	0.5
63485147080	2	1.1637132992893715	0.0	0	2	0.5818566496446858	0.0
63485147081	2	0.35636202439834835	1.0	1	1	0.35636202439834835	1.0
63485147082	1	0.35636229375302203	0.0	0	1	0.35636229375302203	0.0
63485147083	3	2.070485875764803	0.0	0	3	0.6901619585882677	0.0
63485147084	2	0.7848413384812847	0.0	0	2	0.39242066924064234	0.0
63485147085	6	1.4437299400211112	2.0	2	4	0.3609324850052778	0.5
63485147086	2	0.3564155586397414	1.0	1	1	0.3564155586397414	1.0
63485147087	2	0.3564971394365309	1.0	1	1	0.3564971394365309	1.0
63485147088	1	0.3566031978392907	0.0	0	1	0.3566031978392907	0.0
63485147089	3	1.3200335535116996	0.0	0	3	0.44001118450389987	0.0
63485147090	3	1.9261707930175322	0.0	0	3	0.642056931005844	0.0
63485147091	4	1.0705629112014745	1.0	1	3	0.3568543037338248	0.3333333333333333
63485147092	19	6.123941970633135	3.0	3	16	0.38274637316457094	0.1875
63485147093	4	0.7133386151540219	2.0	2	2	0.35666930757701093	1.0
63485147094	10	1.9502797197782118	5.0	5	5	0.39005594395564236	1.0
63485147095	42	10.152943994395809	14.0	14	28	0.3626051426569932	0.5
63485147096	3	1.6858809027435355	0.0	0	3	0.5619603009145119	0.0
63485147097	9	1.9512870389190904	4.0	4	5	0.39025740778381807	0.8
63485147098	6	2.4447971905768826	2.0	2	4	0.6111992976442207	0.5
63485147099	2	0.3570818747637465	1.0	1	1	0.3570818747637465	1.0
63485147100	2	1.2629617425119486	0.0	0	2	0.6314808712559743	0.0
63485147101	1	0.35709308665203826	0.0	0	1	0.35709308665203826	0.0
63485147102	3	0.7142004827711155	1.0	1	2	0.35710024138555774	0.5
63485147103	43	11.772480147466295	11.0	11	32	0.3678900046083217	0.34375
63485147104	3	0.7142726361543263	1.0	1	2	0.3571363180771632	0.5
63485147105	9	1.9561519546883486	4.0	4	5	0.3912303909376697	0.8
63485147106	2	0.7143519947750581	0.0	0	2	0.35717599738752903	0.0
63485147107	2	0.35720530654295835	1.0	1	1	0.35720530654295835	1.0
63485147108	4	1.3169548969302556	1.0	1	3	0.6584774484651278	0.3333333333333333
63485147109	1	0.357294462939945	0.0	0	1	0.357294462939945	0.0
63485147110	3	0.7146204067073758	1.0	1	2	0.3573102033536879	0.5
63485147111	3	0.7146647155511954	1.0	1	2	0.3573323577755977	0.5
63485147112	5	1.0893453156208843	2.0	2	3	0.36311510520696144	0.6666666666666666
63485147113	4	0.9029840356515152	2.0	2	2	0.4514920178257576	1.0
63485147114	10	2.4090618386816676	4.0	4	6	0.4015103064469446	0.6666666666666666
63485147115	2	0.35754765633320007	1.0	1	1	0.35754765633320007	1.0
63485147116	6	1.4478317403305123	2.0	2	4	0.3619579350826281	0.5
63485147117	37	9.131632719953258	12.0	12	25	0.3652653087981303	0.48
63485147118	4	0.7151880716821473	2.0	2	2	0.35759403584107363	1.0
63485147119	7	1.9583603263191467	2.0	2	5	0.39167206526382936	0.4
63485147120	4	0.7153338262299399	2.0	2	2	0.35766691311496995	1.0
63485147121	1	0.3577560021732882	0.0	0	1	0.3577560021732882	0.0
63485147122	8	4.778597495129478	1.0	1	7	0.6826567850184969	0.14285714285714285
63485147123	1	0.3577926680782423	0.0	0	1	0.3577926680782423	0.0
63485147124	2	0.35780472169988925	1.0	1	1	0.35780472169988925	1.0
63485147125	2	1.1420529748590744	0.0	0	2	0.5710264874295372	0.0
63485147126	2	0.3578589293279665	1.0	1	1	0.3578589293279665	1.0
63485147127	9	1.9595408068458644	4.0	4	5	0.3919081613691729	0.8
63485147128	2	0.3579351230312825	1.0	1	1	0.3579351230312825	1.0
63485147129	1	0.3580306766017689	0.0	0	1	0.3580306766017689	0.0
63485147130	2	0.35804188849006063	1.0	1	1	0.35804188849006063	1.0
63485147131	1	0.3580561306184313	0.0	0	1	0.3580561306184313	0.0
63485147132	44	10.547502397004072	15.0	15	29	0.363706979207037	0.5172413793103449
63485147133	2	0.35811074227851897	1.0	1	1	0.35811074227851897	1.0
63485147134	13	2.435966565947098	5.5	6	7	0.4059944276578497	0.8571428571428571
63485147135	2	0.7163023919671434	0.0	0	2	0.3581511959835717	0.0
63485147136	3	0.7163694949502227	1.0	1	2	0.35818474747511136	0.5
63485147137	3	0.7165743391795532	1.0	1	2	0.3582871695897766	0.5
63485147138	2	0.3582968663580289	1.0	1	1	0.3582968663580289	1.0
63485147139	1	0.3583080782463206	0.0	0	1	0.3583080782463206	0.0
63485147140	9	1.7920062401397252	4.0	4	5	0.35840124802794504	0.8
63485147141	2	0.7167854795743805	0.0	0	2	0.3583927397871903	0.0
63485147142	3	0.7168501583653969	1.0	1	2	0.35842507918269845	0.5
63485147143	48	12.503275773698576	14.0	14	34	0.3677434051087816	0.4117647058823529
63485147144	5	1.0924039389484737	2.0	2	3	0.3641346463161579	0.6666666666666666
63485147145	11	2.3222854259222965	5.0	5	6	0.3870475709870494	0.8333333333333334
63485147146	2	0.3586861848694928	1.0	1	1	0.3586861848694928	1.0
63485147147	4	1.163618688460243	0.5	1	3	0.5818093442301215	0.3333333333333333
63485147148	1	0.3587749709038031	0.0	0	1	0.3587749709038031	0.0
63485147149	2	0.358775273927811	1.0	1	1	0.358775273927811	1.0
63485147150	1	0.3587831188826818	0.0	0	1	0.3587831188826818	0.0
63485147151	3	0.7176349232071508	1.0	1	2	0.3588174616035754	0.5
63485147152	4	2.9406906933953594	0.0	0	4	0.7351726733488398	0.0
63485147153	1	0.3588184380142675	0.0	0	1	0.3588184380142675	0.0
63485147154	3	0.7177354598391004	1.0	1	2	0.3588677299195502	0.5
63485147155	9	1.7946003276632267	4.0	4	5	0.3589200655326453	0.8
63485147156	5	1.231895822231572	2.0	2	3	0.4106319407438573	0.6666666666666666
63485147157	3	0.718148683577853	1.0	1	2	0.3590743417889265	0.5
63485147158	1	0.3590737189062436	0.0	0	1	0.3590737189062436	0.0
63485147159	1	0.3590937521600982	0.0	0	1	0.3590937521600982	0.0
63485147160	1	0.35910159711496903	0.0	0	1	0.35910159711496903	0.0
63485147161	11	2.325143110663324	5.0	5	6	0.38752385177722065	0.8333333333333334
63485147162	25	6.71174241935782	7.0	7	18	0.3728745788532122	0.3888888888888889
63485147163	9	5.757001344450185	0.5	1	8	0.8224287634928835	0.125
63485147164	2	1.1607563573510946	0.0	0	2	0.5803781786755473	0.0
63485147165	7	5.39518700907796	0.0	0	7	0.8991978348463266	0.0
63485147166	8	4.098707949400513	0.5	1	7	0.8197415898801026	0.14285714285714285
63485147167	3	0.4198111439907124	0.5	1	2	0.4198111439907124	0.5
63485147168	4	1.1062898794324711	1.0	1	3	0.36876329314415707	0.3333333333333333
63485147169	3	1.5975401790474588	0.0	0	3	0.5325133930158196	0.0
63485147170	1	0.3593418614838877	0.0	0	1	0.3593418614838877	0.0
63485147171	1	0.3593519286148163	0.0	0	1	0.3593519286148163	0.0
63485147172	9	2.2498797583902044	3.0	3	6	0.37497995973170073	0.5
63485147173	9	1.871436441875938	4.0	4	5	0.3742872883751876	0.8
63485147174	2	0.7188812946209164	0.0	0	2	0.3594406473104582	0.0
63485147175	4	2.2910774883902247	1.0	1	3	0.763692496130075	0.3333333333333333
63485147176	1	0.35948923215972245	0.0	0	1	0.35948923215972245	0.0
63485147177	30	7.8427925588212535	9.0	9	21	0.3734663123248216	0.42857142857142855
63485147178	1	0.35959704136786114	0.0	0	1	0.35959704136786114	0.0
63485147179	5	1.0791888262792655	2.0	2	3	0.3597296087597552	0.6666666666666666
63485147180	10	2.3278364890534093	4.0	4	6	0.3879727481755682	0.6666666666666666
63485147181	2	0.7193240126964366	0.0	0	2	0.3596620063482183	0.0
63485147182	7	1.8081984626784018	3.0	3	4	0.45204961566960045	0.75
63485147183	28	7.4357285574235705	8.0	8	20	0.37178642787117855	0.4
63485147184	2	0.3598190569576383	1.0	1	1	0.3598190569576383	1.0
63485147185	4	1.0798601591340677	1.0	1	3	0.3599533863780226	0.3333333333333333
63485147186	10	2.32902323207629	4.0	4	6	0.38817053867938167	0.6666666666666666
63485147187	2	0.3599239032643665	1.0	1	1	0.3599239032643665	1.0
63485147188	31	7.800034962236643	10.0	10	21	0.371430236296983	0.47619047619047616
63485147189	2	0.8906396456342978	0.0	0	2	0.4453198228171489	0.0
63485147190	5	1.166741047837491	2.0	2	3	0.38891368261249704	0.6666666666666666
63485147191	9	1.971125347328643	4.0	4	5	0.3942250694657286	0.8
63485147192	4	1.4850474991815827	1.0	1	3	0.4950158330605276	0.3333333333333333
63485147193	30	7.397859983851514	10.0	10	20	0.36989299919257573	0.5
63485147194	2	0.36026345849986885	1.0	1	1	0.36026345849986885	1.0
63485147195	4	0.7206966777828219	2.0	2	2	0.36034833889141094	1.0
63485147196	11	2.3440997538872677	5.0	5	6	0.39068329231454463	0.8333333333333334
63485147197	20	5.094755943959009	6.0	6	14	0.36391113885421494	0.42857142857142855
63485147198	2	0.3605132176210346	1.0	1	1	0.3605132176210346	1.0
63485147199	3	0.7210523942987447	1.0	1	2	0.36052619714937234	0.5
63485147200	1	0.3605309276908288	0.0	0	1	0.3605309276908288	0.0
63485147201	1	0.36053119704550246	0.0	0	1	0.36053119704550246	0.0
63485147202	3	0.7210718551739177	1.0	1	2	0.36053592758695885	0.5
63485147203	12	3.5298873084017077	3.0	3	9	0.3922097009335231	0.3333333333333333
63485147204	11	2.352107567327642	5.0	5	6	0.3920179278879403	0.8333333333333334
63485147205	27	7.096847752354774	8.0	8	19	0.37351830275551445	0.42105263157894735
63485147206	13	3.4601930323535024	6.0	6	7	0.49431329033621463	0.8571428571428571
63485147207	3	1.08235243059092	0.0	0	3	0.3607841435303067	0.0
63485147208	31	7.818044083057263	10.0	10	21	0.37228781347891726	0.47619047619047616
63485147209	3	1.0830232247363751	0.0	0	3	0.36100774157879173	0.0
63485147210	6	2.7272608175109623	1.0	1	5	0.5454521635021925	0.2
63485147211	5	0.7400506191504372	1.0	2	3	0.3700253095752186	0.6666666666666666
63485147212	28	7.461801382779354	8.0	8	20	0.3730900691389677	0.4
63485147213	4	0.9184394384803521	0.5	1	3	0.45921971924017607	0.3333333333333333
63485147214	3	1.0834898143698495	0.0	0	3	0.3611632714566165	0.0
63485147215	3	0.7223717271597422	1.0	1	2	0.3611858635798711	0.5
63485147216	2	0.9612254856523688	0.0	0	2	0.4806127428261844	0.0
63485147217	17	5.2844719017116715	6.0	6	11	0.48040653651924287	0.5454545454545454
63485147218	3	1.0837940504737662	0.0	0	3	0.3612646834912554	0.0
63485147219	28	7.466659497343102	8.0	8	20	0.3733329748671551	0.4
63485147220	1	0.3613819201129727	0.0	0	1	0.3613819201129727	0.0
63485147221	3	0.3806309815045256	0.5	1	2	0.3806309815045256	0.5
63485147222	2	0.3613930983319303	1.0	1	1	0.3613930983319303	1.0
63485147223	2	0.36139336768660396	1.0	1	1	0.36139336768660396	1.0
63485147224	1	0.3614075088069719	0.0	0	1	0.3614075088069719	0.0
63485147225	2	0.36141872069526365	1.0	1	1	0.36141872069526365	1.0
63485147226	9	1.996067590111007	4.0	4	5	0.3992135180222014	0.8
63485147227	3	1.08457265382736	0.0	0	3	0.3615242179424533	0.0
63485147228	2	0.3615453173918912	1.0	1	1	0.3615453173918912	1.0
63485147229	22	5.110580396360116	8.0	8	14	0.36504145688286543	0.5714285714285714
63485147230	1	0.3616656515923558	0.0	0	1	0.3616656515923558	0.0
63485147231	4	0.4620120518035029	1.0	2	2	0.4620120518035029	1.0
63485147232	3	0.3737012601455384	0.5	1	2	0.3737012601455384	0.5
63485147233	1	0.36167245279786614	0.0	0	1	0.36167245279786614	0.0
63485147234	3	1.0852559729651408	0.0	0	3	0.36175199098838023	0.0
63485147235	25	6.411536736762066	8.0	8	17	0.3771492198095333	0.47058823529411764
63485147236	5	1.5445963294297893	0.5	1	4	0.7722981647148947	0.25
63485147237	2	0.9420119454084068	0.0	0	2	0.9420119454084068	0.0
63485147238	5	1.395122599641617	0.5	1	4	0.6975612998208085	0.25
63485147239	2	0.9420133931897778	0.0	0	2	0.9420133931897778	0.0
63485147240	11	2.360348237883408	5.0	5	6	0.39339137298056803	0.8333333333333334
63485147241	3	1.0858470044578534	0.0	0	3	0.36194900148595116	0.0
63485147242	7	3.2336963235477567	1.0	1	6	0.5389493872579595	0.16666666666666666
63485147243	42	10.324291613201167	14.0	14	28	0.36872470047147027	0.5
63485147244	2	0.36218106176043413	1.0	1	1	0.36218106176043413	1.0
63485147245	9	1.9998491950520758	4.0	4	5	0.39996983901041516	0.8
63485147246	5	2.996461184627915	1.0	1	4	0.7491152961569788	0.25
63485147247	4	1.167326793244733	0.5	1	3	0.5836633966223665	0.3333333333333333
63485147248	1	0.36237344833610696	0.0	0	1	0.36237344833610696	0.0
63485147249	2	0.36237371769078064	1.0	1	1	0.36237371769078064	1.0
63485147250	2	1.3361984365509982	0.0	0	2	0.6680992182754991	0.0
63485147251	4	1.4397485412508435	1.0	1	3	0.47991618041694784	0.3333333333333333
63485147252	9	1.8272199193706986	3.5	4	5	0.45680497984267465	0.8
63485147253	4	0.7250484392293938	2.0	2	2	0.3625242196146969	1.0
63485147254	2	0.362526812153431	1.0	1	1	0.362526812153431	1.0
63485147255	51	13.322969014414753	15.0	15	36	0.370082472622632	0.4166666666666667
63485147256	1	0.3626320288228356	0.0	0	1	0.3626320288228356	0.0
63485147257	3	1.8349583444680628	0.0	0	3	0.6116527814893543	0.0
63485147258	1	0.362644957847172	0.0	0	1	0.362644957847172	0.0
63485147259	6	1.4641243311544672	2.0	2	4	0.3660310827886168	0.5
63485147260	8	3.163633267281956	1.5	2	6	0.6327266534563912	0.3333333333333333
63485147261	10	2.3650273662664985	4.0	4	6	0.3941712277110831	0.6666666666666666
63485147262	2	0.3627494001218897	1.0	1	1	0.3627494001218897	1.0
63485147263	1	0.3628296004759766	0.0	0	1	0.3628296004759766	0.0
63485147264	2	0.3628408123642684	1.0	1	1	0.3628408123642684	1.0
63485147265	1	0.36285532384731267	0.0	0	1	0.36285532384731267	0.0
63485147266	3	0.725735192639264	1.0	1	2	0.362867596319632	0.5
63485147267	36	9.678251263265	10.0	10	26	0.3722404332025	0.38461538461538464
63485147268	4	2.076854868031866	1.0	1	3	0.692284956010622	0.3333333333333333
63485147269	11	2.366401344456918	5.0	5	6	0.394400224076153	0.8333333333333334
63485147270	4	0.7259464003727599	2.0	2	2	0.36297320018637996	1.0
63485147271	5	3.990331783343087	0.0	0	5	0.7980663566686175	0.0
63485147272	6	3.5625609057212513	1.0	1	5	0.7125121811442503	0.2
63485147273	2	1.06364201120805	0.0	0	2	0.531821005604025	0.0
63485147274	5	1.413037816689128	0.5	1	4	0.706518908344564	0.25
63485147275	2	0.9461575158522801	0.0	0	2	0.9461575158522801	0.0
63485147276	3	0.7344989836406429	0.5	1	2	0.7344989836406429	0.5
63485147277	2	0.9461917912345054	0.0	0	2	0.9461917912345054	0.0
63485147278	2	0.36317929018107603	1.0	1	1	0.36317929018107603	1.0
63485147279	13	2.2000752374942243	3.0	5	8	0.44001504749884485	0.625
63485147280	2	0.7264342690254549	0.0	0	2	0.36321713451272747	0.0
63485147281	3	0.7265020117258844	1.0	1	2	0.3632510058629422	0.5
63485147282	46	11.20153837208163	16.0	16	30	0.37338461240272103	0.5333333333333333
63485147283	5	1.1045615651688314	2.0	2	3	0.36818718838961045	0.6666666666666666
63485147284	8	2.014996254118223	3.0	3	5	0.4029992508236446	0.6
63485147285	2	0.7267964163842118	0.0	0	2	0.3633982081921059	0.0
63485147286	18	4.881121358522619	5.0	5	13	0.37547087373250915	0.38461538461538464
63485147287	5	1.1033117258136422	2.0	2	3	0.3677705752712141	0.6666666666666666
63485147288	7	2.3794798943065727	1.0	1	6	0.39657998238442876	0.16666666666666666
63485147289	4	0.727206037504204	2.0	2	2	0.363603018752102	1.0
63485147290	9	2.72661123504606	4.0	4	5	0.5453222470092121	0.8
63485147291	2	0.6610250218034192	0.0	0	2	0.6610250218034192	0.0
63485147292	6	3.801294734045424	1.0	1	5	0.7602589468090848	0.2
63485147293	4	0.7843755232424969	0.5	1	3	0.39218776162124847	0.3333333333333333
63485147294	3	0.661044449009258	0.5	1	2	0.661044449009258	0.5
63485147295	2	0.36373311705948735	1.0	1	1	0.36373311705948735	1.0
63485147296	6	1.4679879209243365	2.0	2	4	0.3669969802310841	0.5
63485147297	8	1.8191063168822388	3.0	3	5	0.36382126337644777	0.6
63485147298	4	0.7276859601940255	2.0	2	2	0.36384298009701277	1.0
63485147299	44	11.536785851957218	13.0	13	31	0.37215438232120057	0.41935483870967744
63485147300	3	0.7743729364275497	1.0	1	2	0.38718646821377484	0.5
63485147301	7	1.82040056608925	2.0	2	5	0.36408011321785	0.4
63485147302	11	5.815865138424566	1.5	2	9	0.7269831423030707	0.2222222222222222
63485147303	46	11.953300700790157	14.0	14	32	0.3735406468996924	0.4375
63485147304	3	0.7739562447473733	1.0	1	2	0.3869781223736867	0.5
63485147305	2	0.7284701863264322	0.0	0	2	0.3642350931632161	0.0
63485147306	5	2.290718909980894	1.0	1	4	0.5726797274952234	0.25
63485147307	9	1.8221981381733587	4.0	4	5	0.36443962763467175	0.8
63485147308	3	0.7734647398065838	1.0	1	2	0.3867323699032919	0.5
63485147309	1	0.36454545708595887	0.0	0	1	0.36454545708595887	0.0
63485147310	2	0.8790326813749357	0.0	0	2	0.8790326813749357	0.0
63485147311	3	0.7291581181629998	1.0	1	2	0.3645790590814999	0.5
63485147312	3	0.45456224023898223	0.5	1	2	0.45456224023898223	0.5
63485147313	1	0.36458060787087354	0.0	0	1	0.36458060787087354	0.0
63485147314	1	0.3645809108948814	0.0	0	1	0.3645809108948814	0.0
63485147315	3	0.7734171650373458	1.0	1	2	0.3867085825186729	0.5
63485147316	11	2.3854715880144846	5.0	5	6	0.3975785980024141	0.8333333333333334
63485147317	4	0.7294083486548444	2.0	2	2	0.3647041743274222	1.0
63485147318	31	7.8857254042904215	10.0	10	21	0.37551073353763914	0.47619047619047616
63485147319	3	0.869079386465271	1.0	1	2	0.4345396932326355	0.5
63485147320	1	0.3648572014514042	0.0	0	1	0.3648572014514042	0.0
63485147321	9	2.021954762757959	4.0	4	5	0.4043909525515918	0.8
63485147322	2	0.7298611338612933	0.0	0	2	0.3649305669306466	0.0
63485147323	3	0.7732989856742707	1.0	1	2	0.38664949283713534	0.5
63485147324	27	6.251695478245451	10.0	10	17	0.3677467928379677	0.5882352941176471
63485147325	2	0.810946688413914	0.0	0	2	0.810946688413914	0.0
64002966662	2	1.6029997962668587	0.0	0	2	0.8014998981334294	0.0
64002966663	2	1.6274482782630408	0.0	0	2	0.8137241391315204	0.0
64002966664	13	10.56756820910488	0.0	0	13	0.812889862238837	0.0
64002966665	5	4.19688860335797	0.0	0	5	0.839377720671594	0.0
64002966666	3	2.404778223967536	0.0	0	3	0.801592741322512	0.0
64002966667	2	1.6032341011636224	0.0	0	2	0.8016170505818112	0.0
64002966668	22	17.897240114574053	0.0	0	22	0.8135109142988206	0.0
64002966669	3	2.405179495092644	0.0	0	3	0.8017264983642147	0.0
64002966670	2	1.6034587429614677	0.0	0	2	0.8017293714807339	0.0
64002966671	1	0.8017567446494461	0.0	0	1	0.8017567446494461	0.0
64002966672	3	2.4055076027545153	0.0	0	3	0.8018358675848384	0.0
64002966673	2	1.6392506256688204	0.0	0	2	0.8196253128344102	0.0
64002966674	2	1.6039451638327917	0.0	0	2	0.8019725819163959	0.0
64002966675	1	0.8019973457117069	0.0	0	1	0.8019973457117069	0.0
64002966676	1	0.8020085575999987	0.0	0	1	0.8020085575999987	0.0
64002966677	1	0.8020228333977035	0.0	0	1	0.8020228333977035	0.0
64002966678	2	0.8020340452859952	1.0	1	1	0.8020340452859952	1.0
64002966679	18	14.58427308092623	0.0	0	18	0.8102373933847906	0.0
64002966680	3	2.595084674503563	0.0	0	3	0.865028224834521	0.0
64002966681	3	2.406423576991683	0.0	0	3	0.802141192330561	0.0
64002966682	21	17.06747051753167	0.0	0	21	0.812736691311032	0.0
64002966683	1	0.8022478792275595	0.0	0	1	0.8022478792275595	0.0
64002966684	5	4.200404489913458	0.0	0	5	0.8400808979826916	0.0
64002966685	4	3.389274943345453	0.0	0	4	0.8473187358363633	0.0
64002966686	3	1.604746224632303	1.0	1	2	0.8023731123161515	0.5
64002966687	22	17.912567742279563	0.0	0	22	0.814207624649071	0.0
64002966688	1	0.8024661575212394	0.0	0	1	0.8024661575212394	0.0
64002966689	1	0.8024678746572841	0.0	0	1	0.8024678746572841	0.0
64002966690	1	0.8024806690042836	0.0	0	1	0.8024806690042836	0.0
64002966691	1	0.8024823861403283	0.0	0	1	0.8024823861403283	0.0
64002966692	1	0.8025023857248488	0.0	0	1	0.8025023857248488	0.0
64002966693	1	0.8025135976131405	0.0	0	1	0.8025135976131405	0.0
64002966694	7	4.23696430279546	0.5	1	6	0.847392860559092	0.16666666666666666
64002966695	3	2.4077799797896455	0.0	0	3	0.8025933265965485	0.0
64002966696	16	12.953592243555073	0.0	0	16	0.8095995152221921	0.0
64002966697	3	2.7653108687944092	0.0	0	3	0.9217702895981364	0.0
64002966698	1	0.8027446365844858	0.0	0	1	0.8027446365844858	0.0
64002966699	1	0.8027591817368642	0.0	0	1	0.8027591817368642	0.0
64002966700	2	1.6055503493412275	0.0	0	2	0.8027751746706138	0.0
64002966701	1	0.8027713363665139	0.0	0	1	0.8027713363665139	0.0
64002966702	5	4.123840255574489	0.0	0	5	0.8247680511148978	0.0
64002966703	6	5.005898934692165	0.0	0	6	0.8343164891153608	0.0
64002966704	2	1.6057054302945963	0.0	0	2	0.8028527151472982	0.0
64002966705	2	1.6057804455712148	0.0	0	2	0.8028902227856074	0.0
64002966706	1	0.8029821737373335	0.0	0	1	0.8029821737373335	0.0
64002966707	3	2.7054888118990927	0.0	0	3	0.9018296039663642	0.0
64002966708	1	0.8030134188794799	0.0	0	1	0.8030134188794799	0.0
64002966709	1	0.8030212638343507	0.0	0	1	0.8030212638343507	0.0
64002966710	1	0.8031361772720075	0.0	0	1	0.8031361772720075	0.0
64002966711	2	1.6062931958618907	0.0	0	2	0.8031465979309453	0.0
64002966712	2	1.6090064391591596	0.0	0	2	0.8045032195795798	0.0
64002966713	6	3.5386784389024646	2.0	2	4	0.8846696097256161	0.5
64002966714	1	0.8031910919561032	0.0	0	1	0.8031910919561032	0.0
64002966715	2	1.6085066515621542	0.0	0	2	0.8042533257810771	0.0
64002966716	2	1.6085110959142699	0.0	0	2	0.8042555479571349	0.0
64002966717	2	1.6064555493914487	0.0	0	2	0.8032277746957244	0.0
64002966718	2	1.6066082734914229	0.0	0	2	0.8033041367457114	0.0
64002966719	1	0.8046253719240917	0.0	0	1	0.8046253719240917	0.0
64002966720	2	1.60958265614482	0.0	0	2	0.80479132807241	0.0
64002966721	1	0.8047047305448234	0.0	0	1	0.8047047305448234	0.0
64002966722	1	0.8047724059065844	0.0	0	1	0.8047724059065844	0.0
64002966723	1	0.8047836177948761	0.0	0	1	0.8047836177948761	0.0
64002966724	2	1.6096041035107116	0.0	0	2	0.8048020517553558	0.0
64002966725	1	0.8048284316787089	0.0	0	1	0.8048284316787089	0.0
64002966726	1	0.8048400475990112	0.0	0	1	0.8048400475990112	0.0
64002966727	1	0.804851259487303	0.0	0	1	0.804851259487303	0.0
64002966728	1	0.8048641548423051	0.0	0	1	0.8048641548423051	0.0
64002966729	1	0.8048988005872066	0.0	0	1	0.8048988005872066	0.0
64002966730	1	0.8049080259847801	0.0	0	1	0.8049080259847801	0.0
64002966731	2	1.7671619751199108	0.0	0	2	0.8835809875599554	0.0
64002966732	3	2.5528722181091386	0.0	0	3	0.8509574060363795	0.0
64002966733	1	0.8050742514877721	0.0	0	1	0.8050742514877721	0.0
64002966734	1	0.805082096442643	0.0	0	1	0.805082096442643	0.0
64002966735	1	0.8051075841286395	0.0	0	1	0.8051075841286395	0.0
64002966736	1	0.8051227353290338	0.0	0	1	0.8051227353290338	0.0
64002966737	1	0.805147212935004	0.0	0	1	0.805147212935004	0.0
64002966738	2	1.610318869806644	0.0	0	2	0.805159434903322	0.0
64002966739	1	0.8051762695704268	0.0	0	1	0.8051762695704268	0.0
64002966740	1	0.8052255951450437	0.0	0	1	0.8052255951450437	0.0
64002966741	2	1.6105013912673936	0.0	0	2	0.8052506956336968	0.0
64002966742	2	1.6105001455020278	0.0	0	2	0.8052500727510139	0.0
64002966743	1	0.8052773449117235	0.0	0	1	0.8052773449117235	0.0
64002966744	1	0.8052885568000153	0.0	0	1	0.8052885568000153	0.0
64002966745	6	5.784875344508835	0.0	0	6	0.9641458907514725	0.0
64002966746	1	0.8053758950529546	0.0	0	1	0.8053758950529546	0.0
64002966747	1	0.8054315841317371	0.0	0	1	0.8054315841317371	0.0
64002966748	2	1.7564834427513745	0.0	0	2	0.8782417213756872	0.0
64002966749	2	1.7723899473199496	0.0	0	2	0.8861949736599748	0.0
64002966750	1	0.8054754216048777	0.0	0	1	0.8054754216048777	0.0
64002966751	1	0.8055027611042559	0.0	0	1	0.8055027611042559	0.0
64002966752	1	0.8055143770245581	0.0	0	1	0.8055143770245581	0.0
64002966753	1	0.8055222219794289	0.0	0	1	0.8055222219794289	0.0
64002966754	1	0.8055334338677207	0.0	0	1	0.8055334338677207	0.0
64002966755	1	0.8055499318414833	0.0	0	1	0.8055499318414833	0.0
64002966756	1	0.8055895269785136	0.0	0	1	0.8055895269785136	0.0
64002966757	2	1.6112745738581795	0.0	0	2	0.8056372869290898	0.0
64002966758	1	0.8056373711024253	0.0	0	1	0.8056373711024253	0.0
64002966759	1	0.8056619833857324	0.0	0	1	0.8056619833857324	0.0
64002966760	2	1.6114287120701904	0.0	0	2	0.8057143560350952	0.0
64002966761	1	0.805701780538768	0.0	0	1	0.805701780538768	0.0
64002966762	3	2.737276905728928	0.0	0	3	0.9124256352429759	0.0
64002966763	1	0.8057480085346375	0.0	0	1	0.8057480085346375	0.0
64002966764	2	1.611616889979087	0.0	0	2	0.8058084449895435	0.0
64002966765	1	0.8058104651495961	0.0	0	1	0.8058104651495961	0.0
64002966766	1	0.8072478426963319	0.0	0	1	0.8072478426963319	0.0
64002966767	1	0.8073596248859073	0.0	0	1	0.8073596248859073	0.0
64002966768	1	0.807359894240581	0.0	0	1	0.807359894240581	0.0
64002966769	1	0.8073601635952546	0.0	0	1	0.8073601635952546	0.0
64002966770	1	0.8073917454307431	0.0	0	1	0.8073917454307431	0.0
64002966771	3	2.4312025235031314	0.0	0	3	0.8104008411677105	0.0
64002966772	1	0.8074470641468492	0.0	0	1	0.8074470641468492	0.0
64002966773	1	0.8075229211568231	0.0	0	1	0.8075229211568231	0.0
64002966774	35	26.816057895362917	2.0	2	33	0.8126078150109974	0.06060606060606061
64002966775	1	0.8076450061626665	0.0	0	1	0.8076450061626665	0.0
64002966776	4	3.2397680829324185	0.0	0	4	0.8099420207331046	0.0
64002966777	1	0.8076929849639151	0.0	0	1	0.8076929849639151	0.0
64002966778	5	4.2248601434778275	0.0	0	5	0.8449720286955655	0.0
64002966779	1	0.8078988392732717	0.0	0	1	0.8078988392732717	0.0
64002966780	34	27.614234108335193	0.0	0	34	0.8121833561275057	0.0
64002966781	2	1.6158750506765567	0.0	0	2	0.8079375253382783	0.0
64002966782	5	4.22598227504836	0.0	0	5	0.845196455009672	0.0
64002966783	2	1.6160131286161497	0.0	0	2	0.8080065643080748	0.0
64002966784	5	4.226827139651678	0.0	0	5	0.8453654279303355	0.0
64002966785	2	1.61628228127382	0.0	0	2	0.80814114063691	0.0
64002966786	1	0.8081712578563603	0.0	0	1	0.8081712578563603	0.0
64002966787	21	17.09867690627437	0.0	0	21	0.814222709822589	0.0
64002966788	5	4.227766446737453	0.0	0	5	0.8455532893474906	0.0
64002966789	2	1.6166985689219857	0.0	0	2	0.8083492844609929	0.0
64002966790	2	1.6167713283532124	0.0	0	2	0.8083856641766062	0.0
64966366569	8	0.08439865070816542	4.0	4	4	0.021099662677041355	1.0
64966366570	3	0.4538387535854895	1.0	1	2	0.22691937679274474	0.5
64966366571	12	0.2652423011952917	0.0	0	12	0.02210352509960764	0.0
64966366572	4	0.08469150657711925	0.0	0	4	0.021172876644279814	0.0
64966366573	9	0.10698208727448322	4.0	4	5	0.021396417454896642	0.8
64966366574	4	1.4286310617722184	0.0	0	4	0.3571577654430546	0.0
64966366575	2	0.8076389793518431	0.0	0	2	0.8076389793518431	0.0
64966366576	4	0.6187093015609743	0.3333333333333333	1	3	0.6187093015609743	0.3333333333333333
64966366577	5	0.6999650882673583	1.5	2	3	0.34998254413367913	0.6666666666666666
64966366578	2	0.8726239256241713	0.0	0	2	0.8726239256241713	0.0
64966366579	5	1.5544511752062253	0.5	1	4	0.7772255876031127	0.25
64966366580	2	0.8726326459817316	0.0	0	2	0.8726326459817316	0.0
64966366581	4	0.8940469149176261	1.0	1	3	0.44702345745881306	0.3333333333333333
64966366582	5	0.10739069831444915	0.0	0	5	0.02147813966288983	0.0
64966366583	8	0.08679344944248128	4.0	4	4	0.02169836236062032	1.0
64966366584	2	0.04293732349061974	0.0	0	2	0.02146866174530987	0.0
64966366585	24	0.4239147624441607	5.0	5	19	0.022311303286534773	0.2631578947368421
64966366586	11	1.6601690463198122	5.0	5	6	0.27669484105330205	0.8333333333333334
64966366587	10	1.4215779086340192	4.0	4	6	0.2369296514390032	0.6666666666666666
64966366588	6	0.7232300594967438	3.0	3	3	0.2410766864989146	1.0
64966366589	10	1.7180720185038583	5.0	5	5	0.3436144037007717	1.0
64966366590	8	1.5416884437114557	0.6666666666666666	2	6	0.5138961479038185	0.3333333333333333
64966366591	15	2.80273594989626	6.5	7	8	0.40039084998518	0.875
64966366592	3	0.4783146087503839	0.5	1	2	0.4783146087503839	0.5
64966366593	6	4.011518548587728	0.0	0	6	0.8023037097175456	0.0
64966366594	2	0.4783218813265731	0.0	0	2	0.4783218813265731	0.0
64966366595	5	0.27165317811411127	0.5	1	4	0.09055105937137042	0.25
64966366596	1	0.021714835082382294	0.0	0	1	0.021714835082382294	0.0
64966366597	1	0.021726046970674043	0.0	0	1	0.021726046970674043	0.0
64966366598	5	0.10898955398805352	0.0	0	5	0.021797910797610703	0.0
64966366599	8	0.08781652583176974	4.0	4	4	0.021954131457942436	1.0
64966366600	2	0.04358232692607025	0.0	0	2	0.021791163463035126	0.0
64966366601	4	0.08808325429737705	0.0	0	4	0.022020813574344263	0.0
65133124524	2	0.14103178395250174	0.0	0	2	0.07051589197625087	0.0
65133124525	13	2.1708555751552234	5.0	5	8	0.27135694689440293	0.625
65133124526	3	0.14245145142944338	1.0	1	2	0.07122572571472169	0.5
65133124527	34	3.168653802713931	5.0	5	29	0.10926392423151486	0.1724137931034483
65133124528	2	0.07067354863368663	1.0	1	1	0.07067354863368663	1.0
65156578873	27	7.2540481229733365	5.0	5	22	0.32972946013515164	0.22727272727272727
65156578874	1	0.2990823052598537	0.0	0	1	0.2990823052598537	0.0
65156578875	1	0.29909476291351117	0.0	0	1	0.29909476291351117	0.0
65156578876	1	0.29910883669521077	0.0	0	1	0.29910883669521077	0.0
65156578877	1	0.29913176551180737	0.0	0	1	0.29913176551180737	0.0
65156578878	3	0.9901181177481937	0.0	0	3	0.33003937258273125	0.0
65156578879	1	0.29915159674965675	0.0	0	1	0.29915159674965675	0.0
65156578880	7	2.450743801046288	1.0	1	6	0.40845730017438137	0.16666666666666666
65156578881	1	0.2991888687026266	0.0	0	1	0.2991888687026266	0.0
65156578882	1	0.29920008059091835	0.0	0	1	0.29920008059091835	0.0
65156578883	1	0.29924371604805383	0.0	0	1	0.29924371604805383	0.0
65156578884	4	0.5985822786105757	2.0	2	2	0.29929113930528783	1.0
65156578885	3	0.6000250769201192	1.0	1	2	0.3000125384600596	0.5
65156578886	3	0.6367416542222002	1.0	1	2	0.3183708271111001	0.5
65156578887	3	0.6367551892945524	1.0	1	2	0.3183775946472762	0.5
65156578888	2	0.2996450208424963	1.0	1	1	0.2996450208424963	1.0
65156578889	2	0.29985188523187917	1.0	1	1	0.29985188523187917	1.0
65156578890	25	6.638830870079232	5.0	5	20	0.3319415435039616	0.25
65156578891	2	0.6016156162681738	0.0	0	2	0.3008078081340869	0.0
65156578892	1	0.3007807548240496	0.0	0	1	0.3007807548240496	0.0
65156578893	1	0.3008109898861697	0.0	0	1	0.3008109898861697	0.0
65156578894	1	0.30082388524117193	0.0	0	1	0.30082388524117193	0.0
65156578895	1	0.3008590696954208	0.0	0	1	0.3008590696954208	0.0
65156578896	2	1.0443593814902903	0.0	0	2	0.5221796907451451	0.0
65156578897	2	0.6018149050573596	0.0	0	2	0.3009074525286798	0.0
65156578898	1	0.3008967456804012	0.0	0	1	0.3008967456804012	0.0
65156578899	1	0.3009518960498363	0.0	0	1	0.3009518960498363	0.0
65156578900	1	0.30096351197013854	0.0	0	1	0.30096351197013854	0.0
65156578901	1	0.30097176095701983	0.0	0	1	0.30097176095701983	0.0
65156578902	1	0.30098381457866685	0.0	0	1	0.30098381457866685	0.0
65156578903	2	1.0652408668816542	0.0	0	2	0.5326204334408271	0.0
65156578904	6	2.7224810851572547	1.0	1	5	0.5444962170314509	0.2
65156578905	4	1.4395113744606718	0.0	0	4	0.35987784361516795	0.0
65156578906	1	0.3010542171564988	0.0	0	1	0.3010542171564988	0.0
65156578907	2	0.602194493131237	0.0	0	2	0.3010972465656185	0.0
65156578908	1	0.30111074796863646	0.0	0	1	0.30111074796863646	0.0
65156578909	1	0.301134619526591	0.0	0	1	0.301134619526591	0.0
65156578910	3	1.6396900104802536	0.0	0	3	0.5465633368267512	0.0
65156578911	1	0.3011511175003536	0.0	0	1	0.3011511175003536	0.0
65156578912	1	0.30116232938864534	0.0	0	1	0.30116232938864534	0.0
65156578913	1	0.30117354127693713	0.0	0	1	0.30117354127693713	0.0
65156578914	1	0.30119899529359945	0.0	0	1	0.30119899529359945	0.0
65156578915	5	1.5801980140681926	1.0	1	4	0.39504950351704815	0.25
65156578916	2	1.045859282990653	0.0	0	2	0.5229296414953265	0.0
65156578917	2	0.6931490682499963	0.0	0	2	0.34657453412499817	0.0
65156578918	1	0.3012630680366	0.0	0	1	0.3012630680366	0.0
65156578919	5	1.8183338076781368	0.0	0	5	0.3636667615356274	0.0
65156578920	1	0.30130232648028826	0.0	0	1	0.30130232648028826	0.0
65156578921	2	0.7636915084962713	0.0	0	2	0.38184575424813566	0.0
65156578922	2	0.6931048267448451	0.0	0	2	0.34655241337242254	0.0
65156578923	1	0.3013483861294868	0.0	0	1	0.3013483861294868	0.0
65156578924	1	0.3013562310843576	0.0	0	1	0.3013562310843576	0.0
65156578925	2	1.1591223508925756	0.0	0	2	0.5795611754462878	0.0
65156578926	7	4.3098032946588285	0.0	0	7	0.6156861849512613	0.0
65156578927	2	1.066361719017487	0.0	0	2	0.5331808595087435	0.0
65156578928	14	4.674916484058227	4.0	4	10	0.4674916484058227	0.4
65156578929	3	1.7075122715464128	0.0	0	3	0.5691707571821376	0.0
65156578930	1	0.3015057565975818	0.0	0	1	0.3015057565975818	0.0
65156578931	6	4.74916389784091	0.0	0	6	0.7915273163068184	0.0
65156578932	3	1.1010168239939258	0.0	0	3	0.36700560799797527	0.0
65156578933	2	0.6031628905217693	0.0	0	2	0.30158144526088465	0.0
65156578934	2	0.6032169634725097	0.0	0	2	0.3016084817362549	0.0
65156578935	1	0.3016294577314673	0.0	0	1	0.3016294577314673	0.0
65156578936	2	0.6032859182689707	0.0	0	2	0.30164295913448536	0.0
65156578937	1	0.3016942375304863	0.0	0	1	0.3016942375304863	0.0
66146203465	1	0.6100734876989256	0.0	0	1	0.6100734876989256	0.0
66146203466	7	1.3424060516991954	0.6666666666666666	2	5	0.6712030258495977	0.4
66146203467	4	0.0	4.0	4	0	0.0	inf
66146203468	3	0.012590445511620179	2.0	2	1	0.012590445511620179	2.0
66146203469	3	0.27266426822042117	2.0	2	1	0.13633213411021058	2.0
66146203470	4	0.14944857879551796	3.0	3	1	0.049816192931839316	3.0
66146203471	2	0.0	2.0	2	0	0.0	inf
66146203472	1	0.0	1.0	1	0	0.0	inf
66146203473	2	0.0	2.0	2	0	0.0	inf
66146203474	4	0.1095617979922774	3.0	3	1	0.0547808989961387	3.0
66146203475	10	1.1004430985389968	4.0	5	5	0.22008861970779936	1.0
66146203476	6	0.022563403312463173	5.0	5	1	0.005640850828115793	5.0
66146203477	3	0.1805528484475592	2.0	2	1	0.1805528484475592	2.0
66146203478	19	0.1252641653875406	13.0	13	6	0.006592850809870558	2.1666666666666665
66146203479	1	0.0	1.0	1	0	0.0	inf
66146203480	1	0.0	1.0	1	0	0.0	inf
66146203481	8	0.15711144990691608	6.0	6	2	0.03142228998138322	3.0
66230261225	2	1.7844829284186252	0.0	0	2	0.8922414642093126	0.0
66230261226	2	1.784462154439418	0.0	0	2	0.892231077219709	0.0
66230261227	2	1.7845037697365007	0.0	0	2	0.8922518848682504	0.0
66230261228	2	1.805144822412275	0.0	0	2	0.9025724112061375	0.0
66230261229	1	0.8923091059017394	0.0	0	1	0.8923091059017394	0.0
66230261230	1	0.8923207218220416	0.0	0	1	0.8923207218220416	0.0
66230261231	1	0.8923308899609729	0.0	0	1	0.8923308899609729	0.0
66230261232	1	0.8923526066815379	0.0	0	1	0.8923526066815379	0.0
66230261233	2	1.784799756853536	0.0	0	2	0.892399878426768	0.0
66396341961	1	0.9814364462529516	0.0	0	1	0.9814364462529516	0.0
66396341962	1	0.9814493416079538	0.0	0	1	0.9814493416079538	0.0
66396341963	2	1.9634089419758518	0.0	0	2	0.9817044709879259	0.0
66396341964	1	0.9815764770139287	0.0	0	1	0.9815764770139287	0.0
66396341965	1	0.9815993048225227	0.0	0	1	0.9815993048225227	0.0
66396341966	1	0.9816890672675251	0.0	0	1	0.9816890672675251	0.0
66396341967	2	1.9635322727470612	0.0	0	2	0.9817661363735306	0.0
66396341968	1	0.981786135958051	0.0	0	1	0.981786135958051	0.0
66396341969	2	1.9636507888034784	0.0	0	2	0.9818253944017392	0.0
66396341970	1	0.9818894671447398	0.0	0	1	0.9818894671447398	0.0
66396341971	1	0.9819010830650421	0.0	0	1	0.9819010830650421	0.0
66396341972	1	0.9819278165164044	0.0	0	1	0.9819278165164044	0.0
66396341973	1	0.9819420923141091	0.0	0	1	0.9819420923141091	0.0
66396341974	1	0.9819503413009905	0.0	0	1	0.9819503413009905	0.0
66396341975	1	0.9819672433067637	0.0	0	1	0.9819672433067637	0.0
66396341976	1	0.9819788592270658	0.0	0	1	0.9819788592270658	0.0
66396341977	1	0.9819900711153576	0.0	0	1	0.9819900711153576	0.0
66396341978	2	1.9640039464500014	0.0	0	2	0.9820019732250007	0.0
66396341979	2	1.9640619923821785	0.0	0	2	0.9820309961910892	0.0
66396341980	2	1.9641722931210488	0.0	0	2	0.9820861465605244	0.0
66396341981	1	0.9821001024995542	0.0	0	1	0.9821001024995542	0.0
66396341982	1	0.9821258595402244	0.0	0	1	0.9821258595402244	0.0
66396341983	1	0.9821370714285161	0.0	0	1	0.9821370714285161	0.0
66396341984	2	1.964316229524794	0.0	0	2	0.982158114762397	0.0
66396341985	2	1.9644190220021356	0.0	0	2	0.9822095110010678	0.0
66396341986	1	0.9823143741424631	0.0	0	1	0.9823143741424631	0.0
66396341987	2	1.9646797236569193	0.0	0	2	0.9823398618284597	0.0
66396341988	1	0.9823713426559455	0.0	0	1	0.9823713426559455	0.0
66396341989	2	1.9649249037486325	0.0	0	2	0.9824624518743162	0.0
66396341990	2	1.9651471886930834	0.0	0	2	0.9825735943465417	0.0
66396341991	1	0.9825937622777332	0.0	0	1	0.9825937622777332	0.0
66396341992	1	0.9826153443209614	0.0	0	1	0.9826153443209614	0.0
66396341993	1	0.9826273979426084	0.0	0	1	0.9826273979426084	0.0
66396341994	1	0.9826377680975449	0.0	0	1	0.9826377680975449	0.0
66396341995	1	0.9826517072019076	0.0	0	1	0.9826517072019076	0.0
66396341996	1	0.9826835583920698	0.0	0	1	0.9826835583920698	0.0
66396341997	2	1.9654459030261897	0.0	0	2	0.9827229515130949	0.0
66396341998	1	0.982893048989521	0.0	0	1	0.982893048989521	0.0
66396341999	1	0.9829353376732881	0.0	0	1	0.9829353376732881	0.0
66396342000	1	0.9830462107908398	0.0	0	1	0.9830462107908398	0.0
66396342001	1	0.9831569492310547	0.0	0	1	0.9831569492310547	0.0
66396342002	1	0.9832158705659212	0.0	0	1	0.9832158705659212	0.0
66396342003	1	0.9832633106578224	0.0	0	1	0.9832633106578224	0.0
66396342004	1	0.9833222319926889	0.0	0	1	0.9833222319926889	0.0
66396342005	1	0.9833681232952164	0.0	0	1	0.9833681232952164	0.0
66396342006	1	0.9834212198352646	0.0	0	1	0.9834212198352646	0.0
66396342007	1	0.9834771109300524	0.0	0	1	0.9834771109300524	0.0
66396342008	1	0.9835877820315989	0.0	0	1	0.9835877820315989	0.0
66396342009	1	0.9836481511478364	0.0	0	1	0.9836481511478364	0.0
66396342010	1	0.9836889247115641	0.0	0	1	0.9836889247115641	0.0
66396342011	1	0.9837504049158305	0.0	0	1	0.9837504049158305	0.0
66396342012	1	0.9838648133134743	0.0	0	1	0.9838648133134743	0.0
66396342013	1	0.9839111086480122	0.0	0	1	0.9839111086480122	0.0
66396342014	1	0.9842105973758054	0.0	0	1	0.9842105973758054	0.0
66396342015	21	20.7010619341679	0.0	0	21	0.9857648540079952	0.0
66396342016	2	1.9795061833227234	0.0	0	2	0.9897530916613617	0.0
66396342017	15	14.861024974666346	0.0	0	15	0.9907349983110898	0.0
66396342018	14	13.905221935288415	0.0	0	14	0.9932301382348868	0.0
66396342019	15	14.872058752180129	0.0	0	15	0.9914705834786752	0.0
66396342020	1	0.9913599438018409	0.0	0	1	0.9913599438018409	0.0
66396342021	1	0.9932920248761162	0.0	0	1	0.9932920248761162	0.0
66396342022	1	0.9932981190256082	0.0	0	1	0.9932981190256082	0.0
66396342023	1	0.9933032367644079	0.0	0	1	0.9933032367644079	0.0
66396342024	1	0.9933093309138998	0.0	0	1	0.9933093309138998	0.0
66396342025	1	0.9936790202035197	0.0	0	1	0.9936790202035197	0.0
66396342026	1	0.9938943019264549	0.0	0	1	0.9938943019264549	0.0
66396342027	30	29.828270032235356	0.0	0	30	0.9942756677411785	0.0
66396342028	1	0.9952880776853895	0.0	0	1	0.9952880776853895	0.0
66396342029	1	0.9952992895736813	0.0	0	1	0.9952992895736813	0.0
66396342030	1	0.9953172353288149	0.0	0	1	0.9953172353288149	0.0
66396342031	1	0.9953175046834886	0.0	0	1	0.9953175046834886	0.0
66396342032	1	0.9953348780599406	0.0	0	1	0.9953348780599406	0.0
66396342033	18	17.91947106688053	0.0	0	18	0.9955261703822517	0.0
66396342034	1	0.995379792951776	0.0	0	1	0.995379792951776	0.0
66396342035	4	3.9816816936833335	0.0	0	4	0.9954204234208334	0.0
66396342036	2	1.990934161401428	0.0	0	2	0.995467080700714	0.0
66396342037	1	0.9955871287118379	0.0	0	1	0.9955871287118379	0.0
66396342038	1	0.9955949736667087	0.0	0	1	0.9955949736667087	0.0
66396342039	3	2.9874053121522697	0.0	0	3	0.9958017707174233	0.0
66396342040	4	3.9826917063709484	0.0	0	4	0.9956729265927371	0.0
66396342041	22	21.911382043006043	0.0	0	22	0.9959719110457292	0.0
66396342042	17	16.938892851956577	0.0	0	17	0.9964054618797986	0.0
66396342043	1	0.9961143568162237	0.0	0	1	0.9961143568162237	0.0
66396342044	2	1.9923148397893553	0.0	0	2	0.9961574198946777	0.0
66396342045	1	0.9961969476930395	0.0	0	1	0.9961969476930395	0.0
66396342046	2	1.992766008867762	0.0	0	2	0.996383004433881	0.0
66396342047	5	4.982123401678828	0.0	0	5	0.9964246803357655	0.0
66396342048	1	0.9964519928996761	0.0	0	1	0.9964519928996761	0.0
66396342049	3	2.9903146793213082	0.0	0	3	0.9967715597737694	0.0
66396342050	19	18.938509762271945	0.0	0	19	0.9967636716985234	0.0
66396342051	2	1.993221756975621	0.0	0	2	0.9966108784878105	0.0
66396342052	2	1.9932566720751963	0.0	0	2	0.9966283360375982	0.0
66396342053	2	1.9933478823015698	0.0	0	2	0.9966739411507849	0.0
66396342054	2	1.993387006067921	0.0	0	2	0.9966935030339605	0.0
66396342055	22	21.939495432030917	0.0	0	22	0.9972497923650416	0.0
66396342056	2	1.9945384299592162	0.0	0	2	0.9972692149796081	0.0
66396342057	2	1.9942858426139767	0.0	0	2	0.9971429213069883	0.0
66396342058	4	3.9886929621697758	0.0	0	4	0.9971732405424439	0.0
66396342059	2	1.994417052009391	0.0	0	2	0.9972085260046955	0.0
66396342060	1	0.9973185068848907	0.0	0	1	0.9973185068848907	0.0
66396342061	1	0.9973187762395643	0.0	0	1	0.9973187762395643	0.0
66396342062	3	2.9926966500392904	0.0	0	3	0.9975655500130968	0.0
66396342063	4	3.9897180587191166	0.0	0	4	0.9974295146797791	0.0
66396342064	21	20.952504926076113	0.0	0	21	0.9977383298131483	0.0
66396342065	4	3.9906649414050888	0.0	0	4	0.9976662353512722	0.0
66396342066	1	0.9977032463669021	0.0	0	1	0.9977032463669021	0.0
66396342067	1	0.9977943892546071	0.0	0	1	0.9977943892546071	0.0
66396342068	1	0.9978056011428988	0.0	0	1	0.9978056011428988	0.0
66396342069	1	0.9978222337939983	0.0	0	1	0.9978222337939983	0.0
66396342070	1	0.99783344568229	0.0	0	1	0.99783344568229	0.0
66396342071	1	0.9978534789361446	0.0	0	1	0.9978534789361446	0.0
66396342072	1	0.9978646908244364	0.0	0	1	0.9978646908244364	0.0
66396342073	1	0.9979105147882955	0.0	0	1	0.9979105147882955	0.0
66396342074	5	4.989797350001179	0.0	0	5	0.9979594700002359	0.0
66396342075	2	1.9959075934348434	0.0	0	2	0.9979537967174217	0.0
66396342076	1	0.9981464694824354	0.0	0	1	0.9981464694824354	0.0
66396342077	4	3.9927333159442444	0.0	0	4	0.9981833289860611	0.0
66396342078	2	1.9963736106896366	0.0	0	2	0.9981868053448183	0.0
66396342079	6	5.990451848188878	0.0	0	6	0.9984086413648131	0.0
66396342080	2	1.9969191549118324	0.0	0	2	0.9984595774559162	0.0
66396342081	5	4.992387834905921	0.0	0	5	0.9984775669811843	0.0
66396342082	1	0.9985117480892737	0.0	0	1	0.9985117480892737	0.0
66396342083	7	6.990371715173459	0.0	0	7	0.9986245307390655	0.0
66396342084	9	8.987801734893251	0.0	0	9	0.9986446372103612	0.0
66396342085	5	4.993379093774382	0.0	0	5	0.9986758187548764	0.0
66396342086	2	1.997398774577646	0.0	0	2	0.998699387288823	0.0
66396342087	15	14.982878907869154	0.0	0	15	0.9988585938579436	0.0
66396342088	2	1.9976114974311812	0.0	0	2	0.9988057487155906	0.0
66396342089	1	0.9987980384380567	0.0	0	1	0.9987980384380567	0.0
66396342090	1	0.9988108327850563	0.0	0	1	0.9988108327850563	0.0
66396342091	1	0.9988114051637379	0.0	0	1	0.9988114051637379	0.0
66396342092	3	2.9966613151504564	0.0	0	3	0.9988871050501521	0.0
66396342093	1	0.9989142313104136	0.0	0	1	0.9989142313104136	0.0
66396342094	15	14.986558326380896	0.0	0	15	0.9991038884253931	0.0
66396342095	2	1.9981050562013576	0.0	0	2	0.9990525281006788	0.0
66396342096	1	0.999053689692709	0.0	0	1	0.999053689692709	0.0
66396342097	4	3.996474315668257	0.0	0	4	0.9991185789170642	0.0
66396342098	3	2.9974067205405195	0.0	0	3	0.9991355735135065	0.0
66396342099	13	12.991602093653476	0.0	0	13	0.9993540072041136	0.0
66396342100	4	3.9976872871024867	0.0	0	4	0.9994218217756217	0.0
66396342101	4	3.9975107587832266	0.0	0	4	0.9993776896958066	0.0
66396342102	3	2.9981478162558037	0.0	0	3	0.9993826054186012	0.0
66396342103	2	1.9988171289505534	0.0	0	2	0.9994085644752767	0.0
66396342104	1	0.9995424337480935	0.0	0	1	0.9995424337480935	0.0
66396342105	1	0.9995536456363853	0.0	0	1	0.9995536456363853	0.0
66396342106	14	13.995053941135296	0.0	0	14	0.9996467100810926	0.0
66396342107	3	2.999023791323931	0.0	0	3	0.999674597107977	0.0
66396342108	1	0.9997033394962805	0.0	0	1	0.9997033394962805	0.0
66396342109	16	15.998212663393494	0.0	0	16	0.9998882914620933	0.0
66396342110	4	3.999679770962334	0.0	0	4	0.9999199427405835	0.0
66396342111	3	2.999758557204384	0.0	0	3	0.9999195190681279	0.0
66396342112	2	1.999900944818756	0.0	0	2	0.999950472409378	0.0
66396342113	1	0.9999888217810424	0.0	0	1	0.9999888217810424	0.0
66450848550	4	2.1868916729911705	0.0	0	4	0.5467229182477926	0.0
66450848551	2	0.5572743488796883	0.0	0	2	0.27863717443984415	0.0
66450848552	1	0.2786656250272511	0.0	0	1	0.2786656250272511	0.0
66450848553	2	0.5573976123122291	0.0	0	2	0.27869880615611453	0.0
66450848554	2	1.245416854471407	0.0	0	2	0.6227084272357035	0.0
66450848555	10	4.710547595694729	2.0	2	8	0.5888184494618411	0.25
66450848556	3	1.5827664118896925	0.0	0	3	0.5275888039632308	0.0
66450848557	1	0.2787963967213206	0.0	0	1	0.2787963967213206	0.0
66450848558	2	1.1694743243886145	0.0	0	2	0.5847371621943073	0.0
66450848559	1	0.2788507053574005	0.0	0	1	0.2788507053574005	0.0
66450848560	6	1.6406704278230988	2.0	2	4	0.4101676069557747	0.5
66450848561	2	0.5578138662910606	0.0	0	2	0.2789069331455303	0.0
66450848562	2	0.601973453952152	0.0	0	2	0.300986726976076	0.0
66450848563	4	1.632838671331306	0.0	0	4	0.4082096678328265	0.0
66450848564	1	0.2789631609336601	0.0	0	1	0.2789631609336601	0.0
66450848565	2	0.9484351453035471	0.0	0	2	0.47421757265177356	0.0
66450848566	1	0.27898952402234606	0.0	0	1	0.27898952402234606	0.0
66450848567	2	0.6030888853251769	0.0	0	2	0.30154444266258845	0.0
66450848568	1	0.2790185133191004	0.0	0	1	0.2790185133191004	0.0
66450848569	1	0.27907881509666954	0.0	0	1	0.27907881509666954	0.0
66450848570	10	2.761137319133808	4.0	4	6	0.460189553188968	0.6666666666666666
66450848571	1	0.27910362939598193	0.0	0	1	0.27910362939598193	0.0
66450848572	3	1.2051955014941271	0.0	0	3	0.40173183383137573	0.0
66450848573	4	1.1170924832975693	0.0	0	4	0.2792731208243923	0.0
66450848574	1	0.27926264966145314	0.0	0	1	0.27926264966145314	0.0
66450848575	17	4.505632963786577	1.0	1	16	0.28160206023666107	0.0625
66450848576	33	11.828331478770291	10.0	10	23	0.5142752816856648	0.43478260869565216
66450848577	24	5.6362496442413965	4.0	4	20	0.28181248221206984	0.2
66450848578	1	0.27947796505372263	0.0	0	1	0.27947796505372263	0.0
66450848579	1	0.2795064493104638	0.0	0	1	0.2795064493104638	0.0
66450848580	3	0.8385909962745892	0.0	0	3	0.2795303320915297	0.0
66450848581	6	1.3978571892967744	1.0	1	5	0.2795714378593549	0.2
66450848582	1	0.2795838887791456	0.0	0	1	0.2795838887791456	0.0
66450848583	3	0.8436451000327705	0.0	0	3	0.28121503334425685	0.0
66450848584	2	0.27977183100270275	1.0	1	1	0.27977183100270275	1.0
66450848585	5	1.3146552477344158	2.0	2	3	0.4382184159114719	0.6666666666666666
66450848586	2	0.2798850273043149	1.0	1	1	0.2798850273043149	1.0
66450848587	6	1.8331549812584704	2.0	2	4	0.4582887453146176	0.5
66450848588	8	5.102700088688393	1.0	1	7	0.7289571555269133	0.14285714285714285
66450848589	3	1.6654127420989266	0.0	0	3	0.5551375806996423	0.0
66450848590	2	0.28021023940344403	1.0	1	1	0.28021023940344403	1.0
66450848591	5	0.8670577786313328	1.0	2	3	0.4335288893156664	0.6666666666666666
66450848592	6	2.082578688516808	2.0	2	4	0.520644672129202	0.5
66450848593	4	0.8017950940211107	2.0	2	2	0.40089754701055536	1.0
66450848594	7	2.7293591914268984	2.0	2	5	0.5458718382853797	0.4
66450848595	4	0.28242935155185495	1.0	2	2	0.28242935155185495	1.0
66450848596	6	0.9758618482572263	3.0	3	3	0.32528728275240876	1.0
66450848597	4	0.7999947947209313	2.0	2	2	0.39999739736046563	1.0
66450848598	5	1.6170339154907118	2.0	2	3	0.5390113051635707	0.6666666666666666
66450848599	2	0.2810695481511377	1.0	1	1	0.2810695481511377	1.0
66450848600	19	11.346554787060487	0.0	0	19	0.6674443992388522	0.0
66450848601	4	0.5625233307442737	2.0	2	2	0.28126166537213687	1.0
66450848602	28	20.295897287251645	1.0	1	27	0.7516998995278387	0.037037037037037035
66450848603	15	3.0982392722683167	4.0	4	11	0.28165811566075605	0.36363636363636365
66450848604	8	2.2630878004992288	0.0	0	8	0.2828859750624036	0.0
66450848605	1	0.28190323453549804	0.0	0	1	0.28190323453549804	0.0
66450848606	1	0.2819285538748235	0.0	0	1	0.2819285538748235	0.0
66450848607	1	0.28283446098106313	0.0	0	1	0.28283446098106313	0.0
66450848608	42	10.051486169462404	8.0	8	34	0.2956319461606589	0.23529411764705882
66450848609	4	0.5691030930434879	2.0	2	2	0.28455154652174397	1.0
66450848610	10	1.5771194584947512	5.0	5	5	0.31542389169895024	1.0
66450848611	4	1.3131304982654064	1.0	1	3	0.4377101660884688	0.3333333333333333
66450848612	47	9.35327111217925	15.0	15	32	0.29228972225560157	0.46875
66450848613	2	0.28479192873333237	1.0	1	1	0.28479192873333237	1.0
66450848614	2	0.2848361028998152	1.0	1	1	0.2848361028998152	1.0
66450848615	9	1.4244356943830492	4.0	4	5	0.2848871388766098	0.8
66450848616	2	0.5697489382122938	0.0	0	2	0.2848744691061469	0.0
66450848617	8	4.781764163350546	1.0	1	7	0.6831091661929352	0.14285714285714285
66450848618	3	1.4069152166098098	0.0	0	3	0.7034576083049049	0.0
66450848619	8	6.420964857396733	0.0	0	8	0.8026206071745916	0.0
66450848620	8	4.088877884254054	0.5	1	7	0.6814796473756757	0.14285714285714285
66450848621	2	0.5546319795309302	0.0	0	2	0.5546319795309302	0.0
66450848622	3	0.31167948463831574	0.5	1	2	0.31167948463831574	0.5
66450848623	4	0.57011260069109	2.0	2	2	0.285056300345545	1.0
66450848624	7	1.448556977789384	0.5	1	6	0.28971139555787684	0.16666666666666666
66450848625	2	0.5701921949971611	0.0	0	2	0.28509609749858056	0.0
66450848626	47	9.734880322519897	14.0	14	33	0.29499637340969387	0.42424242424242425
66450848627	10	2.2449701297451163	4.0	4	6	0.3741616882908527	0.6666666666666666
66450848628	13	3.5284421532387693	5.0	5	8	0.44105526915484616	0.625
66450848629	9	3.7253471535625	1.5	2	7	0.6208911922604167	0.2857142857142857
66450848630	3	0.3236971811056989	0.5	1	2	0.3236971811056989	0.5
66450848631	2	0.48555429000010336	0.0	0	2	0.48555429000010336	0.0
66450848632	2	1.2578273037223435	0.0	0	2	0.6289136518611718	0.0
66450848633	2	0.28526151493755164	1.0	1	1	0.28526151493755164	1.0
66450848634	2	1.2359788687218183	0.0	0	2	0.6179894343609091	0.0
66450848635	5	0.8767879468631914	2.0	2	3	0.29226264895439713	0.6666666666666666
66450848636	2	0.28531811308835775	1.0	1	1	0.28531811308835775	1.0
66450848637	5	2.780121806897143	0.0	0	5	0.5560243613794287	0.0
66450848638	8	3.7224603448473816	0.5	1	7	0.7444920689694763	0.14285714285714285
66450848639	15	2.9641382197548287	7.0	7	8	0.3705172774693536	0.875
66450848640	11	6.736741260290991	0.5	1	10	0.8420926575363739	0.1
66450848641	3	1.8077126815244275	0.0	0	3	0.6025708938414759	0.0
66450848642	3	0.5878430404324597	0.5	1	2	0.5878430404324597	0.5
66450848643	2	0.8094790084663898	0.0	0	2	0.8094790084663898	0.0
66450848644	2	0.28549602185032047	1.0	1	1	0.28549602185032047	1.0
66450848645	2	0.6695129599496199	0.0	0	2	0.33475647997480995	0.0
66450848646	6	1.1630761744781262	2.0	2	4	0.29076904361953154	0.5
66450848647	32	6.85877370830377	9.0	9	23	0.2982075525349465	0.391304347826087
66450848648	2	0.28554477504625575	1.0	1	1	0.28554477504625575	1.0
66450848649	13	1.9134686999936734	2.0	4	9	0.3826937399987347	0.4444444444444444
66450848650	3	0.5712347322616227	1.0	1	2	0.28561736613081135	0.5
66450848651	2	0.2856769271830279	1.0	1	1	0.2856769271830279	1.0
66450848652	3	1.939603645271073	0.0	0	3	0.646534548423691	0.0
66450848653	2	0.2857268924749947	1.0	1	1	0.2857268924749947	1.0
66450848654	25	9.58971916307328	3.0	5	20	0.59935744769208	0.25
66450848655	2	0.2857881033245875	1.0	1	1	0.2857881033245875	1.0
66450848656	47	9.405150000755876	15.0	15	32	0.29391093752362113	0.46875
66450848657	2	0.28590392583426805	1.0	1	1	0.28590392583426805	1.0
66450848658	1	0.285915979455915	0.0	0	1	0.285915979455915	0.0
66450848659	4	1.3032639355606652	0.0	0	4	0.3258159838901663	0.0
66450848660	2	0.5718900048440072	0.0	0	2	0.2859450024220036	0.0
66450848661	10	4.4631572805373025	2.0	2	8	0.5578946600671628	0.25
66450848662	10	2.1645239221797983	5.0	5	5	0.43290478443595964	1.0
66450848663	10	1.8988436839544445	5.0	5	5	0.3797687367908889	1.0
66450848664	8	1.2051910234726775	4.0	4	4	0.30129775586816937	1.0
66450848665	15	3.0499878167514165	6.0	7	8	0.43571254525020237	0.875
66450848666	12	2.1007766269636754	4.5	5	7	0.35012943782727923	0.7142857142857143
66450848667	11	5.261849812749681	2.0	2	9	0.584649979194409	0.2222222222222222
66450848668	2	0.28621812806111063	1.0	1	1	0.28621812806111063	1.0
66450848669	2	0.2862316631334629	1.0	1	1	0.2862316631334629	1.0
66450848670	47	9.748119037392385	14.0	14	33	0.29539754658764805	0.42424242424242425
66450848671	2	0.2863379572215621	1.0	1	1	0.2863379572215621	1.0
66450848672	1	0.2863526033819432	0.0	0	1	0.2863526033819432	0.0
66450848673	2	0.28635314209129054	1.0	1	1	0.28635314209129054	1.0
66450848674	6	1.1664060042927726	2.0	2	4	0.29160150107319316	0.5
66450848675	3	0.5728095143612673	1.0	1	2	0.28640475718063363	0.5
66450848676	16	2.286949560677477	2.5	5	11	0.3811582601129128	0.45454545454545453
66450848677	9	5.428274032152261	1.0	1	8	0.6785342540190327	0.125
66450848678	15	3.829472061135969	7.0	7	8	0.47868400764199615	0.875
66450848679	2	0.28662646974640293	1.0	1	1	0.28662646974640293	1.0
66450848680	1	0.28663768163469466	0.0	0	1	0.28663768163469466	0.0
66450848681	1	0.28665434795512834	0.0	0	1	0.28665434795512834	0.0
66450848682	2	0.28666555984342007	1.0	1	1	0.28666555984342007	1.0
66450848683	2	0.2866855594279405	1.0	1	1	0.2866855594279405	1.0
66450848684	2	0.7589568930504036	0.0	0	2	0.3794784465252018	0.0
66450848685	38	8.400926014432628	10.0	10	28	0.3000330719440224	0.35714285714285715
66450848686	11	1.8577975332970356	1.5	3	8	0.3715595066594071	0.375
66450848687	2	0.2868087555218129	1.0	1	1	0.2868087555218129	1.0
66450848688	3	0.4709894747304408	0.5	1	2	0.4709894747304408	0.5
66450848689	2	0.8282356895144636	0.0	0	2	0.8282356895144636	0.0
66450848690	3	0.5540941792556027	0.5	1	2	0.5540941792556027	0.5
66450848691	1	0.2869225242021066	0.0	0	1	0.2869225242021066	0.0
66450848692	2	0.2869227935567803	1.0	1	1	0.2869227935567803	1.0
66450848693	2	0.28695100845884786	1.0	1	1	0.28695100845884786	1.0
66450848694	1	0.2869622203471396	0.0	0	1	0.2869622203471396	0.0
66450848695	6	1.1682034080302102	2.0	2	4	0.29205085200755254	0.5
66450848696	8	1.601596997126356	1.5	2	6	0.3203193994252712	0.3333333333333333
66450848697	3	0.5741570957936666	1.0	1	2	0.2870785478968333	0.5
66450848698	5	3.821528791809275	0.0	0	5	0.764305758361855	0.0
66450848699	2	0.8078635538110202	0.0	0	2	0.8078635538110202	0.0
66450848700	8	4.320360112384197	0.5	1	7	0.8640720224768395	0.14285714285714285
66450848701	4	0.5940019023847215	2.0	2	2	0.29700095119236075	1.0
66450848702	18	3.5224194500740507	6.0	6	12	0.29353495417283754	0.5
66450848703	2	0.2872325851008415	1.0	1	1	0.2872325851008415	1.0
66450848704	13	1.9611291240178614	1.6666666666666665	4	9	0.39222582480357226	0.4444444444444444
66450848705	2	0.2873081054174733	1.0	1	1	0.2873081054174733	1.0
66450848706	28	5.654154996173984	9.0	9	19	0.29758710506178865	0.47368421052631576
66450848707	2	0.7759344191401816	0.0	0	2	0.3879672095700908	0.0
66450848708	2	0.2873925481076706	1.0	1	1	0.2873925481076706	1.0
66450848709	3	0.5749235108482763	1.0	1	2	0.28746175542413815	0.5
66450848710	7	1.6145849091283189	0.5	1	6	0.32291698182566375	0.16666666666666666
66450848711	2	0.57499000778334	0.0	0	2	0.28749500389167	0.0
66450848712	30	6.337747562617976	10.0	10	20	0.3168873781308988	0.5
66450848713	30	6.323774182873035	9.0	9	21	0.301132103946335	0.42857142857142855
66450848714	2	0.2876125435373952	1.0	1	1	0.2876125435373952	1.0
66450848715	2	0.2876220719589765	1.0	1	1	0.2876220719589765	1.0
66450848716	3	0.5752686215239233	1.0	1	2	0.28763431076196166	0.5
66450848717	1	0.2876231493776712	0.0	0	1	0.2876231493776712	0.0
66450848718	1	0.28763661711135496	0.0	0	1	0.28763661711135496	0.0
66450848719	1	0.28763833424739965	0.0	0	1	0.28763833424739965	0.0
66450848720	3	0.8631356378892736	0.0	0	3	0.28771187929642456	0.0
66450848721	3	0.606190201368544	1.0	1	2	0.303095100684272	0.5
66450848722	28	5.654878348150141	9.0	9	19	0.2976251762184285	0.47368421052631576
66450848723	9	1.6920938376465378	1.0	2	7	0.33841876752930755	0.2857142857142857
66450848724	3	0.8638211792031122	0.0	0	3	0.2879403930677041	0.0
66450848725	3	0.5759424122401229	1.0	1	2	0.28797120612006144	0.5
66450848726	17	4.037536459259416	4.0	4	13	0.31057972763533964	0.3076923076923077
66450848727	19	3.9355946713160876	6.0	6	13	0.302738051639699	0.46153846153846156
66450848728	10	1.8867142052974861	4.0	4	6	0.314452367549581	0.6666666666666666
66450848729	2	0.5761906225719149	0.0	0	2	0.28809531128595744	0.0
66450848730	2	0.28813020955086555	1.0	1	1	0.28813020955086555	1.0
66450848731	29	5.615253582105719	10.0	10	19	0.29553966221609046	0.5263157894736842
66450848732	9	1.4413802581946362	4.0	4	5	0.2882760516389272	0.8
66450848733	2	0.5765389991729801	0.0	0	2	0.28826949958649006	0.0
66450848734	2	0.28831138423824665	1.0	1	1	0.28831138423824665	1.0
66450848735	30	6.3457085420144645	9.0	9	21	0.30217659723878404	0.42857142857142855
66450848736	1	0.28844919282316595	0.0	0	1	0.28844919282316595	0.0
66450848737	3	0.576914142894742	1.0	1	2	0.288457071447371	0.5
66450848738	1	0.2884530984659342	0.0	0	1	0.2884530984659342	0.0
66450848739	3	0.28942957649667683	0.5	1	2	0.28942957649667683	0.5
66450848740	11	1.9032171957909159	5.0	5	6	0.3172028659651526	0.8333333333333334
66450848741	2	0.577049358940927	0.0	0	2	0.2885246794704635	0.0
66450848742	2	0.28855908953002557	1.0	1	1	0.28855908953002557	1.0
66450848743	24	5.098550545263084	7.0	7	17	0.299914737956652	0.4117647058823529
66450848744	5	0.8665832093656505	2.0	2	3	0.28886106978855014	0.6666666666666666
66450848745	10	2.216346549298959	3.0	3	7	0.316620935614137	0.42857142857142855
66450848746	1	0.2887811051198027	0.0	0	1	0.2887811051198027	0.0
66450848747	2	0.7698418184376439	0.0	0	2	0.7698418184376439	0.0
66450848748	4	1.4354650612140483	0.5	1	3	0.7177325306070241	0.3333333333333333
66450848749	10	5.496924794525312	0.5	1	9	0.7852749706464731	0.1111111111111111
66450848750	2	0.769841515413636	0.0	0	2	0.769841515413636	0.0
66450848751	3	0.46669592756271694	0.5	1	2	0.46669592756271694	0.5
66450848752	1	0.2889562193270261	0.0	0	1	0.2889562193270261	0.0
66450848753	4	0.5780384966413323	2.0	2	2	0.28901924832066617	1.0
66450848754	25	5.051405060036294	8.0	8	17	0.297141474119782	0.47058823529411764
66450848755	10	2.125739340701239	4.0	4	6	0.3542898901168732	0.6666666666666666
66450848756	8	3.183492248662713	2.0	2	6	0.5305820414437855	0.3333333333333333
66450848757	32	6.6493236150616	10.0	10	22	0.3022419825028	0.45454545454545453
66450848758	3	0.7158770809374094	0.5	1	2	0.7158770809374094	0.5
66450848759	3	0.3352576816838519	0.5	1	2	0.3352576816838519	0.5
66450848760	3	0.4597163419197655	0.5	1	2	0.4597163419197655	0.5
66450848761	1	0.28920705586688655	0.0	0	1	0.28920705586688655	0.0
66450848762	4	0.5785345132729061	2.0	2	2	0.28926725663645303	1.0
66450848763	4	0.5786107406455563	2.0	2	2	0.28930537032277814	1.0
66450848764	29	6.029051012643947	9.0	9	20	0.30145255063219734	0.45
66450848765	3	0.36349962022674476	0.5	1	2	0.36349962022674476	0.5
66450848766	3	0.9448462299621587	0.0	0	3	0.9448462299621587	0.0
66450848767	3	0.39399757250834216	0.5	1	2	0.39399757250834216	0.5
66450848768	13	2.668574393589197	6.0	6	7	0.38122491336988523	0.8571428571428571
66450848769	2	0.2895294734112763	1.0	1	1	0.2895294734112763	1.0
66450848770	16	3.7110521980065263	4.0	4	12	0.3092543498338772	0.3333333333333333
66450848771	1	0.2896210876696602	0.0	0	1	0.2896210876696602	0.0
66450848772	2	0.7588308350631234	0.0	0	2	0.7588308350631234	0.0
66450848773	2	0.7588451108608283	0.0	0	2	0.7588451108608283	0.0
66450848774	2	0.7588763223336404	0.0	0	2	0.7588763223336404	0.0
66450848775	3	0.5428433692135083	0.5	1	2	0.5428433692135083	0.5
66450848776	3	0.3929563146785806	0.5	1	2	0.3929563146785806	0.5
66450848777	1	0.28971990716556495	0.0	0	1	0.28971990716556495	0.0
66450848778	17	3.2793557117012075	6.0	6	11	0.2981232465182916	0.5454545454545454
66450848779	9	1.6202375526407413	4.0	4	5	0.3240475105281483	0.8
66450848780	3	0.8694102213432132	0.0	0	3	0.2898034071144044	0.0
66450848781	5	1.207525991800103	1.0	2	3	0.6037629959000514	0.6666666666666666
66450848782	30	6.375191498546982	9.0	9	21	0.3035805475498563	0.42857142857142855
66450848783	5	4.02468241653027	0.0	0	5	0.804936483306054	0.0
66450848784	4	0.7917931469235133	1.0	1	3	0.39589657346175666	0.3333333333333333
66450848785	1	0.2899653566119519	0.0	0	1	0.2899653566119519	0.0
66450848786	4	1.995009598622143	0.0	0	4	0.49875239965553575	0.0
66450848787	2	1.1933367242842126	0.0	0	2	0.5966683621421063	0.0
66450848788	1	0.2900033019516059	0.0	0	1	0.2900033019516059	0.0
66450848789	9	1.6214391101706744	4.0	4	5	0.32428782203413486	0.8
66450848790	3	0.8702295309218662	0.0	0	3	0.2900765103072887	0.0
66450848791	33	7.01100034386491	10.0	10	23	0.30482610190717	0.43478260869565216
66450848792	3	0.4353247947677316	0.5	1	2	0.4353247947677316	0.5
66450848793	9	1.6224249482763269	4.0	4	5	0.3244849896552654	0.8
66450848794	3	0.8708991803099578	0.0	0	3	0.29029972676998594	0.0
66450848795	3	0.40285977897361525	0.5	1	2	0.40285977897361525	0.5
66450848796	15	2.955318099957317	5.0	5	10	0.2955318099957317	0.5
66450848797	3	1.7134123846652747	0.0	0	3	0.8567061923326373	0.0
66450848798	6	2.2002930780865597	0.5	1	5	0.7334310260288532	0.2
66450848799	4	2.633828852781072	0.0	0	4	0.8779429509270239	0.0
66450848800	5	1.3497154958093969	0.5	1	4	0.6748577479046984	0.25
66450848801	4	1.0835285341041905	1.0	1	3	0.5417642670520952	0.3333333333333333
66450848802	2	0.8498251063269158	0.0	0	2	0.4249125531634579	0.0
66450848803	10	2.1874053660232042	3.0	3	7	0.31248648086045777	0.42857142857142855
66450848804	9	1.6234181936355059	4.0	4	5	0.32468363872710115	0.8
66450848805	3	0.871626909299561	0.0	0	3	0.2905423030998537	0.0
66450848806	4	1.9451756843973982	1.0	1	3	0.6483918947991327	0.3333333333333333
66450848807	30	6.018188982403968	10.0	10	20	0.3009094491201984	0.5
66450848808	9	1.6243993517037039	4.0	4	5	0.3248798703407408	0.8
66450848809	3	0.8722437315022782	0.0	0	3	0.2907479105007594	0.0
66450848810	5	0.7613071472555604	1.5	2	3	0.3806535736277802	0.6666666666666666
66450848811	30	6.022931611151378	10.0	10	20	0.30114658055756893	0.5
66450848812	3	0.6777835625434987	0.5	1	2	0.6777835625434987	0.5
66450848813	1	0.2908804554464306	0.0	0	1	0.2908804554464306	0.0
66450848814	1	0.29088102782511216	0.0	0	1	0.29088102782511216	0.0
66450848815	3	0.5817955566377628	1.0	1	2	0.2908977783188814	0.5
66450848816	1	0.29092287880753454	0.0	0	1	0.29092287880753454	0.0
66450848817	10	1.6255117191673154	5.0	5	5	0.3251023438334631	1.0
66450848818	3	0.8730541860460339	0.0	0	3	0.29101806201534464	0.0
66450848819	1	0.29104257329064914	0.0	0	1	0.29104257329064914	0.0
66450848820	26	5.051348562893492	9.0	9	17	0.2971381507584407	0.5294117647058824
66450848821	10	3.2458998410706417	0.6666666666666666	2	8	0.8114749602676604	0.25
66450848822	3	0.33503846064881415	0.5	1	2	0.33503846064881415	0.5
66450848823	5	1.2850144493631226	1.0	1	4	0.6425072246815613	0.25
66450848824	2	0.291167284504561	1.0	1	1	0.291167284504561	1.0
66450848825	3	2.1047347265546703	0.0	0	3	0.7015782421848901	0.0
66450848826	3	1.5922068891700127	0.0	0	3	0.5307356297233375	0.0
66450848827	1	0.2912134451617621	0.0	0	1	0.2912134451617621	0.0
66450848828	13	5.137814140359441	4.0	4	9	0.5708682378177157	0.4444444444444444
66450848829	3	0.8738519472507928	0.0	0	3	0.29128398241693093	0.0
66450848830	5	0.815367876027626	1.5	2	3	0.407683938013813	0.6666666666666666
66450848831	13	3.4580316294439273	2.0	2	11	0.31436651176762975	0.18181818181818182
66450848832	3	1.7948934528868543	0.0	0	3	0.5982978176289514	0.0
66450848833	21	4.619730526136881	6.0	6	15	0.3079820350757921	0.4
66450848834	12	3.06348571815865	4.0	4	8	0.38293571476983124	0.5
66450848835	3	0.8745918645393798	0.0	0	3	0.2915306215131266	0.0
66450848836	5	0.6114658830151576	1.5	2	3	0.3057329415075788	0.6666666666666666
66450848837	1	0.29167370496040534	0.0	0	1	0.29167370496040534	0.0
66450848838	10	1.6331366786083938	5.0	5	5	0.3266273357216788	1.0
66450848839	7	1.9841700594974172	1.5	2	5	0.6613900198324724	0.4
66450848840	1	0.2917622553093762	0.0	0	1	0.2917622553093762	0.0
66450848841	58	10.807388041803982	12.0	18	40	0.37266855316565456	0.45
66450848842	1	0.2918831955578566	0.0	0	1	0.2918831955578566	0.0
66450848843	4	0.666172793649371	0.5	1	3	0.3330863968246855	0.3333333333333333
66450848844	11	1.9264943889886192	5.0	5	6	0.32108239816476986	0.8333333333333334
66450848845	2	0.5839625149874832	0.0	0	2	0.2919812574937416	0.0
66450848846	6	0.6711738682061723	2.0	3	3	0.33558693410308615	1.0
66450848847	7	3.0424380072642934	2.0	2	5	0.6084876014528586	0.4
66450848848	1	0.2920913057126052	0.0	0	1	0.2920913057126052	0.0
66450848849	3	0.3690831405960354	0.5	1	2	0.3690831405960354	0.5
66450848850	3	0.6758691578696834	1.0	1	2	0.3379345789348417	0.5
66450848851	2	0.2921156486412387	1.0	1	1	0.2921156486412387	1.0
66450848852	1	0.2921268605295304	0.0	0	1	0.2921268605295304	0.0
66450848853	7	0.9876162505310917	2.0	3	4	0.32920541684369725	0.75
66450848854	67	14.199887867649348	10.0	17	50	0.4580608989564306	0.34
66450848855	10	1.6356836290640022	5.0	5	5	0.32713672581280046	1.0
66450848856	4	0.5844939180893111	2.0	2	2	0.29224695904465553	1.0
66450848857	2	0.8116843835264432	0.0	0	2	0.8116843835264432	0.0
66450848858	3	0.5797771810599086	0.5	1	2	0.5797771810599086	0.5
66450848859	3	0.47696238094986376	0.5	1	2	0.47696238094986376	0.5
66450848860	2	0.8116922621506483	0.0	0	2	0.8116922621506483	0.0
66450848861	3	0.507318383318434	0.5	1	2	0.507318383318434	0.5
66450848862	2	0.8117055278683267	0.0	0	2	0.8117055278683267	0.0
66450848863	3	0.5441423994659774	0.5	1	2	0.5441423994659774	0.5
66450848864	2	0.9619504874259011	0.0	0	2	0.48097524371295053	0.0
66450848865	7	1.2825989439882681	1.5	2	5	0.32064973599706703	0.4
66450848866	4	2.2071947865594845	1.0	1	3	0.7357315955198281	0.3333333333333333
66450848867	2	0.2925435185403724	1.0	1	1	0.2925435185403724	1.0
66450848868	2	0.29268035071459964	1.0	1	1	0.29268035071459964	1.0
66450848869	2	1.1039138345173098	0.0	0	2	0.5519569172586549	0.0
66450848870	44	10.463835717621624	8.0	9	35	0.3875494710230231	0.2571428571428571
66450848871	10	1.6382744506620854	5.0	5	5	0.3276548901324171	1.0
66450848872	2	0.292792772621525	1.0	1	1	0.292792772621525	1.0
66450848873	2	0.2929083594458661	1.0	1	1	0.2929083594458661	1.0
66450848874	1	0.29291176004862124	0.0	0	1	0.29291176004862124	0.0
66450848875	9	1.6393054056755791	4.0	4	5	0.3278610811351158	0.8
66450848876	2	0.5859638538822274	0.0	0	2	0.2929819269411137	0.0
66450848877	2	0.29301162329388647	1.0	1	1	0.29301162329388647	1.0
66450848878	63	13.944774143917616	9.5	14	49	0.44983142399734244	0.2857142857142857
66450848879	4	0.5862182593715141	2.0	2	2	0.29310912968575703	1.0
66450848880	11	1.9334190599474752	5.0	5	6	0.32223650999124587	0.8333333333333334
66450848881	2	0.5862992677896219	0.0	0	2	0.29314963389481097	0.0
66450848882	3	0.5863728016155354	1.0	1	2	0.2931864008077677	0.5
66450848883	2	0.7916935530329219	0.0	0	2	0.7916935530329219	0.0
66450848884	3	0.4383787380578659	0.5	1	2	0.4383787380578659	0.5
66450848885	3	0.3759918859598102	0.5	1	2	0.3759918859598102	0.5
66450848886	6	0.9781640563224663	1.5	2	4	0.3260546854408221	0.5
66450848887	6	2.826899892349038	1.0	1	5	0.5653799784698076	0.2
66450848888	9	1.6414011533834465	4.0	4	5	0.3282802306766893	0.8
66450848889	2	0.2934393921850176	1.0	1	1	0.2934393921850176	1.0
66450848890	59	12.984262111457145	7.5	12	47	0.41884716488571433	0.2553191489361702
66450848891	8	1.251017445193142	2.0	3	5	0.3127543612982855	0.6
66450848892	9	1.6425378974450262	4.0	4	5	0.3285075794890052	0.8
66450848893	5	1.3242094600256957	2.0	2	3	0.44140315334189856	0.6666666666666666
66450848894	10	3.290313665874349	3.0	4	6	0.6580627331748697	0.6666666666666666
66450848895	3	1.4621021846111817	0.0	0	3	0.7310510923055908	0.0
66450848896	6	1.1531869523114622	1.0	2	4	0.5765934761557311	0.5
66450848897	5	4.180917015966369	0.0	0	5	0.8361834031932738	0.0
66450848898	2	0.697588875005526	0.0	0	2	0.697588875005526	0.0
66450848899	3	0.3358816754547557	0.5	1	2	0.3358816754547557	0.5
66450848900	7	1.904155021425986	1.0	2	5	0.6347183404753286	0.4
66450848901	4	0.58778617292698	2.0	2	2	0.29389308646349	1.0
66450848902	8	1.1757282012020154	4.0	4	4	0.29393205030050384	1.0
66450848903	3	0.5879248905839229	1.0	1	2	0.29396244529196147	0.5
66450848904	1	0.29397833721770833	0.0	0	1	0.29397833721770833	0.0
66450848905	10	1.6451523549157243	5.0	5	5	0.32903047098314486	1.0
66450848906	2	0.5883562957631486	0.0	0	2	0.2941781478815743	0.0
66450848907	4	0.5884219846341913	2.0	2	2	0.29421099231709563	1.0
66450848908	9	6.558766035062503	0.0	0	9	0.8198457543828129	0.0
66450848909	7	5.387583193978765	0.0	0	7	0.7696547419969664	0.0
66450848910	3	1.7412006962683637	0.0	0	3	0.8706003481341819	0.0
66450848911	2	0.5886902282198381	0.0	0	2	0.29434511410991904	0.0
66450848912	4	0.6749401199308418	0.5	1	3	0.3374700599654209	0.3333333333333333
66450848913	1	0.29437880027879554	0.0	0	1	0.29437880027879554	0.0
66450848914	3	0.5887821455022297	1.0	1	2	0.29439107275111487	0.5
66450848915	3	0.6327456766302195	1.0	1	2	0.31637283831510976	0.5
66450848916	10	1.646546905069346	5.0	5	5	0.3293093810138692	1.0
66450848917	3	0.6325375664754709	1.0	1	2	0.31626878323773544	0.5
66450848918	2	0.29459556345243604	1.0	1	1	0.29459556345243604	1.0
66450848919	1	0.29460677534072777	0.0	0	1	0.29460677534072777	0.0
66450848920	3	0.5893175552548285	1.0	1	2	0.29465877762741427	0.5
66450848921	8	2.275228188020471	2.0	3	5	0.5688070470051177	0.6
66450848922	30	6.447930088455738	9.0	9	21	0.3070442899264637	0.42857142857142855
66450848923	3	0.5897195334359553	1.0	1	2	0.29485976671797764	0.5
66450848924	1	0.2948608441366723	0.0	0	1	0.2948608441366723	0.0
66450848925	2	0.853983067085778	0.0	0	2	0.426991533542889	0.0
66450848926	1	0.2948616522006933	0.0	0	1	0.2948616522006933	0.0
66450848927	6	1.1797274783887486	2.0	2	4	0.29493186959718715	0.5
66450848928	3	0.5899425591057587	1.0	1	2	0.29497127955287933	0.5
66450848929	17	3.583370271398739	5.0	5	12	0.29861418928322825	0.4166666666666667
66450848930	3	1.6299232100127752	0.0	0	3	0.8149616050063876	0.0
66450848931	12	2.877496585340298	3.0	3	9	0.31972184281558863	0.3333333333333333
66450848932	3	0.8855247013892001	0.0	0	3	0.2951749004630667	0.0
66450848933	3	0.6323556847320715	1.0	1	2	0.31617784236603574	0.5
66450848934	28	5.788062349007766	9.0	9	19	0.30463486047409294	0.47368421052631576
66450848935	6	1.7890595000097136	1.0	1	5	0.35781190000194274	0.2
66450848936	2	1.2393244557848746	0.0	0	2	0.6196622278924373	0.0
66450848937	2	0.2953301609862179	1.0	1	1	0.2953301609862179	1.0
66450848938	9	1.6529016215387042	3.0	3	6	0.33058032430774087	0.5
66450848939	3	0.8862013539988074	0.0	0	3	0.2954004513329358	0.0
66450848940	4	0.5908671863618187	2.0	2	2	0.29543359318090934	1.0
66450848941	16	3.754776171821616	4.0	4	12	0.31289801431846803	0.3333333333333333
66450848942	1	0.29554423061312163	0.0	0	1	0.29554423061312163	0.0
66450848943	2	0.29553971892233755	1.0	1	1	0.29553971892233755	1.0
66450848944	2	0.29556729410705507	1.0	1	1	0.29556729410705507	1.0
66450848945	2	0.7735870604977668	0.0	0	2	0.3867935302488834	0.0
66450848946	18	4.060313292481432	5.0	5	13	0.3123317917293409	0.38461538461538464
66450848947	11	1.9498530619751098	5.0	5	6	0.324975510329185	0.8333333333333334
66450848948	3	0.8869277025457081	0.0	0	3	0.29564256751523604	0.0
66450848949	31	6.425985291820705	10.0	10	21	0.30599929961050976	0.47619047619047616
66450848950	15	4.33658869780382	5.5	6	9	0.5420735872254775	0.6666666666666666
66450848951	6	5.138806341969259	0.0	0	6	0.8564677236615431	0.0
66450848952	4	2.6442045294883942	0.0	0	4	0.6610511323720986	0.0
66450848953	4	1.2160345019095058	1.0	1	3	0.4053448339698353	0.3333333333333333
66450848954	1	0.2958420695435384	0.0	0	1	0.2958420695435384	0.0
66450848955	10	2.4602986193855836	4.0	4	6	0.4100497698975973	0.6666666666666666
66450848956	2	0.5918191531172567	0.0	0	2	0.2959095765586284	0.0
66450848957	3	0.6322104015549577	1.0	1	2	0.31610520077747883	0.5
66450848958	30	6.0928997535640415	10.0	10	20	0.3046449876782021	0.5
66450848959	3	0.6118143942935597	0.5	1	2	0.6118143942935597	0.5
66450848960	1	0.2960616272719183	0.0	0	1	0.2960616272719183	0.0
66450848961	2	0.29606216598126567	1.0	1	1	0.29606216598126567	1.0
66450848962	1	0.29606243533593934	0.0	0	1	0.29606243533593934	0.0
66450848963	10	1.6569413019264885	5.0	5	5	0.3313882603852977	1.0
66450848964	2	0.5922861467827418	0.0	0	2	0.2961430733913709	0.0
66450848965	20	4.191127308904054	6.0	6	14	0.2993662363502896	0.42857142857142855
66450848966	4	1.175760119730846	1.0	1	3	0.587880059865423	0.3333333333333333
66450848967	8	3.8352088443145815	0.5	1	7	0.7670417688629163	0.14285714285714285
66450848968	2	0.8795046581018838	0.0	0	2	0.8795046581018838	0.0
66450848969	2	0.6013099323828862	0.0	0	2	0.6013099323828862	0.0
66450848970	6	1.3395644945692542	0.6666666666666666	2	4	0.6697822472846271	0.5
66450848971	5	0.42855106343413674	0.6666666666666666	2	3	0.42855106343413674	0.6666666666666666
66450848972	3	1.2026899979889307	0.0	0	3	0.6013449989944654	0.0
66450848973	2	0.8976894991777444	0.0	0	2	0.4488447495888722	0.0
66450848974	3	1.7590684732239739	0.0	0	3	0.8795342366119869	0.0
66450848975	3	0.59299023989973	1.0	1	2	0.296495119949865	0.5
66450848976	11	1.9548643383401767	5.0	5	6	0.3258107230566961	0.8333333333333334
66450848977	2	0.5928443170052662	0.0	0	2	0.2964221585026331	0.0
66450848978	9	1.6935175791129187	4.0	4	5	0.33870351582258373	0.8
66450848979	28	5.421888171548759	10.0	10	18	0.3012160095304866	0.5555555555555556
66450848980	2	0.2965259610600009	1.0	1	1	0.2965259610600009	1.0
66450848981	5	0.8901195554287644	2.0	2	3	0.2967065184762548	0.6666666666666666
66450848982	11	1.9560553236991676	5.0	5	6	0.32600922061652793	0.8333333333333334
66450848983	3	0.6322477071772616	1.0	1	2	0.3161238535886308	0.5
66450848984	20	4.668046492098127	5.0	5	15	0.31120309947320846	0.3333333333333333
66450848985	1	0.2966920182163219	0.0	0	1	0.2966920182163219	0.0
66450848986	1	0.29673925629221776	0.0	0	1	0.29673925629221776	0.0
66450848987	13	3.8405614603898632	5.0	5	8	0.4800701825487329	0.625
66450848988	2	0.29676161273013285	1.0	1	1	0.29676161273013285	1.0
66450848989	3	0.335998104012452	0.5	1	2	0.335998104012452	0.5
66450848990	1	0.29679827863508695	0.0	0	1	0.29679827863508695	0.0
66450848991	2	0.7351633132739297	0.0	0	2	0.36758165663696485	0.0
66450848992	2	0.6422529538696116	0.0	0	2	0.3211264769348058	0.0
66450848993	4	0.5937730855894341	2.0	2	2	0.29688654279471705	1.0
66450848994	14	3.180327465924361	4.0	4	10	0.3180327465924361	0.4
66450848995	9	1.6608162719313202	4.0	4	5	0.33216325438626404	0.8
66450848996	3	0.632308850688186	1.0	1	2	0.316154425344093	0.5
66450848997	31	8.823065460222596	8.0	8	23	0.3836115417488085	0.34782608695652173
66450848998	3	0.31384866516409404	0.5	1	2	0.31384866516409404	0.5
66450848999	2	0.7822769136412216	0.0	0	2	0.7822769136412216	0.0
66450849000	3	0.5314752215416939	0.5	1	2	0.5314752215416939	0.5
66450849001	3	0.5239364555961918	0.5	1	2	0.5239364555961918	0.5
66450849002	3	1.7446336215843596	0.0	0	3	0.8723168107921798	0.0
66450849003	3	0.4467396754754287	0.5	1	2	0.4467396754754287	0.5
66450849004	3	1.5646354080792328	0.0	0	3	0.7823177040396164	0.0
66450849005	2	0.9906821127655361	0.0	0	2	0.49534105638276804	0.0
66450849006	4	0.5942912903122517	2.0	2	2	0.29714564515612585	1.0
66450849007	12	2.3001326201405172	4.0	5	7	0.3833554366900862	0.7142857142857143
66450849008	4	0.5943997055684063	2.0	2	2	0.29719985278420313	1.0
66450849009	31	6.460294141364135	10.0	10	21	0.30763305435067306	0.47619047619047616
66450849010	6	1.5909321681768431	0.5	1	5	0.7954660840884216	0.2
66450849011	3	1.7368514263525232	0.0	0	3	0.8684257131762616	0.0
66450849012	5	1.1897177422273755	1.0	1	4	0.29742943555684387	0.25
66450849013	12	2.1372699765799474	4.5	5	7	0.35621166276332455	0.7142857142857143
66450849014	5	2.266580791907454	1.0	1	4	0.5666451979768635	0.25
66450849015	30	6.503569235615544	9.0	9	21	0.3096937731245497	0.42857142857142855
66450849016	10	1.8259612923192807	5.0	5	5	0.36519225846385617	1.0
66450849017	5	0.7370271802770966	1.5	2	3	0.3685135901385483	0.6666666666666666
66450849018	2	0.29758260577549617	1.0	1	1	0.29758260577549617	1.0
66450849019	1	0.29759381766378795	0.0	0	1	0.29759381766378795	0.0
66450849020	1	0.29760779043748486	0.0	0	1	0.29760779043748486	0.0
66450849021	2	0.29761563539235564	1.0	1	1	0.29761563539235564	1.0
66450849022	2	0.2976322680434551	1.0	1	1	0.2976322680434551	1.0
66450849023	1	0.2976434799317469	0.0	0	1	0.2976434799317469	0.0
66450849024	2	0.29767472507389325	1.0	1	1	0.29767472507389325	1.0
66450849025	3	0.8932542377823329	0.0	0	3	0.297751412594111	0.0
66450849026	3	0.6325518422731757	1.0	1	2	0.31627592113658787	0.5
66450849027	24	4.812270128933685	8.0	8	16	0.3007668830583553	0.5
66450849028	2	0.2978252269978095	1.0	1	1	0.2978252269978095	1.0
66450849029	7	3.2194237917683663	0.5	1	6	0.6438847583536733	0.16666666666666666
66450849030	5	1.5619183264778642	0.5	1	4	0.7809591632389321	0.25
66450849031	1	0.2978537112545507	0.0	0	1	0.2978537112545507	0.0
66450849032	8	4.987708740192165	0.5	1	7	0.8312847900320275	0.14285714285714285
66450849033	2	0.8891466126781137	0.0	0	2	0.8891466126781137	0.0
66450849034	3	0.6834117621192852	0.5	1	2	0.6834117621192852	0.5
66450849035	2	0.29789098320752055	1.0	1	1	0.29789098320752055	1.0
66450849036	1	0.29790216142647813	0.0	0	1	0.29790216142647813	0.0
66450849037	1	0.29790556202923324	0.0	0	1	0.29790556202923324	0.0
66450849038	24	5.489519157127274	9.0	10	14	0.4222707043944057	0.7142857142857143
66450849039	3	0.5959737469426982	1.0	1	2	0.2979868734713491	0.5
66450849040	2	0.5959431078485675	0.0	0	2	0.29797155392428376	0.0
66450849041	4	0.5960149582077705	2.0	2	2	0.29800747910388525	1.0
66450849042	12	3.20700886449598	2.0	2	10	0.32070088644959804	0.2
66450849043	2	0.2980638079000177	1.0	1	1	0.2980638079000177	1.0
66450849044	23	4.653594435428733	8.0	8	15	0.3102396290285822	0.5333333333333333
66450849045	4	0.5964398652054939	2.0	2	2	0.29821993260274693	1.0
66450849046	31	6.492859155080854	10.0	10	21	0.3091837692895645	0.47619047619047616
66450849047	2	0.29826400576122714	1.0	1	1	0.29826400576122714	1.0
66450849048	3	0.36824517820623054	0.5	1	2	0.36824517820623054	0.5
66450849049	2	0.2983059577516521	1.0	1	1	0.2983059577516521	1.0
66450849050	2	0.7171760438512103	0.0	0	2	0.7171760438512103	0.0
66450849051	1	0.2983165972612623	0.0	0	1	0.2983165972612623	0.0
66450849052	3	1.3609700768169226	0.0	0	3	0.45365669227230754	0.0
66450849053	9	1.6705378544829559	4.0	4	5	0.33410757089659116	0.8
66450849054	2	0.5967976018814694	0.0	0	2	0.2983988009407347	0.0
66450849055	6	1.9947798727548318	2.0	2	4	0.49869496818870795	0.5
66450849056	27	7.482184259000411	7.0	7	20	0.37410921295002053	0.35
66450849057	3	0.5969619419017457	1.0	1	2	0.29848097095087284	0.5
66450849058	2	1.1095293744234338	0.0	0	2	0.5547646872117169	0.0
66450849059	9	1.8825774562191753	3.0	3	6	0.31376290936986256	0.5
66450849060	10	1.6716928809930112	5.0	5	5	0.33433857619860224	1.0
66450849061	2	0.597272406832491	0.0	0	2	0.2986362034162455	0.0
66450849062	3	0.6326300898058784	1.0	1	2	0.3163150449029392	0.5
66807323916	6	5.092130577624027	0.0	0	6	0.8486884296040045	0.0
66807323917	2	1.6965994679504468	0.0	0	2	0.8482997339752234	0.0
66807323918	6	5.090473878034252	0.0	0	6	0.8484123130057086	0.0
66807323919	1	0.8483246661172056	0.0	0	1	0.8483246661172056	0.0
66807323920	21	17.82019754000397	0.0	0	21	0.8485808352382843	0.0
66807323921	4	3.3939816805825953	0.0	0	4	0.8484954201456488	0.0
66807323922	2	1.697610726403428	0.0	0	2	0.848805363201714	0.0
66807323923	2	1.699273654820033	0.0	0	2	0.8496368274100164	0.0
66807323924	1	0.8496429215595084	0.0	0	1	0.8496429215595084	0.0
66807323925	1	0.8496541334478	0.0	0	1	0.8496541334478	0.0
66807323926	2	1.699542134091019	0.0	0	2	0.8497710670455095	0.0
66807323927	34	29.24146195346716	0.0	0	34	0.860042998631387	0.0
66807323928	1	0.8499230840894653	0.0	0	1	0.8499230840894653	0.0
66807323929	2	1.7000018551803149	0.0	0	2	0.8500009275901574	0.0
66807323930	1	0.8500702190799605	0.0	0	1	0.8500702190799605	0.0
66807323931	4	3.567109632772949	0.0	0	4	0.8917774081932373	0.0
66807323932	1	0.8500971882166622	0.0	0	1	0.8500971882166622	0.0
66831902872	10	7.67742979884896	0.0	0	10	0.767742979884896	0.0
66831902873	2	0.5691042041315169	1.0	1	1	0.5691042041315169	1.0
66831902874	2	0.5691158537211534	1.0	1	1	0.5691158537211534	1.0
66831902875	5	1.7154254741576582	0.5	1	4	0.8577127370788291	0.25
66831902876	11	4.168343708145861	1.5	3	8	0.8336687416291723	0.375
66831902877	2	1.5534921042212693	0.0	0	2	0.7767460521106346	0.0
66831902878	49	36.07302649638558	1.5	3	46	0.9492901709575152	0.06521739130434782
66831902879	3	0.801938357038172	0.5	1	2	0.801938357038172	0.5
66831902880	3	0.6650805941169505	0.5	1	2	0.6650805941169505	0.5
66831902881	8	4.574357495670881	0.0	0	8	0.5717946869588602	0.0
66831902882	10	5.712337390162634	0.0	0	10	0.5712337390162634	0.0
66831902883	2	1.1402837523543703	0.0	0	2	0.5701418761771851	0.0
66831902884	1	0.5701430377692154	0.0	0	1	0.5701430377692154	0.0
66831902885	2	0.5704066349867412	1.0	1	1	0.5704066349867412	1.0
66831902886	1	0.5704178468750329	0.0	0	1	0.5704178468750329	0.0
66831902887	26	12.567210573436904	4.0	4	22	0.5712368442471321	0.18181818181818182
66831902888	5	4.318534998784705	0.0	0	5	0.8637069997569411	0.0
66831902889	3	1.1419924710655	1.0	1	2	0.57099623553275	0.5
66831902890	2	0.5710150061865719	1.0	1	1	0.5710150061865719	1.0
66831902891	3	2.3958292179586707	0.0	0	3	0.7986097393195569	0.0
66831902892	1	0.5710295176696161	0.0	0	1	0.5710295176696161	0.0
66831902893	2	0.5710267231148767	1.0	1	1	0.5710267231148767	1.0
66831902894	3	1.143695398651146	1.0	1	2	0.571847699325573	0.5
66831902895	3	1.7155658752813114	0.0	0	3	0.5718552917604371	0.0
66831902896	3	1.1437780905359642	1.0	1	2	0.5718890452679821	0.5
66831902897	1	0.5718902068600124	0.0	0	1	0.5718902068600124	0.0
66831902898	2	1.310267695785579	0.0	0	2	0.6551338478927895	0.0
66831902899	1	0.5725282070739474	0.0	0	1	0.5725282070739474	0.0
66831902900	3	1.1450752689750519	1.0	1	2	0.5725376344875259	0.5
66831902901	1	0.5725354796501365	0.0	0	1	0.5725354796501365	0.0
66831902902	3	0.6280062464695598	0.5	1	2	0.6280062464695598	0.5
66831902903	2	1.1462278039543756	0.0	0	2	0.5731139019771878	0.0
66831902904	7	3.4393905688895283	1.0	1	6	0.573231761481588	0.16666666666666666
66831902905	4	1.7201559146060839	1.0	1	3	0.5733853048686947	0.3333333333333333
66831902906	3	1.7201598539181864	0.0	0	3	0.5733866179727288	0.0
66831902907	3	1.1468369495488933	1.0	1	2	0.5734184747744466	0.5
66831902908	5	3.163273039075249	0.0	0	5	0.6326546078150498	0.0
66831902909	2	0.5734338448255132	1.0	1	1	0.5734338448255132	1.0
66831902910	5	3.15370387759958	0.0	0	5	0.6307407755199159	0.0
66831902911	1	0.57350148651794	0.0	0	1	0.57350148651794	0.0
66831902912	1	0.573560946562154	0.0	0	1	0.573560946562154	0.0
66831902913	22	10.908426818203807	3.0	3	19	0.5741277272738846	0.15789473684210525
66831902914	2	1.5717731049156318	0.0	0	2	0.7858865524578159	0.0
66831902915	1	0.5737490908017163	0.0	0	1	0.5737490908017163	0.0
66831902916	1	0.5737494274950584	0.0	0	1	0.5737494274950584	0.0
66831902917	1	0.5737561613619003	0.0	0	1	0.5737561613619003	0.0
66831902918	2	1.1475194269533189	0.0	0	2	0.5737597134766594	0.0
66831902919	1	0.573757878497945	0.0	0	1	0.573757878497945	0.0
66831902920	2	1.147659929084975	0.0	0	2	0.5738299645424875	0.0
66831902921	2	0.5741022821175735	1.0	1	1	0.5741022821175735	1.0
66831902922	2	1.1483191409794617	0.0	0	2	0.5741595704897309	0.0
66831902923	2	1.1483877927519148	0.0	0	2	0.5741938963759574	0.0
66831902924	2	0.5743943972611747	1.0	1	1	0.5743943972611747	1.0
66831902925	4	1.7481204178350906	1.0	1	3	0.5827068059450302	0.3333333333333333
66831902926	2	0.5744368206222786	1.0	1	1	0.5744368206222786	1.0
66831902927	1	0.5744697829004697	0.0	0	1	0.5744697829004697	0.0
66831902928	8	3.5909791032287313	2.0	2	6	0.5984965172047886	0.3333333333333333
66831902929	5	2.874335203204701	0.0	0	5	0.5748670406409402	0.0
66831902930	2	1.1497143645197674	0.0	0	2	0.5748571822598837	0.0
66831902931	23	11.50543488709342	3.0	3	20	0.575271744354671	0.15
66831902932	4	2.300398069171425	0.0	0	4	0.5750995172928562	0.0
66831902933	2	1.1501881593907628	0.0	0	2	0.5750940796953814	0.0
66831902934	4	2.3018374668782133	0.0	0	4	0.5754593667195533	0.0
66831902935	4	2.3027550572434237	0.0	0	4	0.5756887643108559	0.0
66831902936	2	1.1513699530215147	0.0	0	2	0.5756849765107573	0.0
66831902937	4	2.3036657790644552	0.0	0	4	0.5759164447661138	0.0
66831902938	24	12.680403710131674	2.0	2	22	0.576381986824167	0.09090909090909091
66831902939	6	3.4581695390368488	0.0	0	6	0.5763615898394748	0.0
66831902940	4	2.3045618883944394	0.0	0	4	0.5761404720986099	0.0
66831902941	4	1.2166060725270456	0.5	1	3	0.6083030362635228	0.3333333333333333
66831902942	2	0.8642603283292061	0.0	0	2	0.8642603283292061	0.0
66831902943	5	1.4517575173606663	0.5	1	4	0.7258787586803331	0.25
66831902944	2	1.4406505090449806	0.0	0	2	0.7203252545224903	0.0
66831902945	1	0.5763650633924541	0.0	0	1	0.5763650633924541	0.0
66831902946	1	0.5763762752807459	0.0	0	1	0.5763762752807459	0.0
66831902947	5	2.8822275981674053	0.0	0	5	0.576445519633481	0.0
66831902948	2	1.152869618836538	0.0	0	2	0.576434809418269	0.0
66831902949	4	2.3067176011865342	0.0	0	4	0.5766794002966336	0.0
66831902950	2	1.1533506862837226	0.0	0	2	0.5766753431418613	0.0
66831902951	4	2.3068462853818827	0.0	0	4	0.5767115713454707	0.0
66831902952	1	0.5792716360067537	0.0	0	1	0.5792716360067537	0.0
66831902953	2	0.5792828478950454	1.0	1	1	0.5792828478950454	1.0
66831902954	1	0.5794540227901662	0.0	0	1	0.5794540227901662	0.0
66831902955	2	0.5794592415369687	1.0	1	1	0.5794592415369687	1.0
66831902956	3	1.1589447451546209	1.0	1	2	0.5794723725773104	0.5
66831902957	1	0.5794704534252605	0.0	0	1	0.5794704534252605	0.0
66831902958	9	5.6743870674471175	1.0	1	8	0.7092983834308897	0.125
66831902959	8	5.676971693887706	0.0	0	8	0.7096214617359633	0.0
66831902960	6	2.8999871618828656	1.0	1	5	0.5799974323765731	0.2
66831902961	1	0.5799694666275789	0.0	0	1	0.5799694666275789	0.0
66831902962	4	1.1601254950360123	2.0	2	2	0.5800627475180061	1.0
66831902963	15	7.069447816521791	3.0	3	12	0.5891206513768159	0.25
66831902964	5	3.087598584231432	0.0	0	5	0.6175197168462864	0.0
66831902965	2	0.5801032685617272	1.0	1	1	0.5801032685617272	1.0
66831902966	25	11.171618017228397	6.0	6	19	0.5879798956435999	0.3157894736842105
66831902967	6	3.095123209056566	1.0	1	5	0.6190246418113132	0.2
66831902968	2	1.1606237001743094	0.0	0	2	0.5803118500871547	0.0
66831902969	3	1.1607103987098988	1.0	1	2	0.5803551993549494	0.5
66831902970	11	5.442310676576179	2.0	2	9	0.6047011862862421	0.2222222222222222
66831902971	22	8.817058110274276	7.0	7	15	0.587803874018285	0.4666666666666667
66831902972	7	3.676953815471241	1.0	1	6	0.6128256359118734	0.16666666666666666
66831902973	2	1.1611089426189363	0.0	0	2	0.5805544713094681	0.0
66831902974	29	11.142820197977708	10.0	10	19	0.5864642209461951	0.5263157894736842
66831902975	3	1.1616709848148945	1.0	1	2	0.5808354924074473	0.5
66831902976	6	3.0972200678524624	1.0	1	5	0.6194440135704925	0.2
66831902977	2	1.1615013923784816	0.0	0	2	0.5807506961892408	0.0
66831902978	28	12.99804101712769	6.0	6	22	0.5908200462330768	0.2727272727272727
66831902979	1	0.5808876293714706	0.0	0	1	0.5808876293714706	0.0
66831902980	3	1.161806739570427	1.0	1	2	0.5809033697852135	0.5
66831902981	3	1.1618525635342862	1.0	1	2	0.5809262817671431	0.5
66831902982	1	0.5809224434630432	0.0	0	1	0.5809224434630432	0.0
66831902983	3	1.162087238793726	1.0	1	2	0.581043619396863	0.5
66831902984	5	2.9049749707219887	0.0	0	5	0.5809949941443977	0.0
66831902985	4	1.162041414829867	2.0	2	2	0.5810207074149335	1.0
66831902986	22	8.825603926005982	7.0	7	15	0.5883735950670654	0.4666666666666667
66831902987	1	0.5810997798463244	0.0	0	1	0.5810997798463244	0.0
66831902988	9	3.5587261032321322	3.0	3	6	0.5931210172053554	0.5
66831902989	5	3.0991038671014817	0.0	0	5	0.6198207734202963	0.0
66831902990	32	13.665232880515582	9.0	9	23	0.5941405600224166	0.391304347826087
66831902991	5	2.9065855096545636	0.0	0	5	0.5813171019309127	0.0
66831902992	3	1.7439588207881336	0.0	0	3	0.5813196069293779	0.0
66831902993	1	0.581343882519343	0.0	0	1	0.581343882519343	0.0
66831902994	24	10.576851854626454	6.0	6	18	0.5876028808125808	0.3333333333333333
66831902995	1	0.5814390993964873	0.0	0	1	0.5814390993964873	0.0
66831902996	5	3.1016925338621752	0.0	0	5	0.6203385067724351	0.0
66831902997	3	1.744585979476453	0.0	0	3	0.5815286598254844	0.0
66831902998	4	1.9094638673667956	1.0	1	3	0.6364879557889319	0.3333333333333333
66831902999	22	9.961645847289974	5.0	5	17	0.5859791674876456	0.29411764705882354
66831903000	6	3.1025175335583093	1.0	1	5	0.6205035067116619	0.2
66831903001	2	1.1633881545289109	0.0	0	2	0.5816940772644554	0.0
66831903002	3	1.163455156503988	1.0	1	2	0.581727578251994	0.5
66831903003	14	7.2385724848746404	2.0	2	12	0.6032143737395533	0.16666666666666666
66831903004	21	8.29398658620459	7.0	7	14	0.5924276133003278	0.5
66831903005	10	3.7127164058578312	2.5	3	7	0.6187860676429718	0.42857142857142855
66831903006	3	1.7457141041884754	0.0	0	3	0.5819047013961585	0.0
66831903007	3	1.1638564949677646	1.0	1	2	0.5819282474838823	0.5
66831903008	25	9.968553447896387	8.0	8	17	0.5863854969350816	0.47058823529411764
66831903009	2	1.16412776879349	0.0	0	2	0.582063884396745	0.0
66831903010	4	2.3285078892468802	0.0	0	4	0.5821269723117201	0.0
66831903011	3	1.7464220019402292	0.0	0	3	0.5821406673134097	0.0
66831903012	2	0.5821662896767431	1.0	1	1	0.5821662896767431	1.0
66831903013	1	0.5821790840237426	0.0	0	1	0.5821790840237426	0.0
66831903014	31	12.410399487660474	10.0	10	21	0.5909714041743083	0.47619047619047616
66831903015	5	3.1057203626443184	0.0	0	5	0.6211440725288637	0.0
66831903016	3	1.7469975792085397	0.0	0	3	0.5823325264028466	0.0
66831903017	4	1.1647269819344157	2.0	2	2	0.5823634909672079	1.0
66831903018	3	1.7475288139636964	0.0	0	3	0.5825096046545655	0.0
66831903019	4	1.165091284130562	2.0	2	2	0.582545642065281	1.0
66831903020	4	2.3308442380170087	0.0	0	4	0.5827110595042522	0.0
66831903021	2	1.1655059556506857	0.0	0	2	0.5827529778253429	0.0
66831903022	5	2.3310818425085245	1.0	1	4	0.5827704606271311	0.25
66831903023	21	19.351446200595763	0.0	0	21	0.9675723100297882	0.0
66831903024	5	2.915530778367332	0.0	0	5	0.5831061556734664	0.0
66831903025	1	0.5830952602769162	0.0	0	1	0.5830952602769162	0.0
66831903026	7	2.7405766688281257	0.5	1	6	0.6851441672070314	0.16666666666666666
66831903027	2	1.1663301136134647	0.0	0	2	0.5831650568067324	0.0
66831903028	19	17.7859078483117	0.0	0	19	0.9881059915728723	0.0
66831903029	22	8.897360617121185	7.0	7	15	0.5931573744747457	0.4666666666666667
66831903030	4	1.1671098617244213	2.0	2	2	0.5835549308622107	1.0
66831903031	1	0.5835089217170135	0.0	0	1	0.5835089217170135	0.0
66831903032	2	0.5835168003412186	1.0	1	1	0.5835168003412186	1.0
66831903033	6	3.111035841443967	1.0	1	5	0.6222071682887934	0.2
66831903034	2	1.2514427562228758	0.0	0	2	0.6257213781114379	0.0
66831903035	2	1.1671752812407903	0.0	0	2	0.5835876406203951	0.0
66831903036	3	1.1671734294274088	1.0	1	2	0.5835867147137044	0.5
66831903037	26	11.712084062092044	6.0	6	20	0.5856042031046023	0.3
66831903038	6	1.7514315274999168	3.0	3	3	0.5838105091666389	1.0
66831903039	3	1.7514465440229743	0.0	0	3	0.5838155146743248	0.0
66831903040	16	15.177221368835536	0.0	0	16	0.948576335552221	0.0
66831903041	11	7.084886452022192	1.0	1	10	0.7084886452022192	0.1
66831903042	1	0.5838884761215567	0.0	0	1	0.5838884761215567	0.0
66831903043	3	1.873936726634332	0.0	0	3	0.6246455755447774	0.0
66831903044	4	2.3363499485549406	0.0	0	4	0.5840874871387352	0.0
66831903045	2	1.1681596042264037	0.0	0	2	0.5840798021132019	0.0
66831903046	5	2.7919106528999045	1.0	1	4	0.6979776632249761	0.25
66831903047	3	1.7523836962713604	0.0	0	3	0.5841278987571201	0.0
66831903048	4	2.3366104818630538	0.0	0	4	0.5841526204657634	0.0
66831903049	1	0.5841624771633532	0.0	0	1	0.5841624771633532	0.0
66831903050	1	0.5841703221182241	0.0	0	1	0.5841703221182241	0.0
66831903051	4	3.4821437211220223	0.0	0	4	0.8705359302805056	0.0
66831903052	5	2.9217369457341578	0.0	0	5	0.5843473891468316	0.0
66831903053	19	9.358370635869282	3.0	3	16	0.5848981647418301	0.1875
66831903054	10	5.858464152445047	0.0	0	10	0.5858464152445048	0.0
66831903055	1	0.5845806502942347	0.0	0	1	0.5845806502942347	0.0
66831903056	5	2.9233229397220937	0.0	0	5	0.5846645879444188	0.0
66831903057	2	1.1693090416269802	0.0	0	2	0.5846545208134901	0.0
66831903058	5	3.169355134945513	0.0	0	5	0.6338710269891026	0.0
66831903059	5	2.925603835098779	0.0	0	5	0.5851207670197558	0.0
66831903060	2	1.1702209418747092	0.0	0	2	0.5851104709373546	0.0
66831903061	1	0.5851959573769124	0.0	0	1	0.5851959573769124	0.0
66831903062	2	0.5853582772371362	1.0	1	1	0.5853582772371362	1.0
66831903063	3	0.6096109720548903	0.5	1	2	0.6096109720548903	0.5
66831903064	1	0.5853549776423836	0.0	0	1	0.5853549776423836	0.0
66831903065	1	0.585369489125428	0.0	0	1	0.585369489125428	0.0
66831903066	2	0.5853928556433693	1.0	1	1	0.5853928556433693	1.0
66831903067	4	2.3418377133377395	0.0	0	4	0.5854594283344349	0.0
66831903068	2	1.170909412420624	0.0	0	2	0.585454706210312	0.0
66831903069	25	11.722958145953667	5.0	5	20	0.5861479072976834	0.25
66831903070	1	0.58551675879326	0.0	0	1	0.58551675879326	0.0
66831903071	5	3.5264108486365786	0.0	0	5	0.7052821697273157	0.0
66831903072	8	7.236930566122583	0.0	0	8	0.9046163207653228	0.0
66831903073	1	0.5856600218103213	0.0	0	1	0.5856600218103213	0.0
66831903074	2	0.8888773926817749	0.0	0	2	0.8888773926817749	0.0
66831903075	3	0.6034731534365094	0.5	1	2	0.6034731534365094	0.5
66831903076	4	3.4890093023993405	0.0	0	4	0.8722523255998351	0.0
66831903077	1	0.585715576211767	0.0	0	1	0.585715576211767	0.0
66831903078	1	0.5857267881000586	0.0	0	1	0.5857267881000586	0.0
66831903079	1	0.5857467876845791	0.0	0	1	0.5857467876845791	0.0
66831903080	4	2.3432890636581725	0.0	0	4	0.5858222659145431	0.0
66831903081	2	1.1716389595542747	0.0	0	2	0.5858194797771373	0.0
66831903082	4	2.3441175986343987	0.0	0	4	0.5860293996585997	0.0
66831903083	8	7.361076135219682	0.0	0	8	0.9201345169024603	0.0
66831903084	2	1.1795413206399046	0.0	0	2	0.5897706603199523	0.0
66831903085	3	1.1720578734105085	1.0	1	2	0.5860289367052542	0.5
66831903086	6	5.4304685656867	0.0	0	6	0.9050780942811167	0.0
66831903087	5	3.1593902241155463	0.0	0	5	0.6318780448231093	0.0
66831903088	2	1.172180429787031	0.0	0	2	0.5860902148935155	0.0
66831903089	2	0.5863466068735205	1.0	1	1	0.5863466068735205	1.0
66831903090	1	0.5863578187618123	0.0	0	1	0.5863578187618123	0.0
66831903091	2	0.586374485082246	1.0	1	1	0.586374485082246	1.0
66831903092	1	0.5863856969705377	0.0	0	1	0.5863856969705377	0.0
66831903093	4	2.3458198865026945	0.0	0	4	0.5864549716256736	0.0
66831903094	2	1.1728942870109398	0.0	0	2	0.5864471435054699	0.0
66831903095	1	0.5866972393199777	0.0	0	1	0.5866972393199777	0.0
66831903096	2	1.173565249503066	0.0	0	2	0.586782624751533	0.0
66831903097	24	12.19832338836597	4.0	4	20	0.6099161694182985	0.2
66831903098	2	0.587268405905507	1.0	1	1	0.587268405905507	1.0
66831903099	1	0.5872796177937987	0.0	0	1	0.5872796177937987	0.0
66831903100	2	0.587314229869366	1.0	1	1	0.587314229869366	1.0
66831903101	5	2.936896092091285	0.0	0	5	0.587379218418257	0.0
66831903102	4	2.5682578244081595	0.0	0	4	0.6420644561020399	0.0
66831903103	4	2.350329422449372	0.0	0	4	0.587582355612343	0.0
66831903104	2	1.1751524555870336	0.0	0	2	0.5875762277935168	0.0
66831903105	4	2.3628185232650214	0.0	0	4	0.5907046308162553	0.0
66831903106	6	2.3726869377831443	0.5	1	5	0.5931717344457861	0.2
66831903107	2	0.5889915350916785	1.0	1	1	0.5889915350916785	1.0
66831903108	1	0.5890055078653753	0.0	0	1	0.5890055078653753	0.0
66831903109	1	0.5890060802440569	0.0	0	1	0.5890060802440569	0.0
66831903110	2	0.5890167197536671	1.0	1	1	0.5890167197536671	1.0
66831903111	1	0.5892078605639741	0.0	0	1	0.5892078605639741	0.0
66831903112	1	0.5892190724522659	0.0	0	1	0.5892190724522659	0.0
66831903113	1	0.5892391057061205	0.0	0	1	0.5892391057061205	0.0
66831903114	1	0.5892503175944123	0.0	0	1	0.5892503175944123	0.0
66831903115	4	1.4694374194313875	1.0	1	3	0.7347187097156938	0.3333333333333333
66831903116	1	0.5894100785852361	0.0	0	1	0.5894100785852361	0.0
66831903117	2	1.1788652404089786	0.0	0	2	0.5894326202044893	0.0
66831903118	3	1.1788767216519442	1.0	1	2	0.5894383608259721	0.5
66831903119	2	0.5894591684745135	1.0	1	1	0.5894591684745135	1.0
66831903120	1	0.5894703803628053	0.0	0	1	0.5894703803628053	0.0
66831903121	1	0.5896501409381495	0.0	0	1	0.5896501409381495	0.0
66831903122	1	0.5896504102928232	0.0	0	1	0.5896504102928232	0.0
66831903123	1	0.589664686090528	0.0	0	1	0.589664686090528	0.0
66831903124	2	0.5896613528264413	1.0	1	1	0.5896613528264413	1.0
66831903125	17	7.079680869929403	5.0	5	12	0.5899734058274503	0.4166666666666667
66831903126	8	6.779923292502644	0.0	0	8	0.8474904115628304	0.0
66831903127	2	1.391582302818827	0.0	0	2	0.6957911514094135	0.0
66831903128	1	0.5898915500644313	0.0	0	1	0.5898915500644313	0.0
66831903129	4	1.211479108329635	0.5	1	3	0.6057395541648175	0.3333333333333333
66831903130	2	1.1798616506855732	0.0	0	2	0.5899308253427866	0.0
66831903131	2	0.878406936798653	0.0	0	2	0.878406936798653	0.0
66831903132	5	3.137041664824673	0.0	0	5	0.6274083329649346	0.0
66831903133	2	1.1800398288022098	0.0	0	2	0.5900199144011049	0.0
66831903134	2	0.5900523884739499	1.0	1	1	0.5900523884739499	1.0
66831903135	43	17.280967260713805	14.0	14	29	0.5958954227832346	0.4827586206896552
66831903136	3	1.4982101213587584	1.0	1	2	0.7491050606793792	0.5
66831903137	6	3.728476448822595	0.0	0	6	0.6214127414704326	0.0
66831903138	1	0.5902845722026583	0.0	0	1	0.5902845722026583	0.0
66831903139	1	0.5904228858275907	0.0	0	1	0.5904228858275907	0.0
66831903140	1	0.5904231551822644	0.0	0	1	0.5904231551822644	0.0
66831903141	2	0.5904234245369381	1.0	1	1	0.5904234245369381	1.0
66831903142	1	0.5904251416729828	0.0	0	1	0.5904251416729828	0.0
66831903143	1	0.5904268588090275	0.0	0	1	0.5904268588090275	0.0
66831903144	4	2.362655530018114	0.0	0	4	0.5906638825045285	0.0
66831903145	43	16.70477906233396	15.0	15	28	0.5965992522262128	0.5357142857142857
66831903146	2	0.5905026821496672	1.0	1	1	0.5905026821496672	1.0
66831903147	6	3.7302011941368085	0.0	0	6	0.6217001990228014	0.0
66831903148	1	0.5905625125565573	0.0	0	1	0.5905625125565573	0.0
66831903149	5	1.6592680549363672	0.5	1	4	0.8296340274681836	0.25
66831903150	2	0.9349640110170102	0.0	0	2	0.9349640110170102	0.0
66831903151	1	0.5907205227420023	0.0	0	1	0.5907205227420023	0.0
66831903152	6	2.363665980407074	2.0	2	4	0.5909164951017685	0.5
66831903153	2	0.5907681648499087	1.0	1	1	0.5907681648499087	1.0
66831903154	10	6.952694114065038	1.0	1	9	0.7725215682294486	0.1111111111111111
66831903155	1	0.5908283992888094	0.0	0	1	0.5908283992888094	0.0
66831903156	28	12.068202185833378	8.0	8	20	0.6034101092916689	0.4
66831903157	2	0.590994389106462	1.0	1	1	0.590994389106462	1.0
66831903158	2	0.591005634664088	1.0	1	1	0.591005634664088	1.0
66831903159	2	1.1821408962648823	0.0	0	2	0.5910704481324411	0.0
66831903160	3	1.182393079578111	1.0	1	2	0.5911965397890555	0.5
66831903161	2	0.5912079200240183	1.0	1	1	0.5912079200240183	1.0
66831903162	5	3.1446968256585377	0.0	0	5	0.6289393651317076	0.0
66831903163	2	1.1824754347695874	0.0	0	2	0.5912377173847937	0.0
66831903164	4	1.1825393054965827	2.0	2	2	0.5912696527482914	1.0
66831903165	39	16.682994464391093	11.0	11	28	0.5958212308711105	0.39285714285714285
66831903166	4	1.1828591978409069	2.0	2	2	0.5914295989204534	1.0
66831903167	4	1.1827688293478886	2.0	2	2	0.5913844146739443	1.0
66831903168	2	0.5913957949089071	1.0	1	1	0.5913957949089071	1.0
66831903169	6	3.145719397007813	1.0	1	5	0.6291438794015626	0.2
66831903170	2	0.5914581168465288	1.0	1	1	0.5914581168465288	1.0
66831903171	5	2.3667983059072477	1.0	1	4	0.5916995764768119	0.25
66831903172	2	0.5915630304919255	1.0	1	1	0.5915630304919255	1.0
66831903173	2	0.5915742760495514	1.0	1	1	0.5915742760495514	1.0
66831903174	5	2.9580876383813846	0.0	0	5	0.591617527676277	0.0
66831903175	4	2.4470992639647857	0.0	0	4	0.6117748159911964	0.0
66831903176	17	6.549821069373745	6.0	6	11	0.5954382790339768	0.5454545454545454
66831903177	4	1.7756466473406933	1.0	1	3	0.5918822157802311	0.3333333333333333
66831903178	28	12.082954269939911	8.0	8	20	0.6041477134969956	0.4
66831903179	3	1.1835008680122705	1.0	1	2	0.5917504340061353	0.5
66831903180	2	0.5917581779530035	1.0	1	1	0.5917581779530035	1.0
66831903181	6	3.740330141963044	0.0	0	6	0.6233883569938407	0.0
66831903182	37	15.479354654484116	11.0	11	26	0.5953597944032352	0.4230769230769231
66831903183	4	1.776785680916999	1.0	1	3	0.5922618936389997	0.3333333333333333
66831903184	2	0.5921082380207792	1.0	1	1	0.5921082380207792	1.0
66831903185	7	3.931668456584589	0.0	0	7	0.6552780760974315	0.0
66831903186	6	4.1873047957219205	1.0	1	5	0.8374609591443841	0.2
66831903187	2	1.1846005758062197	0.0	0	2	0.5923002879031098	0.0
66831903188	2	0.5923116681380727	1.0	1	1	0.5923116681380727	1.0
66831903189	8	3.198071440738083	0.5	1	7	0.6396142881476166	0.14285714285714285
66831903190	4	1.1847654208665093	2.0	2	2	0.5923827104332546	1.0
66831903191	20	9.010416315593712	5.0	5	15	0.6006944210395808	0.3333333333333333
66831903192	3	1.1850954476804303	1.0	1	2	0.5925477238402151	0.5
66831903193	7	3.086105483936579	2.0	2	5	0.6172210967873158	0.4
66831903194	4	1.1850089511608464	2.0	2	2	0.5925044755804232	1.0
66831903195	5	3.1522565002605836	0.0	0	5	0.6304513000521167	0.0
66831903196	27	12.046574116625255	7.0	7	20	0.6023287058312627	0.35
66831903197	3	1.778222452415719	0.0	0	3	0.5927408174719063	0.0
66831903198	2	0.5927650593925372	1.0	1	1	0.5927650593925372	1.0
66831903199	30	12.012390213981075	10.0	10	20	0.6006195106990537	0.5
66831903200	9	3.2254778074139	1.0	2	7	0.64509556148278	0.2857142857142857
66831903201	3	1.7787677272832412	0.0	0	3	0.5929225757610804	0.0
66831903202	3	1.185902501621431	1.0	1	2	0.5929512508107155	0.5
66831903203	27	12.058319966888234	7.0	7	20	0.6029159983444117	0.35
66831903204	1	0.5930455586158362	0.0	0	1	0.5930455586158362	0.0
66831903205	2	0.5930600700988804	1.0	1	1	0.5930600700988804	1.0
66831903206	2	0.5930800696834009	1.0	1	1	0.5930800696834009	1.0
66831903207	14	3.7994139987058184	4.5	6	8	0.6332356664509697	0.75
66831903208	3	1.7794851534565765	0.0	0	3	0.5931617178188588	0.0
66831903209	4	1.8328849195287762	1.0	1	3	0.6109616398429254	0.3333333333333333
66831903210	24	10.835758765550224	6.0	6	18	0.6019865980861235	0.3333333333333333
66831903211	6	3.750395151723616	0.0	0	6	0.6250658586206027	0.0
66831903212	3	1.780284800144051	0.0	0	3	0.5934282667146836	0.0
66831903213	2	0.5934537656237916	1.0	1	1	0.5934537656237916	1.0
66831903214	27	12.658149761669934	6.0	6	21	0.6027690362699969	0.2857142857142857
66831903215	1	0.5935320804951628	0.0	0	1	0.5935320804951628	0.0
66831903216	1	0.5935354474285838	0.0	0	1	0.5935354474285838	0.0
66831903217	2	0.5935359861379311	1.0	1	1	0.5935359861379311	1.0
66831903218	4	2.691640715746747	0.0	0	4	0.6729101789366867	0.0
66831903219	3	1.1872873886761344	1.0	1	2	0.5936436943380672	0.5
66831903220	29	11.399136421980728	10.0	10	19	0.5999545485253015	0.5263157894736842
66831903221	1	0.5937340965004195	0.0	0	1	0.5937340965004195	0.0
66831903222	1	0.5937453083887112	0.0	0	1	0.5937453083887112	0.0
66831903223	8	3.5381971357699404	1.5	2	6	0.7076394271539881	0.3333333333333333
66831903224	1	0.5937627154344975	0.0	0	1	0.5937627154344975	0.0
66831903225	3	1.4190869502812014	0.0	0	3	0.7095434751406007	0.0
66831903226	11	7.648043372297619	1.0	1	10	0.7648043372297619	0.1
66831903227	3	1.1877510154081985	1.0	1	2	0.5938755077040992	0.5
66831903228	15	6.610564016229023	4.0	4	11	0.6009603651117293	0.36363636363636365
66831903229	2	0.5940210265665524	1.0	1	1	0.5940210265665524	1.0
66831903230	1	0.5940322384548442	0.0	0	1	0.5940322384548442	0.0
66831903231	14	6.095399701629094	4.0	4	10	0.6095399701629094	0.4
66831903232	5	3.1604543097539017	0.0	0	5	0.6320908619507803	0.0
66831903233	2	1.1882009723905735	0.0	0	2	0.5941004861952868	0.0
66831903234	2	0.5941315966600963	1.0	1	1	0.5941315966600963	1.0
66831903235	30	13.345857528818339	8.0	8	22	0.6066298876735609	0.36363636363636365
66831903236	2	0.9415082858379676	0.0	0	2	0.9415082858379676	0.0
66831903237	5	1.653599418490195	0.5	1	4	0.8267997092450975	0.25
66831903238	3	0.6017633909760192	0.5	1	2	0.6017633909760192	0.5
66831903239	1	0.5942811895119889	0.0	0	1	0.5942811895119889	0.0
66831903240	2	0.594307889294017	1.0	1	1	0.594307889294017	1.0
66831903241	6	2.4006712049113323	0.5	1	5	0.6001678012278331	0.2
66831903242	2	1.1886864505205397	0.0	0	2	0.5943432252602698	0.0
66831903243	30	12.678447488144773	9.0	9	21	0.6037355946735606	0.42857142857142855
66831903244	1	0.5945055619551607	0.0	0	1	0.5945055619551607	0.0
66831903245	1	0.5945058313098344	0.0	0	1	0.5945058313098344	0.0
66831903246	3	1.1890323692602076	1.0	1	2	0.5945161846301038	0.5
66831903247	5	4.132468628513677	0.0	0	5	0.8264937257027354	0.0
66831903248	5	1.7840025006887905	2.0	2	3	0.5946675002295968	0.6666666666666666
66831903249	6	3.162938332223873	1.0	1	5	0.6325876664447746	0.2
66831903250	19	7.8086095652491	6.0	6	13	0.6006622742499308	0.46153846153846156
66831903251	1	0.5947469710814425	0.0	0	1	0.5947469710814425	0.0
66831903252	1	0.5947518531349029	0.0	0	1	0.5947518531349029	0.0
66831903253	1	0.5947581829697343	0.0	0	1	0.5947581829697343	0.0
66831903254	1	0.5947630650231946	0.0	0	1	0.5947630650231946	0.0
66831903255	5	1.7847160885580255	2.0	2	3	0.5949053628526751	0.6666666666666666
66831903256	11	4.914791231441422	3.0	3	8	0.6143489039301777	0.375
66831903257	5	3.1733501024574675	0.0	0	5	0.6346700204914935	0.0
66831903258	2	0.5948589216176889	1.0	1	1	0.5948589216176889	1.0
66831903259	27	10.154084273737476	10.0	10	17	0.5972990749257339	0.5882352941176471
66831903260	1	0.5949975382666293	0.0	0	1	0.5949975382666293	0.0
66831903261	3	1.190026355344739	1.0	1	2	0.5950131776723695	0.5
66831903262	5	2.5911211878190947	1.0	1	4	0.6477802969547737	0.25
66831903263	6	1.7903362748322702	3.0	3	3	0.5967787582774234	1.0
66831903264	30	12.694151741022752	9.0	9	21	0.6044834162391787	0.42857142857142855
66831903265	2	0.5952699905190522	1.0	1	1	0.5952699905190522	1.0
66831903266	4	1.1906640862040003	2.0	2	2	0.5953320431020002	1.0
66831903267	5	2.976741358605446	0.0	0	5	0.5953482717210892	0.0
66831903268	26	12.70714951813964	5.0	5	21	0.6051023580066496	0.23809523809523808
66831903269	1	0.5954739256763588	0.0	0	1	0.5954739256763588	0.0
66831903270	2	0.9064126176233982	0.0	0	2	0.9064126176233982	0.0
66831903271	1	0.5955055075118473	0.0	0	1	0.5955055075118473	0.0
66831903272	1	0.5955368536619963	0.0	0	1	0.5955368536619963	0.0
66831903273	15	3.980877265950401	3.0	5	10	0.6634795443250668	0.5
66831903274	5	2.067270420678466	2.0	2	3	0.6890901402261553	0.6666666666666666
66831903275	24	10.209225788137667	7.0	7	17	0.6005426934198628	0.4117647058823529
66831903276	2	1.1916190831995173	0.0	0	2	0.5958095415997586	0.0
66831903277	1	0.5958242887681424	0.0	0	1	0.5958242887681424	0.0
66831903278	2	0.5958510222195047	1.0	1	1	0.5958510222195047	1.0
66831903279	5	3.1782936697914392	0.0	0	5	0.6356587339582879	0.0
66831903280	1	0.5959329397096363	0.0	0	1	0.5959329397096363	0.0
66831903281	18	8.543485645432888	4.0	4	14	0.6102489746737777	0.2857142857142857
66831903282	14	6.1200777411459155	4.0	4	10	0.6120077741145915	0.4
66831903283	5	3.179380044529041	0.0	0	5	0.6358760089058082	0.0
66831903284	3	1.7884936531789897	0.0	0	3	0.5961645510596633	0.0
66831903285	2	0.5961835742334916	1.0	1	1	0.5961835742334916	1.0
66831903286	31	12.721151954520002	10.0	10	21	0.6057691406914286	0.47619047619047616
66831903287	3	1.7891646830097838	0.0	0	3	0.5963882276699279	0.0
66831903288	28	12.726139291988446	7.0	7	21	0.6060066329518308	0.3333333333333333
66831903289	7	3.7789063439321815	1.0	1	6	0.629817723988697	0.16666666666666666
66831903290	3	1.7898994488902369	0.0	0	3	0.596633149630079	0.0
66831903291	3	1.193320529334458	1.0	1	2	0.596660264667229	0.5
66831903292	17	6.565915179472534	6.0	6	11	0.5969013799520485	0.5454545454545454
66831903293	13	5.105668680216306	5.0	5	8	0.6382085850270383	0.625
66831903294	9	3.7347133562915547	3.0	3	6	0.6224522260485924	0.5
66831903295	2	1.262919891529526	0.0	0	2	0.631459945764763	0.0
66831903296	6	3.7795430647114165	0.0	0	6	0.6299238441185694	0.0
66831903297	6	3.1828369760803286	1.0	1	5	0.6365673952160658	0.2
66831903298	7	3.1420016964630735	2.0	2	5	0.6284003392926147	0.4
66831903299	1	0.5968419443946232	0.0	0	1	0.5968419443946232	0.0
66831903300	2	0.5968531562829149	1.0	1	1	0.5968531562829149	1.0
66831903301	7	3.0698040717470616	2.0	2	5	0.6139608143494123	0.4
66831903302	2	0.5968985425454293	1.0	1	1	0.5968985425454293	1.0
66831903303	2	0.5969064211696343	1.0	1	1	0.5969064211696343	1.0
66831903304	5	3.1836525483628844	0.0	0	5	0.6367305096725768	0.0
66831903305	2	1.193900651962887	0.0	0	2	0.5969503259814435	0.0
66831903306	3	1.1939675192606267	1.0	1	2	0.5969837596303134	0.5
66831903307	1	0.5970707611899106	0.0	0	1	0.5970707611899106	0.0
66831903308	2	0.5971312313141508	1.0	1	1	0.5971312313141508	1.0
66831903309	1	0.5971424432024426	0.0	0	1	0.5971424432024426	0.0
66831903310	25	11.560224186588448	6.0	6	19	0.6084328519257077	0.3157894736842105
66831903311	5	2.9861216014468654	0.0	0	5	0.5972243202893731	0.0
66831903312	3	1.7916888729954668	0.0	0	3	0.5972296243318223	0.0
66831903313	28	12.758712217998703	7.0	7	21	0.6075577246666048	0.3333333333333333
66831903314	2	0.5973647954855618	1.0	1	1	0.5973647954855618	1.0
66831903315	1	0.5973760073738535	0.0	0	1	0.5973760073738535	0.0
66831903316	6	3.185855734916214	1.0	1	5	0.6371711469832428	0.2
66831903317	3	1.7923717544319029	0.0	0	3	0.597457251477301	0.0
66831903318	2	0.5974762409817951	1.0	1	1	0.5974762409817951	1.0
66831903319	19	9.604661209563426	3.0	3	16	0.6002913255977141	0.1875
66831903320	6	3.6605367154493793	1.0	1	5	0.7321073430898759	0.2
66831903321	8	5.863477448970167	0.0	0	8	0.7329346811212709	0.0
66831903322	1	0.597594858046215	0.0	0	1	0.597594858046215	0.0
66831903323	2	0.8520638813665049	0.0	0	2	0.8520638813665049	0.0
66831903324	7	3.214922605816573	0.5	1	6	0.6429845211633146	0.16666666666666666
66831903325	3	1.7930167915366877	0.0	0	3	0.5976722638455626	0.0
66831903326	2	0.5976902769393646	1.0	1	1	0.5976902769393646	1.0
66831903327	10	4.952297320961379	2.0	2	8	0.6190371651201724	0.25
66831903328	7	5.659796124774108	0.0	0	7	0.9432993541290181	0.0
66831903329	5	4.1523006407577325	0.0	0	5	0.8304601281515465	0.0
66831903330	4	3.366415350899949	0.0	0	4	0.8416038377249873	0.0
66831903331	1	0.5978234054868288	0.0	0	1	0.5978234054868288	0.0
66831903332	17	6.576877443320454	6.0	6	11	0.5978979493927685	0.5454545454545454
66831903333	3	1.7937153292135313	0.0	0	3	0.5979051097378437	0.0
66831903334	3	1.1958660656780296	1.0	1	2	0.5979330328390148	0.5
66831903335	28	12.814784386465774	7.0	7	21	0.6102278279269416	0.3333333333333333
66831903336	7	5.0366995069496365	0.0	0	7	0.7195285009928052	0.0
66831903337	4	2.6136466121225697	0.0	0	4	0.6534116530306424	0.0
66831903338	5	4.212666154376524	0.0	0	5	0.8425332308753047	0.0
66831903339	2	1.3538886414379876	0.0	0	2	0.6769443207189938	0.0
66831903340	5	3.502913424323811	0.0	0	5	0.7005826848647623	0.0
66831903341	2	1.2880085622463668	0.0	0	2	0.6440042811231834	0.0
66831903342	5	3.6781738574656546	0.0	0	5	0.735634771493131	0.0
66831903343	3	1.7945380730642735	0.0	0	3	0.5981793576880912	0.0
66831903344	2	0.5982098621048849	1.0	1	1	0.5982098621048849	1.0
66831903345	29	11.497206202820635	10.0	10	19	0.6051161159379281	0.5263157894736842
66831903346	9	3.196956884767747	2.5	3	6	0.6393913769535494	0.5
66831903347	2	0.5983844712720952	1.0	1	1	0.5983844712720952	1.0
66831903348	24	10.38928898345782	7.0	7	17	0.6111346460857542	0.4117647058823529
66831903349	2	0.5984956137443205	1.0	1	1	0.5984956137443205	1.0
66831903350	1	0.5985077347046359	0.0	0	1	0.5985077347046359	0.0
66831903351	1	0.5985180711902383	0.0	0	1	0.5985180711902383	0.0
66831903352	3	1.455446026592646	1.0	1	2	0.727723013296323	0.5
66831903353	9	3.6766881307549943	3.0	3	6	0.6127813551258324	0.5
66831903354	5	3.1980918780239485	0.0	0	5	0.6396183756047897	0.0
66831903355	2	0.5986365872466555	1.0	1	1	0.5986365872466555	1.0
66831903356	31	12.7888962037388	10.0	10	21	0.6089950573208952	0.47619047619047616
66831903357	1	0.5987621065245884	0.0	0	1	0.5987621065245884	0.0
66831903358	3	1.7965562466261222	0.0	0	3	0.5988520822087074	0.0
66831903359	3	1.1977795612798212	1.0	1	2	0.5988897806399106	0.5
66831903360	31	12.793982630057819	10.0	10	21	0.6092372680979914	0.47619047619047616
66831903361	2	0.5990612922283736	1.0	1	1	0.5990612922283736	1.0
66831903362	2	1.5690152497505356	0.0	0	2	0.7845076248752678	0.0
66831903363	4	3.0877017470714496	0.0	0	4	0.7719254367678624	0.0
66831903364	5	2.995937929504966	0.0	0	5	0.5991875859009932	0.0
66831903365	3	1.7975697945938296	0.0	0	3	0.5991899315312765	0.0
66831903366	6	3.2761776295758436	0.5	1	5	0.8190444073939609	0.2
66831903367	25	10.273871616875837	8.0	8	17	0.6043453892279904	0.47058823529411764
66831903368	1	0.5993361686728595	0.0	0	1	0.5993361686728595	0.0
66831903369	3	1.7982681975933361	0.0	0	3	0.599422732531112	0.0
66831903370	4	1.1988936122101437	2.0	2	2	0.5994468061050718	1.0
66831903371	2	1.199155862654301	0.0	0	2	0.5995779313271505	0.0
66831903372	1	0.5995910792021594	0.0	0	1	0.5995910792021594	0.0
66831903373	3	1.866579438400219	0.0	0	3	0.6221931461334064	0.0
66831903374	16	6.0383774518893	6.0	6	10	0.60383774518893	0.6
66831903375	5	2.9983192605055984	0.0	0	5	0.5996638521011197	0.0
66831903376	3	1.7989854890893344	0.0	0	3	0.5996618296964448	0.0
66831903377	2	0.5996911444634299	1.0	1	1	0.5996911444634299	1.0
66831903378	5	2.9995153972727238	0.0	0	5	0.5999030794545448	0.0
66831903379	3	1.7997066525587666	0.0	0	3	0.5999022175195888	0.0
66831903380	4	1.199866992662139	2.0	2	2	0.5999334963310695	1.0
66831903381	23	9.731941865046103	7.0	7	16	0.6082463665653814	0.4375
66831903382	2	0.600104772234193	1.0	1	1	0.600104772234193	1.0
66831903383	8	3.8075996872388203	0.5	1	7	0.6345999478731367	0.14285714285714285
66831903384	2	1.2002786339421838	0.0	0	2	0.6001393169710919	0.0
66873125994	2	1.773591942551227	0.0	0	2	0.8867959712756135	0.0
66873125995	1	0.8868271322444244	0.0	0	1	0.8868271322444244	0.0
66873125996	1	0.8870066571344293	0.0	0	1	0.8870066571344293	0.0
66873125997	2	1.7741028073591871	0.0	0	2	0.8870514036795936	0.0
66873125998	2	1.774173041590348	0.0	0	2	0.887086520795174	0.0
66873125999	1	0.887215609022533	0.0	0	1	0.887215609022533	0.0
66873126000	5	4.436329420361874	0.0	0	5	0.8872658840723748	0.0
66873126001	1	0.8872862809550387	0.0	0	1	0.8872862809550387	0.0
66873126002	19	16.984291471116574	0.0	0	19	0.8939100774271881	0.0
66873126003	2	1.7747772377927369	0.0	0	2	0.8873886188963684	0.0
66873126004	1	0.887391463955109	0.0	0	1	0.887391463955109	0.0
66873126005	2	1.7751585430026589	0.0	0	2	0.8875792715013294	0.0
66873126006	5	4.437431282993212	0.0	0	5	0.8874862565986424	0.0
66873126007	2	1.7749652810242966	0.0	0	2	0.8874826405121483	0.0
66873126008	2	1.7750477708931096	0.0	0	2	0.8875238854465548	0.0
66873126009	14	12.547538019159672	0.0	0	14	0.8962527156542623	0.0
66873126010	1	0.8876169474863098	0.0	0	1	0.8876169474863098	0.0
67079178265	35	10.156168506533044	9.0	9	26	0.3906218656358863	0.34615384615384615
67079178266	2	0.38296224620518826	1.0	1	1	0.38296224620518826	1.0
67079178267	9	2.1051499704534757	4.0	4	5	0.42102999409069514	0.8
67079178268	2	0.7660106859059528	0.0	0	2	0.3830053429529764	0.0
67079178269	2	0.38303699212713327	1.0	1	1	0.38303699212713327	1.0
67265479583	4	0.13423303630358924	2.0	2	2	0.06711651815179462	1.0
67265479584	43	2.228592759537621	13.0	13	30	0.0742864253179207	0.43333333333333335
67265479585	5	0.20923090587646714	2.0	2	3	0.06974363529215571	0.6666666666666666
67680413625	3	1.6170082257887102	1.0	1	2	0.8085041128943551	0.5
67680413626	2	1.617016272759586	0.0	0	2	0.808508136379793	0.0
67680413627	1	0.8085063350704128	0.0	0	1	0.8085063350704128	0.0
67974629836	1	0.45516209309725786	0.0	0	1	0.45516209309725786	0.0
67974629837	4	0.9103973159884187	2.0	2	2	0.45519865799420933	1.0
67974629838	13	3.134655081407905	3.5	5	8	0.5224425135679841	0.625
67974629839	5	1.6295392785947849	0.5	1	4	0.8147696392973924	0.25
67974629840	3	0.6202438824755728	0.5	1	2	0.6202438824755728	0.5
67974629841	1	0.4554000342821161	0.0	0	1	0.4554000342821161	0.0
67974629842	1	0.45540558972226064	0.0	0	1	0.45540558972226064	0.0
67974629843	36	12.504195485231843	9.0	9	27	0.4631183513048831	0.3333333333333333
67974629844	3	0.9109018172922132	1.0	1	2	0.4554509086461066	0.5
67974629845	8	2.4659458084658645	3.0	3	5	0.4931891616931729	0.6
67974629846	2	0.9109740716834267	0.0	0	2	0.45548703584171335	0.0
67974629847	2	0.4555200317892386	1.0	1	1	0.4555200317892386	1.0
67974629848	2	0.45566736879573916	1.0	1	1	0.45566736879573916	1.0
67974629849	1	0.45566763815041283	0.0	0	1	0.45566763815041283	0.0
67974629850	2	0.4556679075050865	1.0	1	1	0.4556679075050865	1.0
67974629851	1	0.4556696246411312	0.0	0	1	0.4556696246411312	0.0
67974629852	11	2.479420646379164	4.0	5	6	0.4958841292758328	0.8333333333333334
67974629853	2	1.1718102691267323	0.0	0	2	0.5859051345633661	0.0
67974629854	7	2.6469785459339112	2.0	2	5	0.5293957091867822	0.4
67974629855	44	13.310256719582624	15.0	15	29	0.45897436964078014	0.5172413793103449
67974629856	2	0.45593833959745683	1.0	1	1	0.45593833959745683	1.0
67974629857	11	5.6716401548156385	2.0	2	9	0.6301822394239598	0.2222222222222222
67974629858	5	2.304005401638626	1.0	1	4	0.5760013504096565	0.25
67974629859	5	4.332185287598571	0.0	0	5	0.8664370575197141	0.0
67974629860	2	0.45613251064784277	1.0	1	1	0.45613251064784277	1.0
67974629861	3	1.043409300217568	1.0	1	2	0.521704650108784	0.5
67974629862	2	1.431530227132992	0.0	0	2	0.715765113566496	0.0
67974629863	2	0.45615028805630536	1.0	1	1	0.45615028805630536	1.0
67974629864	10	2.4756677950495103	5.0	5	5	0.4951335590099021	1.0
67974629865	2	0.4562540906136731	1.0	1	1	0.4562540906136731	1.0
67974629866	44	14.308564465175927	13.0	13	31	0.46156659565083635	0.41935483870967744
67974629867	2	0.9127077393712058	0.0	0	2	0.4563538696856029	0.0
67974629868	2	1.0883080307725594	0.0	0	2	0.5441540153862797	0.0
67974629869	1	0.45636647885126425	0.0	0	1	0.45636647885126425	0.0
67974629870	3	0.9128128887019418	1.0	1	2	0.4564064443509709	0.5
67974629871	8	2.4766419835655267	3.0	3	5	0.49532839671310536	0.6
67974629872	2	0.9128970620374655	0.0	0	2	0.45644853101873273	0.0
67974629873	2	0.4564755001554345	1.0	1	1	0.4564755001554345	1.0
67974629874	43	13.840720851018013	13.0	13	30	0.46135736170060043	0.43333333333333335
67974629875	4	0.9131655749777858	2.0	2	2	0.4565827874888929	1.0
67974629876	10	2.4775297765699618	5.0	5	5	0.49550595531399233	1.0
67974629877	2	0.9132503543613253	0.0	0	2	0.45662517718066264	0.0
67974629878	2	0.4566624996376338	1.0	1	1	0.4566624996376338	1.0
67974629879	3	0.5006427307553913	0.5	1	2	0.5006427307553913	0.5
67974629880	2	1.0382115967489833	0.0	0	2	0.5191057983744917	0.0
67974629881	5	1.3781818404647956	2.0	2	3	0.45939394682159856	0.6666666666666666
67974629882	3	0.91359640777833	1.0	1	2	0.456798203889165	0.5
67974629883	10	5.032334547124054	2.0	2	8	0.6290418183905068	0.25
67974629884	1	0.4569873750434208	0.0	0	1	0.4569873750434208	0.0
67974629885	2	0.8460802346294691	0.0	0	2	0.8460802346294691	0.0
67974629886	1	0.4570094957959964	0.0	0	1	0.4570094957959964	0.0
67974629887	4	1.3031102687193332	1.0	1	3	0.6515551343596666	0.3333333333333333
67974629888	4	0.9142037688981344	2.0	2	2	0.4571018844490672	1.0
67974629889	8	2.479800436469047	3.0	3	5	0.4959600872938094	0.6
67974629890	2	0.4571789872244068	1.0	1	1	0.4571789872244068	1.0
67974629891	26	7.824004228599022	9.0	9	17	0.460235542858766	0.5294117647058824
67974629892	2	0.4573234286681654	1.0	1	1	0.4573234286681654	1.0
67974629893	2	0.45732396737751274	1.0	1	1	0.45732396737751274	1.0
67974629894	3	0.9921158876935117	1.0	1	2	0.49605794384675583	0.5
67974629895	8	2.4808442531682084	3.0	3	5	0.4961688506336417	0.6
67974629896	2	0.9147760129023582	0.0	0	2	0.4573880064511791	0.0
67974629897	5	1.6084492453473271	2.0	2	3	0.536149748449109	0.6666666666666666
67974629898	14	5.181246739756281	3.0	3	11	0.47102243088693463	0.2727272727272727
67974629899	1	0.4575407305511532	0.0	0	1	0.4575407305511532	0.0
67974629900	2	0.45755524203419745	1.0	1	1	0.45755524203419745	1.0
67974629901	1	0.4575760160134047	0.0	0	1	0.4575760160134047	0.0
67974629902	2	1.230583829285432	0.0	0	2	0.615291914642716	0.0
67974629903	19	6.024579220020917	6.0	6	13	0.4634291707708398	0.46153846153846156
67974629904	2	0.9153148232577122	0.0	0	2	0.4576574116288561	0.0
67974629905	3	0.9413346194121153	1.0	1	2	0.47066730970605763	0.5
67974629906	30	9.256507398482663	10.0	10	20	0.46282536992413315	0.5
67974629907	1	0.45779160076034786	0.0	0	1	0.45779160076034786	0.0
67974629908	3	0.6126367677816256	0.5	1	2	0.6126367677816256	0.5
67974629909	2	0.9157833657125709	0.0	0	2	0.45789168285628545	0.0
67974629910	3	0.9413685917703325	1.0	1	2	0.47068429588516625	0.5
67974629911	28	9.284788191437237	8.0	8	20	0.4642394095718618	0.4
67974629912	2	0.4580010240191306	1.0	1	1	0.4580010240191306	1.0
67974629913	2	0.4580012933738043	1.0	1	1	0.4580012933738043	1.0
67974629914	1	0.4580167475982065	0.0	0	1	0.4580167475982065	0.0
67974629915	2	1.0324412115748303	0.0	0	2	0.5162206057874151	0.0
67974629916	7	2.290884832459878	2.0	2	5	0.4581769664919756	0.4
67974629917	12	2.9706478825002187	4.5	5	7	0.4951079804167031	0.7142857142857143
67974629918	2	0.9161715731360058	0.0	0	2	0.4580857865680029	0.0
67974629919	5	2.2775370962832184	1.0	1	4	0.5693842740708046	0.25
67974629920	24	7.355864896678746	8.0	8	16	0.4597415560424216	0.5
67974629921	12	5.936523675585595	3.0	3	9	0.6596137417317327	0.3333333333333333
67974629922	3	0.9165433499243467	1.0	1	2	0.45827167496217336	0.5
67974629923	13	5.1896254209129715	2.0	2	11	0.4717841291739065	0.18181818181818182
67974629924	22	6.493390726529351	8.0	8	14	0.4638136233235251	0.5714285714285714
67974629925	8	3.461787847707002	1.0	1	7	0.4945411211010003	0.14285714285714285
67974629926	3	1.375497519125613	0.0	0	3	0.458499173041871	0.0
67974629927	4	0.9170501070735332	2.0	2	2	0.4585250535367666	1.0
67974629928	28	9.298141887086048	8.0	8	20	0.46490709435430244	0.4
67974629929	3	0.5388213652261837	0.5	1	2	0.5388213652261837	0.5
67974629930	1	0.45863996697442344	0.0	0	1	0.45863996697442344	0.0
67974629931	1	0.4586600002282781	0.0	0	1	0.4586600002282781	0.0
67974629932	1	0.45867121211656986	0.0	0	1	0.45867121211656986	0.0
67974629933	3	0.5444500698419834	0.5	1	2	0.5444500698419834	0.5
67974629934	2	1.412171201695911	0.0	0	2	0.7060856008479555	0.0
67974629935	2	0.9373676984555573	0.0	0	2	0.46868384922777867	0.0
67974629936	1	0.4587303017981074	0.0	0	1	0.4587303017981074	0.0
67974629937	6	2.2940256426322723	1.0	1	5	0.45880512852645444	0.2
67974629938	3	1.3764067258266048	0.0	0	3	0.4588022419422016	0.0
67974629939	4	0.9176731581030791	2.0	2	2	0.4588365790515396	1.0
67974629940	29	8.794581035134726	10.0	10	19	0.4628726860597224	0.5263157894736842
67974629941	9	2.2949319201011886	4.0	4	5	0.4589863840202377	0.8
67974629942	3	1.3769679599585423	0.0	0	3	0.45898931998618075	0.0
67974629943	3	0.9414727983597109	1.0	1	2	0.47073639917985544	0.5
67974629944	21	7.0099828565851	6.0	6	15	0.46733219043900665	0.4
67974629945	1	0.45914527634223895	0.0	0	1	0.45914527634223895	0.0
67974629946	2	0.45914699347828364	1.0	1	1	0.45914699347828364	1.0
67974629947	1	0.4591458487209205	0.0	0	1	0.4591458487209205	0.0
67974629948	13	4.205378932026901	4.0	4	9	0.4672643257807667	0.4444444444444444
67974629949	8	2.4920749962871143	3.0	3	5	0.49841499925742283	0.6
67974629950	3	1.3776863962119035	0.0	0	3	0.45922879873730116	0.0
67974629951	2	0.45925032466497245	1.0	1	1	0.45925032466497245	1.0
67974629952	30	9.288767401700778	10.0	10	20	0.46443837008503885	0.5
67974629953	3	0.9187506778057843	1.0	1	2	0.45937533890289217	0.5
67974629954	1	0.4593787395056473	0.0	0	1	0.4593787395056473	0.0
67974629955	2	1.0584718492548488	0.0	0	2	0.5292359246274244	0.0
67974629956	11	2.503263248706247	4.0	5	6	0.5006526497412495	0.8333333333333334
67974629957	3	1.3783989403317782	0.0	0	3	0.4594663134439261	0.0
67974629958	30	9.291823802852312	10.0	10	20	0.4645911901426156	0.5
67974629959	1	0.459642639747181	0.0	0	1	0.459642639747181	0.0
67974629960	4	0.9195101906468812	2.0	2	2	0.4597550953234406	1.0
67974629961	27	8.83811915422498	8.0	8	19	0.4651641660118411	0.42105263157894735
67974629962	2	0.4598820623827444	1.0	1	1	0.4598820623827444	1.0
67974629963	7	2.9553523416702085	1.0	1	6	0.49255872361170144	0.16666666666666666
67974629964	2	0.91989099081679	0.0	0	2	0.459945495408395	0.0
67974629965	3	0.9199529760610697	1.0	1	2	0.45997648803053487	0.5
67974629966	2	0.9232560050856855	0.0	0	2	0.46162800254284275	0.0
67974629967	2	0.9203659977838171	0.0	0	2	0.46018299889190856	0.0
67974629968	1	0.46019407610286345	0.0	0	1	0.46019407610286345	0.0
67974629969	3	1.588063305216858	0.0	0	3	0.529354435072286	0.0
67974629970	2	0.9204427975351488	0.0	0	2	0.4602213987675744	0.0
67974629971	3	1.4866254125293088	0.0	0	3	0.4955418041764363	0.0
67974629972	1	0.46024784602959595	0.0	0	1	0.46024784602959595	0.0
67974629973	3	0.9205261964759857	1.0	1	2	0.46026309823799283	0.5
67974629974	3	1.815981465974259	0.0	0	3	0.605327155324753	0.0
67974629975	4	2.8481522454567187	0.0	0	4	0.7120380613641797	0.0
67974629976	1	0.46032730565833024	0.0	0	1	0.46032730565833024	0.0
67974629977	1	0.46174087898578	0.0	0	1	0.46174087898578	0.0
67974629978	1	0.4617537743407822	0.0	0	1	0.4617537743407822	0.0
67974629979	1	0.4617653902610845	0.0	0	1	0.4617653902610845	0.0
67974629980	1	0.4617783866240893	0.0	0	1	0.4617783866240893	0.0
67974629981	7	5.018357261736348	0.0	0	7	0.7169081802480497	0.0
67974629982	1	0.46182764486003774	0.0	0	1	0.46182764486003774	0.0
67974629983	3	1.4223457378006659	0.0	0	3	0.4741152459335553	0.0
67974629984	1	0.46185353657804484	0.0	0	1	0.46185353657804484	0.0
67974629985	1	0.46188885570963056	0.0	0	1	0.46188885570963056	0.0
67974629986	2	0.9244004594247992	0.0	0	2	0.4622002297123996	0.0
67974629987	1	0.46194585789244713	0.0	0	1	0.46194585789244713	0.0
67974629988	3	1.5461225940188381	0.0	0	3	0.5153741980062794	0.0
67974629989	4	2.3668477661592013	0.0	0	4	0.5917119415398003	0.0
67974629990	1	0.46199892076316124	0.0	0	1	0.46199892076316124	0.0
67974629991	1	0.4620811076079665	0.0	0	1	0.4620811076079665	0.0
67974629992	1	0.4620962251390266	0.0	0	1	0.4620962251390266	0.0
67974629993	1	0.4621433622069198	0.0	0	1	0.4621433622069198	0.0
67974629994	1	0.4621512071617906	0.0	0	1	0.4621512071617906	0.0
67974629995	3	1.5226907912384446	0.0	0	3	0.5075635970794815	0.0
67974629996	1	0.462196761770976	0.0	0	1	0.462196761770976	0.0
67974629997	3	1.9820840758964704	0.0	0	3	0.6606946919654901	0.0
67974629998	1	0.46222655913175137	0.0	0	1	0.46222655913175137	0.0
67974629999	2	1.3370703712990204	0.0	0	2	0.6685351856495102	0.0
67974630000	2	0.9245333522869239	0.0	0	2	0.46226667614346195	0.0
67974630001	4	2.1761139170947192	0.0	0	4	0.7253713056982397	0.0
67974630002	1	0.46234470482549234	0.0	0	1	0.46234470482549234	0.0
67974630003	1	0.4624086428911561	0.0	0	1	0.4624086428911561	0.0
67974630004	4	2.4247943401310486	0.0	0	4	0.8082647800436829	0.0
67974630005	1	0.462530155518318	0.0	0	1	0.462530155518318	0.0
67974630006	1	0.4625413674066098	0.0	0	1	0.4625413674066098	0.0
67974630007	7	3.7877591903225443	1.0	1	6	0.6312931983870907	0.16666666666666666
67974630008	4	2.8490694991285874	0.0	0	4	0.7122673747821469	0.0
67974630009	4	1.7882924115684196	1.0	1	3	0.5960974705228065	0.3333333333333333
67974630010	1	0.4626661796285242	0.0	0	1	0.4626661796285242	0.0
67974630011	3	2.358625041358568	0.0	0	3	0.7862083471195227	0.0
67974630012	3	1.5785814819941284	0.0	0	3	0.5261938273313761	0.0
67974630013	2	0.9933195663914995	0.0	0	2	0.49665978319574977	0.0
67974630014	2	0.9254787535221911	0.0	0	2	0.46273937676109556	0.0
67974630015	3	1.8922012293549324	0.0	0	3	0.6307337431183108	0.0
67974630016	2	0.9255708728205883	0.0	0	2	0.4627854364102941	0.0
67974630017	1	0.46277385415932604	0.0	0	1	0.46277385415932604	0.0
67974630018	1	0.4628166815524405	0.0	0	1	0.4628166815524405	0.0
67974630019	4	2.326989469612702	0.0	0	4	0.5817473674031755	0.0
67974630020	1	0.4628641216443416	0.0	0	1	0.4628641216443416	0.0
67974630021	2	1.025728691090828	0.0	0	2	0.512864345545414	0.0
67974630022	1	0.4629165111283715	0.0	0	1	0.4629165111283715	0.0
67974630023	4	1.6498607756195773	1.0	1	3	0.5499535918731925	0.3333333333333333
67974630024	2	1.0266035887402607	0.0	0	2	0.5133017943701303	0.0
67974630025	3	1.935684265414419	0.0	0	3	0.6452280884714731	0.0
67974630026	3	1.4185913713509721	0.0	0	3	0.47286379045032406	0.0
67974630027	17	5.110582281842833	6.0	6	11	0.4645983892584393	0.5454545454545454
67974630028	4	0.929280728410457	2.0	2	2	0.4646403642052285	1.0
67974630029	7	2.387095695688746	2.0	2	5	0.47741913913774925	0.4
67974630030	2	0.464585634702471	1.0	1	1	0.464585634702471	1.0
67974630031	2	0.46459391735868655	1.0	1	1	0.46459391735868655	1.0
67974630032	2	0.9292668566447626	0.0	0	2	0.4646334283223813	0.0
67974630033	3	0.9293330168864842	1.0	1	2	0.4646665084432421	0.5
67974630034	2	0.4646728719474077	1.0	1	1	0.4646728719474077	1.0
67974630035	34	11.837096751222374	9.0	9	25	0.473483870048895	0.36
67974630036	1	0.46481091621766646	0.0	0	1	0.46481091621766646	0.0
67974630037	1	0.46481118557234014	0.0	0	1	0.46481118557234014	0.0
67974630038	2	0.8129513942420792	0.0	0	2	0.8129513942420792	0.0
67974630039	9	2.5161507250842634	4.0	4	5	0.5032301450168527	0.8
67974630040	2	0.9297532101774182	0.0	0	2	0.4648766050887091	0.0
67974630041	3	0.9298093032882111	1.0	1	2	0.46490465164410555	0.5
67974630042	27	8.456540953341138	9.0	9	18	0.4698078307411743	0.5
67974630043	9	2.325476571749334	4.0	4	5	0.46509531434986684	0.8
67974630044	2	0.9301784875378178	0.0	0	2	0.4650892437689089	0.0
67974630045	3	0.9302449508035473	1.0	1	2	0.46512247540177365	0.5
67974630046	30	9.39089884900371	10.0	10	20	0.4695449424501855	0.5
67974630047	3	0.9307343345762817	1.0	1	2	0.46536716728814087	0.5
67974630048	6	2.5180029424977937	1.0	1	5	0.5036005884995587	0.2
67974630049	1	0.4652757887150964	0.0	0	1	0.4652757887150964	0.0
67974630050	2	0.46531400340942414	1.0	1	1	0.46531400340942414	1.0
67974630051	23	7.024622518784713	8.0	8	15	0.46830816791898083	0.5333333333333333
67974630052	2	1.2031900212712752	0.0	0	2	0.6015950106356376	0.0
67974630053	2	1.4448564486050912	0.0	0	2	0.7224282243025456	0.0
67974630054	2	0.4654624178346194	1.0	1	1	0.4654624178346194	1.0
67974630055	9	3.343657843875769	2.0	2	7	0.477665406267967	0.2857142857142857
67974630056	6	2.3276170660023663	1.0	1	5	0.46552341320047325	0.2
67974630057	2	0.465549318386214	1.0	1	1	0.465549318386214	1.0
67974630058	29	9.927571403651312	8.0	8	21	0.47274149541196725	0.38095238095238093
67974630059	2	0.465620529028067	1.0	1	1	0.465620529028067	1.0
67974630060	7	2.5208488766411823	2.0	2	5	0.5041697753282365	0.4
67974630061	4	0.9314134450472864	2.0	2	2	0.4657067225236432	1.0
67974630062	4	1.8633300446249987	0.0	0	4	0.4658325111562497	0.0
67974630063	5	1.5193206255614151	0.5	1	4	0.7596603127807076	0.25
67974630064	1	0.4658716349226011	0.0	0	1	0.4658716349226011	0.0
67974630065	3	1.3976887416177246	0.0	0	3	0.4658962472059082	0.0
67974630066	20	16.397465278246575	0.0	0	20	0.8198732639123287	0.0
67974630067	5	2.331171672292195	0.0	0	5	0.46623433445843904	0.0
67974630068	3	1.8779594713470094	0.0	0	3	0.6259864904490031	0.0
67974630069	15	9.748818955511933	1.0	1	14	0.6963442111079952	0.07142857142857142
67974630070	8	2.958707255138841	2.0	2	6	0.49311787585647354	0.3333333333333333
67974630071	6	4.328992693990162	0.0	0	6	0.7214987823316936	0.0
67974630072	9	5.898998192529131	0.0	0	9	0.8427140275041616	0.0
67974630073	13	9.09133833819008	1.0	1	12	0.7576115281825068	0.08333333333333333
67974630074	1	0.4666455245694054	0.0	0	1	0.4666455245694054	0.0
67974630075	1	0.4668455204146096	0.0	0	1	0.4668455204146096	0.0
67974630076	5	2.3372110081080133	0.0	0	5	0.46744220162160266	0.0
67974630077	7	3.2763274581130757	0.0	0	7	0.4680467797304394	0.0
67974630078	2	0.9352855531587104	0.0	0	2	0.4676427765793552	0.0
67974630079	2	0.9369181118358585	0.0	0	2	0.46845905591792925	0.0
67974630080	8	5.64738725798188	0.0	0	8	0.705923407247735	0.0
67974630081	2	0.47012538493728934	1.0	1	1	0.47012538493728934	1.0
67974630082	2	1.1915096578633366	0.0	0	2	0.5957548289316683	0.0
67974630083	4	3.3627301749320564	0.0	0	4	0.8406825437330141	0.0
67974630084	2	0.7288360036426179	0.0	0	2	0.7288360036426179	0.0
67974630085	4	2.193062218202403	0.0	0	4	0.731020739400801	0.0
67974630086	3	0.4964691137561216	0.5	1	2	0.4964691137561216	0.5
67974630087	1	0.47066951504744836	0.0	0	1	0.47066951504744836	0.0
67974630088	22	8.483828904968542	4.0	4	18	0.4713238280538079	0.2222222222222222
67974630089	9	4.245967482763069	0.0	0	9	0.4717741647514521	0.0
67974630090	3	0.4939913537823137	0.5	1	2	0.4939913537823137	0.5
67974630091	2	0.8955847954269771	0.0	0	2	0.8955847954269771	0.0
67974630092	2	0.4709560410815708	1.0	1	1	0.4709560410815708	1.0
68262377896	5	2.0222517936243545	0.0	0	5	0.4044503587248709	0.0
68262377897	2	0.808883633629564	0.0	0	2	0.404441816814782	0.0
68262377898	2	1.1181082871106685	0.0	0	2	0.5590541435553342	0.0
68262377899	27	9.313089691032344	4.0	4	23	0.4049169430883628	0.17391304347826086
68262377900	14	4.857834535895331	2.0	2	12	0.4048195446579443	0.16666666666666666
68262377901	5	1.5798389642881832	2.0	2	3	0.526612988096061	0.6666666666666666
68262377902	16	5.667896629891561	2.0	2	14	0.4048497592779686	0.14285714285714285
68262377903	1	0.40474640644670784	0.0	0	1	0.40474640644670784	0.0
68262377904	3	1.214920720333857	0.0	0	3	0.404973573444619	0.0
68262377905	1	0.4050338078835197	0.0	0	1	0.4050338078835197	0.0
68262377906	31	10.57971176154354	5.0	5	26	0.40691199082859775	0.19230769230769232
68262377907	5	2.0484107451370455	0.0	0	5	0.40968214902740907	0.0
68262377908	2	0.8181126001523806	0.0	0	2	0.4090563000761903	0.0
68262377909	26	8.607116579429983	5.0	5	21	0.4098626942585706	0.23809523809523808
68262377910	9	2.9010372747475244	3.0	3	6	0.48350621245792075	0.5
68262377911	8	2.5567836520029195	3.0	3	5	0.5113567304005839	0.6
68262377912	2	0.40995565849692617	1.0	1	1	0.40995565849692617	1.0
68262377913	1	0.40995737563297086	0.0	0	1	0.40995737563297086	0.0
68262377914	2	0.40995764498764453	1.0	1	1	0.40995764498764453	1.0
68262377915	1	0.4099579480116524	0.0	0	1	0.4099579480116524	0.0
68262377916	1	0.4099653552651785	0.0	0	1	0.4099653552651785	0.0
68262377917	2	0.40996188732375494	1.0	1	1	0.40996188732375494	1.0
68262377918	9	3.697610524387423	0.0	0	9	0.41084561382082474	0.0
68262377919	4	1.6479255632972203	0.0	0	4	0.41198139082430507	0.0
68262377920	8	3.5660667588151447	0.5	1	7	0.7132133517630289	0.14285714285714285
68262377921	8	6.490428060804258	0.0	0	8	0.8113035076005323	0.0
68262377922	1	0.4136886449193968	0.0	0	1	0.4136886449193968	0.0
68262377923	3	1.6899759691860947	0.0	0	3	0.8449879845930474	0.0
68262377924	4	1.258720988860265	1.0	1	3	0.6293604944301325	0.3333333333333333
68262377925	1	0.4137274993310745	0.0	0	1	0.4137274993310745	0.0
68262377926	2	0.4137277686857482	1.0	1	1	0.4137277686857482	1.0
68262377927	1	0.413735613640619	0.0	0	1	0.413735613640619	0.0
68262377928	1	0.4140473916753985	0.0	0	1	0.4140473916753985	0.0
68262377929	7	2.081080201128482	3.0	3	4	0.5202700502821205	0.75
68262377930	12	3.33967859994289	5.0	5	7	0.4770969428489843	0.7142857142857143
68262377931	8	1.8849671708840257	2.5	3	5	0.4712417927210064	0.6
68262377932	5	1.869761594515023	1.0	1	4	0.46744039862875575	0.25
68262377933	12	3.9668852333943097	3.5	4	8	0.5666978904849014	0.5
68262377934	10	2.65017538187843	2.0	4	6	0.6625438454696075	0.6666666666666666
68262377935	11	2.844996957470614	5.0	5	6	0.47416615957843566	0.8333333333333334
68262377936	12	4.337304810873121	4.0	4	8	0.5421631013591401	0.5
68262377937	2	0.829108129302499	0.0	0	2	0.4145540646512495	0.0
68262377938	4	1.030015167698368	1.0	1	3	0.515007583849184	0.3333333333333333
68262377939	19	13.245162112288778	1.0	1	18	0.7358423395715987	0.05555555555555555
68262377940	5	1.2537056048364248	0.5	1	4	0.6268528024182124	0.25
68262377941	3	0.4483296424448017	0.5	1	2	0.4483296424448017	0.5
68262377942	2	0.4147470741096052	1.0	1	1	0.4147470741096052	1.0
68262377943	1	0.4147487912456499	0.0	0	1	0.4147487912456499	0.0
68262377944	34	13.191470062726305	9.0	9	25	0.5276588025090522	0.36
68262377945	12	3.887010798462537	1.5	3	9	0.6478351330770895	0.3333333333333333
68262377946	3	1.5967820803183987	0.0	0	3	0.5322606934394662	0.0
68262377947	27	19.54228260645225	1.0	1	26	0.7516262540943173	0.038461538461538464
68262377948	39	21.40807515884266	2.0	4	35	0.7136025052947553	0.11428571428571428
68262377949	2	1.1769608691967577	0.0	0	2	0.5884804345983788	0.0
68262377950	4	0.6140365366820494	1.0	2	2	0.6140365366820494	1.0
68262377951	41	13.895862904127544	14.0	14	27	0.5146615890417608	0.5185185185185185
68262377952	2	0.9722694313050803	0.0	0	2	0.48613471565254013	0.0
68262377953	2	1.136365146892403	0.0	0	2	0.5681825734462015	0.0
68262377954	2	0.4151901625478016	1.0	1	1	0.4151901625478016	1.0
68262377955	2	0.41520140810542755	1.0	1	1	0.41520140810542755	1.0
68262377956	10	2.2761650035755148	3.0	4	6	0.455233000715103	0.6666666666666666
68262377957	9	2.2698657741689336	4.0	4	5	0.45397315483378675	0.8
68262377958	4	0.8705369319431984	2.0	2	2	0.4352684659715992	1.0
68262377959	27	7.9859149390734885	8.0	8	19	0.4203113125828152	0.42105263157894735
68262377960	8	2.2673630652184773	3.0	3	5	0.45347261304369546	0.6
